"","state","gp","gp_vs_rank","mi","mi_rank","util_diff","rank_diff"
"1","1111111",1,1,1,1,0,0
"2","2111111",0.936776827491811,7,0.943625515359177,7,-0.00684868786736559,0
"3","3111111",0.893662618678308,29,0.914831682159397,16,-0.0211690634810896,13
"4","4111111",0.852188287977768,92,0.872421307037587,72,-0.0202330190598192,20
"5","1211111",0.946042222407004,5,0.944695721054294,6,0.00134650135271008,-1
"6","2211111",0.882819049898815,39,0.88832123641347,45,-0.0055021865146555,-6
"7","3211111",0.839704841085312,124,0.859527403213691,97,-0.0198225621283795,27
"8","4211111",0.798230510384772,324,0.817117028091881,289,-0.0188865177071091,35
"9","1311111",0.918062752130228,14,0.917645153720996,14,0.000417598409231834,0
"10","2311111",0.854839579622039,86,0.861270669080173,90,-0.00643108945813375,-4
"11","3311111",0.811725370808535,240,0.832476835880393,202,-0.0207514650718578,38
"12","4311111",0.770251040107995,555,0.790066460758583,516,-0.0198154206505874,39
"13","1411111",0.879126254145232,45,0.87701564975289,60,0.00211060439234168,-15
"14","2411111",0.815903081637043,217,0.820641165112067,266,-0.00473808347502402,-49
"15","3411111",0.772788872823539,523,0.791847331912287,495,-0.019058459088748,28
"16","4411111",0.731314542122999,1074,0.749436956790477,1114,-0.0181224146674777,-40
"17","1121111",0.93202072913358,8,0.939430688342593,8,-0.00740995920901322,0
"18","2121111",0.868797556625391,62,0.88305620370177,52,-0.0142586470763788,10
"19","3121111",0.825683347811888,176,0.85426237050199,108,-0.0285790226901028,68
"20","4121111",0.784209017111348,416,0.81185199538018,323,-0.0276429782688324,93
"21","1221111",0.878062951540584,46,0.884126409396887,51,-0.00606345785630313,-5
"22","2221111",0.814839779032395,222,0.827751924756064,229,-0.0129121457236687,-7
"23","3221111",0.771725570218892,532,0.798958091556284,429,-0.0272325213373927,103
"24","4221111",0.730251239518352,1091,0.756547716434474,986,-0.0262964769161224,105
"25","1321111",0.850083481263808,93,0.857075842063589,100,-0.00699236079978138,-7
"26","2321111",0.786860308755619,396,0.800701357422766,414,-0.013841048667147,-18
"27","3321111",0.743746099942115,871,0.771907524222986,739,-0.028161424280871,132
"28","4321111",0.702271769241575,1653,0.729497149101176,1543,-0.0272253798596006,110
"29","1421111",0.811146983278812,242,0.816446338095483,292,-0.00529935481667154,-50
"30","2421111",0.747923810770623,817,0.76007185345466,933,-0.0121480426840372,-116
"31","3421111",0.704809601957119,1594,0.731278020254881,1507,-0.0264684182977613,87
"32","4421111",0.663335271256579,2724,0.68886764513307,2777,-0.0255323738764909,-53
"33","1131111",0.88868820696848,33,0.900965595894564,28,-0.012277388926084,5
"34","2131111",0.825465034460292,177,0.844591111253741,148,-0.0191260767934496,29
"35","3131111",0.782350825646788,430,0.815797278053962,298,-0.0334464524071736,132
"36","4131111",0.740876494946248,911,0.773386902932151,721,-0.0325104079859032,190
"37","1231111",0.834730429375484,143,0.845661316948858,143,-0.0109308875733739,0
"38","2231111",0.771507256867295,533,0.789286832308035,527,-0.0177795754407395,6
"39","3231111",0.728393048053792,1115,0.760492999108255,929,-0.0320999510544635,186
"40","4231111",0.686918717353252,2027,0.718082623986445,1856,-0.0311639066331931,171
"41","1331111",0.806750959098708,266,0.81861074961556,280,-0.0118597905168522,-14
"42","2331111",0.743527786590519,874,0.762236264974737,905,-0.0187084783842177,-31
"43","3331111",0.700413577777016,1685,0.733442431774957,1453,-0.0330288539979418,232
"44","4331111",0.658939247076476,2851,0.691032056653147,2705,-0.0320928095766714,146
"45","1431111",0.767814461113712,573,0.777981245647454,666,-0.0101667845337423,-93
"46","2431111",0.704591288605523,1599,0.721606761006631,1766,-0.017015472401108,-167
"47","3431111",0.66147707979202,2775,0.692812927806852,2648,-0.031335848014832,127
"48","4431111",0.62000274909148,4334,0.650402552685041,4400,-0.0303998035935616,-66
"49","1141111",0.839654642513651,125,0.86056710176748,94,-0.0209124592538295,31
"50","2141111",0.776431470005462,485,0.804192617126657,391,-0.027761147121195,94
"51","3141111",0.733317261191959,1038,0.775398783926878,690,-0.042081522734919,348
"52","4141111",0.691842930491419,1908,0.732988408805067,1465,-0.0411454783136487,443
"53","1241111",0.785696864920655,404,0.805262822821774,379,-0.0195659579011194,25
"54","2241111",0.722473692412466,1224,0.748888338180951,1128,-0.026414645768485,96
"55","3241111",0.679359483598962,2247,0.720094504981171,1806,-0.040735021382209,441
"56","4241111",0.637885152898422,3638,0.677684129859361,3218,-0.0397989769609386,420
"57","1341111",0.757717394643879,689,0.778212255488476,659,-0.0204948608445976,30
"58","2341111",0.69449422213569,1831,0.721837770847653,1757,-0.0273435487119632,74
"59","3341111",0.651380013322186,3144,0.693043937647873,2640,-0.0416639243256872,504
"60","4341111",0.609905682621646,4803,0.650633562526063,4388,-0.0407278799044168,415
"61","1441111",0.718780896658883,1291,0.73758275152037,1359,-0.0188018548614878,-68
"62","2441111",0.655557724150694,2969,0.681208266879547,3085,-0.0256505427288535,-116
"63","3441111",0.61244351533719,4685,0.652414433679768,4307,-0.0399709183425775,378
"64","4441111",0.57096918463665,6639,0.610004058557957,6483,-0.0390348739213071,156
"65","1112111",0.966915088238311,2,0.961681018471348,2,0.00523406976696317,0
"66","2112111",0.903691915730122,19,0.905306533830525,22,-0.00161461810040242,-3
"67","3112111",0.860577706916619,73,0.876512700630745,61,-0.0159349937141264,12
"68","4112111",0.819103376216079,200,0.834102325508935,196,-0.0149989492928561,4
"69","1212111",0.912957310645315,16,0.906376739525642,21,0.00658057111967325,-5
"70","2212111",0.849734138137126,95,0.850002254884818,126,-0.000268116747692337,-31
"71","3212111",0.806619929323623,267,0.821208421685039,262,-0.0145884923614163,5
"72","4212111",0.765145598623083,608,0.778798046563229,654,-0.013652447940146,-46
"73","1312111",0.884977840368539,37,0.879326172192344,59,0.005651668176195,-22
"74","2312111",0.82175466786035,190,0.82295168755152,254,-0.00119701969117059,-64
"75","3312111",0.778640459046846,464,0.794157854351741,467,-0.0155173953048946,-3
"76","4312111",0.737166128346306,975,0.751747479229931,1068,-0.0145813508836242,-93
"77","1412111",0.846041342383543,108,0.838696668224238,170,0.00734467415930484,-62
"78","2412111",0.782818169875354,426,0.782322183583415,605,0.000495986291939143,-179
"79","3412111",0.73970396106185,929,0.753528350383635,1034,-0.0138243893217849,-105
"80","4412111",0.69822963036131,1738,0.711117975261825,2045,-0.0128883449005145,-307
"81","1122111",0.898935817371891,26,0.901111706813941,27,-0.00217588944205005,-1
"82","2122111",0.835712644863702,139,0.844737222173118,147,-0.00902457730941564,-8
"83","3122111",0.792598436050199,360,0.815943388973338,295,-0.0233449529231397,65
"84","4122111",0.751124105349659,770,0.773533013851528,719,-0.0224089085018693,51
"85","1222111",0.844978039778895,111,0.845807427868235,142,-0.000829388089339966,-31
"86","2222111",0.781754867270706,435,0.789432943227412,526,-0.00767807595670555,-91
"87","3222111",0.738640658457203,948,0.760639110027632,926,-0.0219984515704296,22
"88","4222111",0.697166327756663,1771,0.718228734905822,1853,-0.0210624071491592,-82
"89","1322111",0.816998569502119,211,0.818756860534937,279,-0.00175829103281822,-68
"90","2322111",0.75377539699393,738,0.762382375894114,903,-0.0086069789001838,-165
"91","3322111",0.710661188180426,1457,0.733588542694334,1448,-0.0229273545139078,9
"92","4322111",0.669186857479886,2538,0.691178167572524,2700,-0.0219913100926374,-162
"93","1422111",0.778062071517123,469,0.778127356566831,664,-6.52850497083746e-05,-195
"94","2422111",0.714838899008934,1371,0.721752871926008,1762,-0.00691397291707407,-391
"95","3422111",0.67172469019543,2454,0.692959038726229,2644,-0.0212343485307981,-190
"96","4422111",0.63025035949489,3907,0.650548663604418,4393,-0.0202983041095277,-486
"97","1132111",0.855603295206791,83,0.862646614365912,89,-0.00704331915912082,-6
"98","2132111",0.792380122698603,361,0.806272129725089,368,-0.0138920070264864,-7
"99","3132111",0.749265913885099,795,0.77747829652531,671,-0.0282123826402104,124
"100","4132111",0.707791583184559,1527,0.735067921403499,1419,-0.02727633821894,108
"101","1232111",0.801645517613795,301,0.807342335420206,361,-0.00569681780641074,-60
"102","2232111",0.738422345105606,952,0.750967850779383,1083,-0.0125455056737763,-131
"103","3232111",0.695308136292103,1813,0.722174017579603,1747,-0.0268658812875003,66
"104","4232111",0.653833805591563,3040,0.679763642457793,3149,-0.02592983686623,-109
"105","1332111",0.773666047337019,513,0.780291768086908,637,-0.00662572074988899,-124
"106","2332111",0.71044287482883,1462,0.723917283446085,1702,-0.0134744086172546,-240
"107","3332111",0.667328666015327,2592,0.695123450246305,2571,-0.0277947842309786,21
"108","4332111",0.625854335314787,4079,0.652713075124495,4292,-0.0268587398097082,-213
"109","1432111",0.734729549352023,1015,0.739662264118802,1324,-0.00493271476677914,-309
"110","2432111",0.671506376843834,2458,0.683287779477979,2996,-0.0117814026341448,-538
"111","3432111",0.628392168030331,3988,0.6544939462782,4214,-0.0261017782478689,-226
"112","4432111",0.586917837329791,5832,0.612083571156389,6385,-0.0251657338265985,-553
"113","1142111",0.806569730751962,268,0.822248120238828,260,-0.0156783894868663,8
"114","2142111",0.743346558243773,878,0.765873635598005,845,-0.0225270773542319,33
"115","3142111",0.70023234943027,1686,0.737079802398225,1371,-0.0368474529679559,315
"116","4142111",0.65875801872973,2856,0.694669427276415,2587,-0.0359114085466855,269
"117","1242111",0.752611953158966,750,0.766943841293122,825,-0.0143318881341562,-75
"118","2242111",0.689388780650777,1958,0.710569356652299,2068,-0.0211805760015218,-110
"119","3242111",0.646274571837273,3323,0.681775523452519,3064,-0.0355009516152458,259
"120","4242111",0.604800241136733,5013,0.639365148330709,4963,-0.0345649071939754,50
"121","1342111",0.72463248288219,1185,0.739893273959824,1317,-0.0152607910776345,-132
"122","2342111",0.661409310374001,2777,0.683518789319001,2986,-0.022109478945,-209
"123","3342111",0.618295101560497,4415,0.654724956119221,4200,-0.036429854558724,215
"124","4342111",0.576820770859957,6343,0.612314580997411,6371,-0.0354938101374537,-28
"125","1442111",0.685695984897194,2064,0.699263769991718,2432,-0.0135677850945246,-368
"126","2442111",0.622472812389005,4244,0.642889285350895,4767,-0.0204164729618903,-523
"127","3442111",0.579358603575501,6238,0.614095452151116,6263,-0.0347368485756143,-25
"128","4442111",0.537884272874961,8335,0.571685077029305,8677,-0.0338008041543439,-342
"129","1113111",0.928031912665825,10,0.936184428082109,11,-0.00815251541628348,-1
"130","2113111",0.864808740157637,68,0.879809943441286,58,-0.0150012032836491,10
"131","3113111",0.821694531344133,191,0.851016110241506,123,-0.0293215788973731,68
"132","4113111",0.780220200643593,448,0.808605735119696,352,-0.0283855344761026,96
"133","1213111",0.874074135072829,52,0.880880149136403,55,-0.00680601406357328,-3
"134","2213111",0.81085096256464,243,0.824505664495579,247,-0.0136547019309389,-4
"135","3213111",0.767736753751137,576,0.7957118312958,459,-0.0279750775446629,117
"136","4213111",0.726262423050597,1155,0.75330145617399,1038,-0.0270390331233926,117
"137","1313111",0.846094664796053,107,0.853829581803105,111,-0.00773491700705153,-4
"138","2313111",0.782871492287864,425,0.797455097162281,435,-0.0145836048744171,-10
"139","3313111",0.739757283474361,928,0.768661263962502,790,-0.0289039804881411,138
"140","4313111",0.698282952773821,1736,0.726250888840692,1633,-0.0279679360668709,103
"141","1413111",0.807158166811057,264,0.813200077834999,311,-0.00604191102394169,-47
"142","2413111",0.743934994302868,868,0.756825593194176,980,-0.0128905988913074,-112
"143","3413111",0.700820785489365,1676,0.728031759994396,1587,-0.0272109745050314,89
"144","4413111",0.659346454788825,2837,0.685621384872586,2904,-0.0262749300837611,-67
"145","1123111",0.860052641799405,74,0.875615116424702,65,-0.0155624746252967,9
"146","2123111",0.796829469291217,332,0.819240631783879,277,-0.0224111624926623,55
"147","3123111",0.753715260477713,739,0.790446798584099,512,-0.0367315381063863,227
"148","4123111",0.712240929777173,1422,0.748036423462289,1148,-0.0357954936851158,274
"149","1223111",0.806094864206409,270,0.820310837478996,270,-0.0142159732725865,0
"150","2223111",0.74287169169822,883,0.763936352838173,873,-0.0210646611399521,10
"151","3223111",0.699757482884717,1701,0.735142519638393,1418,-0.0353850367536761,283
"152","4223111",0.658283152184177,2881,0.692732144516583,2652,-0.0344489923324058,229
"153","1323111",0.778115393929633,467,0.793260270145698,478,-0.0151448762160648,-11
"154","2323111",0.714892221421444,1369,0.736885785504875,1377,-0.0219935640834303,-8
"155","3323111",0.671778012607941,2451,0.708091952305095,2141,-0.0363139396971544,310
"156","4323111",0.630303681907401,3904,0.665681577183285,3711,-0.0353778952758841,193
"157","1423111",0.739178895944637,935,0.752630766177592,1048,-0.0134518702329549,-113
"158","2423111",0.675955723436448,2343,0.696256281536769,2528,-0.0203005581003206,-185
"159","3423111",0.632841514622945,3813,0.66746244833699,3632,-0.0346209337140446,181
"160","4423111",0.591367183922405,5615,0.625052073215179,5664,-0.0336848892927744,-49
"161","1133111",0.816720119634306,212,0.837150023976673,180,-0.0204299043423674,32
"162","2133111",0.753496947126117,742,0.78077553933585,631,-0.0272785922097329,111
"163","3133111",0.710382738312614,1464,0.75198170613607,1065,-0.041598967823457,399
"164","4133111",0.668908407612073,2545,0.70957133101426,2096,-0.0406629234021867,449
"165","1233111",0.76276234204131,628,0.781845745030967,614,-0.0190834029896574,14
"166","2233111",0.699539169533121,1704,0.725471260390144,1659,-0.025932090857023,45
"167","3233111",0.656424960719617,2941,0.696677427190364,2518,-0.040252466470747,423
"168","4233111",0.614950630019077,4556,0.654267052068554,4225,-0.0393164220494765,331
"169","1333111",0.734782871764533,1014,0.754795177697669,1014,-0.0200123059331356,0
"170","2333111",0.671559699256345,2457,0.698420693056846,2462,-0.0268609938005012,-5
"171","3333111",0.628445490442841,3986,0.669626859857066,3530,-0.0411813694142252,456
"172","4333111",0.586971159742301,5830,0.627216484735256,5550,-0.0402453249929547,280
"173","1433111",0.695846373779538,1796,0.714165673729563,1960,-0.0183192999500258,-164
"174","2433111",0.632623201271349,3820,0.65779118908874,4064,-0.0251679878173915,-244
"175","3433111",0.589508992457845,5709,0.628997355888961,5454,-0.0394883634311155,255
"176","4433111",0.548034661757305,7791,0.58658698076715,7802,-0.038552319009845,-11
"177","1143111",0.767686555179476,577,0.796751529849589,446,-0.0290649746701129,131
"178","2143111",0.704463382671287,1606,0.740377045208766,1308,-0.0359136625374785,298
"179","3143111",0.661349173857784,2778,0.711583212008986,2025,-0.0502340381512025,753
"180","4143111",0.619874843157244,4339,0.669172836887176,3557,-0.049297993729932,782
"181","1243111",0.71372877758648,1390,0.741447250903883,1282,-0.0277184733174027,108
"182","2243111",0.650505605078291,3168,0.68507276626306,2925,-0.0345671611847683,243
"183","3243111",0.607391396264788,4916,0.65627893306328,4137,-0.0488875367984923,779
"184","4243111",0.565917065564248,6890,0.61386855794147,6278,-0.0479514923772221,612
"185","1343111",0.685749307309704,2063,0.714396683570585,1950,-0.028647376260881,113
"186","2343111",0.622526134801515,4241,0.658022198929762,4053,-0.0354960641282466,188
"187","3343111",0.579411925988012,6234,0.629228365729982,5447,-0.0498164397419706,787
"188","4343111",0.537937595287472,8334,0.586817990608172,7792,-0.0488803953207003,542
"189","1443111",0.646812809324708,3308,0.673767179602479,3359,-0.0269543702777711,-51
"190","2443111",0.583589636816519,6025,0.617392694961656,6081,-0.0338030581451368,-56
"191","3443111",0.540475428003016,8210,0.588598861761877,7683,-0.0481234337588609,527
"192","4443111",0.499001097302476,10320,0.546188486640066,10102,-0.0471873893375905,218
"193","1114111",0.875824840695256,51,0.891533814708453,39,-0.0157089740131974,12
"194","2114111",0.812601668187067,235,0.83515933006763,187,-0.022557661880563,48
"195","3114111",0.769487459373563,562,0.80636549686785,367,-0.036878037494287,195
"196","4114111",0.728013128673023,1116,0.76395512174604,872,-0.0359419930730166,244
"197","1214111",0.82186706310226,189,0.836229535762747,181,-0.0143624726604873,8
"198","2214111",0.758643890594071,684,0.779855051121924,638,-0.0212111605278529,46
"199","3214111",0.715529681780567,1360,0.751061217922144,1080,-0.0355315361415769,280
"200","4214111",0.674055351080027,2390,0.708650842800334,2127,-0.0345954917203065,263
"201","1314111",0.793887592825483,349,0.809178968429449,344,-0.0152913756039655,5
"202","2314111",0.730664420317295,1083,0.752804483788626,1042,-0.0221400634713311,41
"203","3314111",0.687550211503791,2009,0.724010650588846,1699,-0.0364604390850551,310
"204","4314111",0.646075880803251,3330,0.681600275467036,3072,-0.0355243946637848,258
"205","1414111",0.754951094840487,721,0.768549464461343,791,-0.0135983696208557,-70
"206","2414111",0.691727922332299,1915,0.71217497982052,2003,-0.0204470574882214,-88
"207","3414111",0.648613713518795,3242,0.68338114662074,2991,-0.0347674331019454,251
"208","4414111",0.607139382818255,4925,0.64097077149893,4873,-0.033831388680675,52
"209","1124111",0.807845569828836,261,0.830964503051046,211,-0.0231189332222106,50
"210","2124111",0.744622397320647,858,0.774590018410223,704,-0.0299676210895762,154
"211","3124111",0.701508188507143,1666,0.745796185210444,1192,-0.0442879967033002,474
"212","4124111",0.660033857806603,2811,0.703385810088633,2301,-0.0433519522820298,510
"213","1224111",0.75388779223584,736,0.77566022410534,686,-0.0217724318695005,50
"214","2224111",0.690664619727651,1938,0.719285739464517,1822,-0.0286211197368661,116
"215","3224111",0.647550410914147,3286,0.690491906264737,2731,-0.0429414953505901,555
"216","4224111",0.606076080213607,4974,0.648081531142927,4498,-0.0420054509293197,476
"217","1324111",0.725908321959063,1162,0.748609656772042,1132,-0.0227013348129788,30
"218","2324111",0.662685149450875,2738,0.692235172131219,2661,-0.0295500226803443,77
"219","3324111",0.619570940637371,4357,0.663441338931439,3819,-0.0438703982940684,538
"220","4324111",0.578096609936831,6293,0.621030963809629,5886,-0.042934353872798,407
"221","1424111",0.686971823974067,2025,0.707980152803936,2145,-0.0210083288298689,-120
"222","2424111",0.623748651465879,4189,0.651605668163113,4335,-0.0278570166972346,-146
"223","3424111",0.580634442652375,6167,0.622811834963334,5791,-0.0421773923109586,376
"224","4424111",0.539160111951835,8268,0.580401459841523,8163,-0.0412413478896883,105
"225","1134111",0.764513047663736,615,0.792499410603017,487,-0.0279863629392814,128
"226","2134111",0.701289875155547,1669,0.736124925962194,1396,-0.034835050806647,273
"227","3134111",0.658175666342044,2885,0.707331092762415,2172,-0.049155426420371,713
"228","4134111",0.616701335641504,4473,0.664920717640604,3754,-0.0482193819991006,719
"229","1234111",0.71055527007074,1460,0.737195131657311,1369,-0.0266398615865713,91
"230","2234111",0.647332097562551,3291,0.680820647016488,3098,-0.0334885494539369,193
"231","3234111",0.604217888749048,5042,0.652026813816708,4321,-0.0478089250676609,721
"232","4234111",0.562743558048508,7024,0.609616438694898,6515,-0.0468728806463905,509
"233","1334111",0.682575799793964,2153,0.710144564324013,2079,-0.0275687645300495,74
"234","2334111",0.619352627285775,4370,0.65377007968319,4245,-0.0344174523974151,125
"235","3334111",0.576238418472271,6373,0.62497624648341,5668,-0.0487378280111391,705
"236","4334111",0.534764087771731,8474,0.5825658713616,8048,-0.0478017835898688,426
"237","1434111",0.643639301808968,3407,0.669515060355907,3537,-0.0258757585469397,-130
"238","2434111",0.580416129300779,6181,0.613140575715084,6316,-0.0327244464143054,-135
"239","3434111",0.537301920487275,8356,0.584346742515305,7926,-0.0470448220280294,430
"240","4434111",0.495827589786735,10457,0.541936367393494,10358,-0.0461087776067591,99
"241","1144111",0.715479483208907,1361,0.752100916475933,1063,-0.0366214332670268,298
"242","2144111",0.652256310700718,3113,0.69572643183511,2550,-0.0434701211343924,563
"243","3144111",0.609142101887214,4842,0.666932598635331,3653,-0.0577904967481164,1189
"244","4144111",0.567667771186674,6813,0.62452222351352,5695,-0.056854452326846,1118
"245","1244111",0.66152170561591,2773,0.696796637530227,2512,-0.0352749319143167,261
"246","2244111",0.598298533107722,5308,0.640422152889404,4896,-0.0421236197816823,412
"247","3244111",0.555184324294218,7445,0.611628319689624,6414,-0.0564439953954063,1031
"248","4244111",0.513709993593678,9580,0.569217944567814,8819,-0.055507950974136,761
"249","1344111",0.633542235339134,3794,0.669746070196929,3521,-0.036203834857795,273
"250","2344111",0.570319062830945,6676,0.613371585556106,6301,-0.0430525227251606,375
"251","3344111",0.527204854017442,8891,0.584577752356326,7913,-0.0573728983388846,978
"252","4344111",0.485730523316902,10968,0.542167377234516,10341,-0.0564368539176143,627
"253","1444111",0.594605737354138,5489,0.629116566228823,5450,-0.0345108288746852,39
"254","2444111",0.531382564845949,8661,0.572742081588,8607,-0.0413595167420509,54
"255","3444111",0.488268356032446,10843,0.543948248388221,10238,-0.0556798923557749,605
"256","4444111",0.446794025331906,12690,0.50153787326641,12420,-0.0547438479345045,270
"257","1111211",0.95415116585179,4,0.954665153345218,4,-0.000513987493428236,0
"258","2111211",0.890927993343601,32,0.898290668704395,31,-0.00736267536079382,1
"259","3111211",0.847813784530097,101,0.869496835504615,76,-0.0216830509745178,25
"260","4111211",0.806339453829558,269,0.827086460382805,233,-0.0207470065532475,36
"261","1211211",0.900193388258794,23,0.899360874399512,29,0.000832513859281847,-6
"262","2211211",0.836970215750605,134,0.842986389758689,153,-0.00601617400808374,-19
"263","3211211",0.793856006937101,350,0.814192556558909,305,-0.0203365496218078,45
"264","4211211",0.752381676236561,754,0.771782181437099,740,-0.0194005052005374,14
"265","1311211",0.872213917982018,56,0.872310307066214,74,-9.63890841964021e-05,-18
"266","2311211",0.808990745473829,254,0.815935822425391,297,-0.00694507695156199,-43
"267","3311211",0.765876536660325,596,0.787141989225611,556,-0.021265452565286,40
"268","4311211",0.724402205959785,1188,0.744731614103801,1217,-0.0203294081440156,-29
"269","1411211",0.833277419997022,149,0.831680803098108,205,0.00159661689891344,-56
"270","2411211",0.770054247488833,557,0.775306318457285,692,-0.00525207096845226,-135
"271","3411211",0.726940038675329,1140,0.746512485257505,1177,-0.0195724465821763,-37
"272","4411211",0.685465707974789,2071,0.704102110135695,2271,-0.0186364021609059,-200
"273","1121211",0.88617189498537,36,0.894095841687811,37,-0.00792394670244145,-1
"274","2121211",0.822948722477181,186,0.837721357046988,176,-0.014772634569807,10
"275","3121211",0.779834513663678,452,0.808927523847209,349,-0.0290930101835311,103
"276","4121211",0.738360182963138,953,0.766517148725398,833,-0.0281569657622607,120
"277","1221211",0.832214117392374,152,0.838791562742105,167,-0.00657744534973137,-15
"278","2221211",0.768990944884185,565,0.782417078101282,603,-0.013426133217097,-38
"279","3221211",0.725876736070681,1163,0.753623244901502,1031,-0.027746508830821,132
"280","4221211",0.684402405370141,2095,0.711212869779692,2040,-0.0268104644095506,55
"281","1321211",0.804234647115598,284,0.811740995408807,325,-0.00750634829320962,-41
"282","2321211",0.741011474607409,908,0.755366510767984,1003,-0.0143550361605752,-95
"283","3321211",0.697897265793905,1744,0.726572677568204,1626,-0.0286754117742992,118
"284","4321211",0.656422935093365,2942,0.684162302446394,2963,-0.0277393673530288,-21
"285","1421211",0.765298149130602,607,0.771111491440701,756,-0.00581334231009978,-149
"286","2421211",0.702074976622413,1655,0.714737006799878,1944,-0.0126620301774655,-289
"287","3421211",0.658960767808909,2849,0.685943173600099,2894,-0.0269824057911895,-45
"288","4421211",0.617486437108369,4442,0.643532798478288,4733,-0.0260463613699191,-291
"289","1131211",0.84283937282027,119,0.855630749239782,106,-0.0127913764195122,13
"290","2131211",0.779616200312081,457,0.799256264598959,427,-0.0196400642868778,30
"291","3131211",0.736501991498578,987,0.77046243139918,767,-0.0339604399006018,220
"292","4131211",0.695027660798038,1816,0.728052056277369,1584,-0.0330243954793314,232
"293","1231211",0.788881595227274,386,0.800326470294076,421,-0.0114448750668021,-35
"294","2231211",0.725658422719085,1168,0.743951985653253,1234,-0.0182935629341677,-66
"295","3231211",0.682544213905582,2156,0.715158152453473,1932,-0.0326139385478917,224
"296","4231211",0.641069883205042,3524,0.672747777331663,3403,-0.0316778941266214,121
"297","1331211",0.760902124950498,655,0.773275902960778,724,-0.0123737780102804,-69
"298","2331211",0.697678952442309,1749,0.716901418319955,1891,-0.019222465877646,-142
"299","3331211",0.654564743628806,3006,0.688107585120176,2808,-0.03354284149137,198
"300","4331211",0.613090412928266,4654,0.645697209998365,4621,-0.0326067970700996,33
"301","1431211",0.721965626965502,1231,0.732646398992672,1475,-0.0106807720271705,-244
"302","2431211",0.658742454457313,2859,0.676271914351849,3282,-0.0175294598945362,-423
"303","3431211",0.61562824564381,4516,0.64747808115207,4532,-0.0318498355082603,-16
"304","4431211",0.57415391494327,6472,0.60506770603026,6764,-0.0309137910869899,-292
"305","1141211",0.793805808365441,351,0.815232255112698,301,-0.0214264467472577,50
"306","2141211",0.730582635857252,1087,0.758857770471875,951,-0.0282751346146233,136
"307","3141211",0.687468427043748,2012,0.730063937272096,1528,-0.0425955102283473,484
"308","4141211",0.645994096343208,3331,0.687653562150285,2824,-0.0416594658070769,507
"309","1241211",0.739848030772445,926,0.759927976166992,935,-0.0200799453945476,-9
"310","2241211",0.676624858264256,2326,0.703553491526169,2294,-0.0269286332619132,32
"311","3241211",0.633510649450752,3795,0.674759658326389,3327,-0.0412490088756372,468
"312","4241211",0.592036318750212,5584,0.632349283204579,5295,-0.0403129644543668,289
"313","1341211",0.711868560495668,1425,0.732877408833694,1468,-0.0210088483380259,-43
"314","2341211",0.64864538798748,3239,0.676502924192871,3273,-0.0278575362053914,-34
"315","3341211",0.605531179173976,4985,0.647709090993091,4518,-0.0421779118191155,467
"316","4341211",0.564056848473436,6965,0.605298715871281,6754,-0.0412418673978451,211
"317","1441211",0.672932062510672,2417,0.692247904865588,2660,-0.019315842354916,-243
"318","2441211",0.609708890002484,4812,0.635873420224765,5128,-0.0261645302222817,-316
"319","3441211",0.56659468118898,6857,0.607079587024986,6648,-0.0404849058360057,209
"320","4441211",0.52512035048844,8996,0.564669211903175,9058,-0.0395488614147353,-62
"321","1112211",0.921066254090101,13,0.916346171816566,15,0.00472008227353493,-2
"322","2112211",0.857843081581912,80,0.859971687175743,95,-0.00212860559383066,-15
"323","3112211",0.814728872768409,224,0.831177853975963,208,-0.0164489812075547,16
"324","4112211",0.773254542067869,516,0.788767478854153,536,-0.0155129367862843,-20
"325","1212211",0.867108476497105,65,0.86104189287086,92,0.00606658362624501,-27
"326","2212211",0.803885303988916,285,0.804667408230036,385,-0.000782104241120574,-100
"327","3212211",0.760771095175412,659,0.775873575030257,681,-0.0151024798548446,-22
"328","4212211",0.719296764474872,1285,0.733463199908447,1450,-0.0141664354335742,-165
"329","1312211",0.839129006220329,126,0.833991325537562,198,0.00513768068276677,-72
"330","2312211",0.77590583371214,491,0.777616840896739,670,-0.00171100718459882,-179
"331","3312211",0.732791624898636,1046,0.748823007696959,1130,-0.0160313827983228,-84
"332","4312211",0.691317294198096,1927,0.706412632575149,2208,-0.0150953383770525,-281
"333","1412211",0.800192508235333,312,0.793361821569456,476,0.00683068666587661,-164
"334","2412211",0.736969335727144,977,0.736987336928633,1374,-1.80012014890929e-05,-397
"335","3412211",0.69385512691364,1847,0.708193503728853,2138,-0.0143383768152131,-291
"336","4412211",0.6523807962131,3108,0.665783128607043,3705,-0.0134023323939427,-597
"337","1122211",0.853086983223681,90,0.855776860159159,105,-0.00268987693547829,-15
"338","2122211",0.789863810715492,380,0.799402375518336,425,-0.00953856480284387,-45
"339","3122211",0.746749601901989,831,0.770608542318556,763,-0.0238589404165679,68
"340","4122211",0.705275271201449,1584,0.728198167196746,1581,-0.0229228959952975,3
"341","1222211",0.799129205630685,319,0.800472581213453,416,-0.0013433755827682,-97
"342","2222211",0.735906033122496,995,0.74409809657263,1229,-0.00819206345013379,-234
"343","3222211",0.692791824308992,1882,0.71530426337285,1925,-0.0225124390638578,-43
"344","4222211",0.651317493608452,3147,0.67289388825104,3398,-0.0215763946425874,-251
"345","1322211",0.771149735353909,539,0.773422013880155,720,-0.00227227852624645,-181
"346","2322211",0.70792656284572,1521,0.717047529239332,1888,-0.00912096639361204,-367
"347","3322211",0.664812354032216,2665,0.688253696039552,2804,-0.0234413420073361,-139
"348","4322211",0.623338023331676,4210,0.645843320917742,4617,-0.0225052975860657,-407
"349","1422211",0.732213237368913,1059,0.732792509912049,1473,-0.000579272543136611,-414
"350","2422211",0.668990064860724,2542,0.676418025271226,3279,-0.00742796041050231,-737
"351","3422211",0.62587585604722,4078,0.647624192071447,4528,-0.0217483360242263,-450
"352","4422211",0.58440152534668,5982,0.605213816949636,6762,-0.0208122916029559,-780
"353","1132211",0.809754461058581,249,0.81731176771113,288,-0.00755730665254906,-39
"354","2132211",0.746531288550392,837,0.760937283070307,920,-0.0144059945199146,-83
"355","3132211",0.703417079736889,1624,0.732143449870528,1491,-0.0287263701336387,133
"356","4132211",0.661942749036349,2760,0.689733074748717,2753,-0.0277903257123683,7
"357","1232211",0.755796683465585,712,0.762007488765424,913,-0.00621080529983897,-201
"358","2232211",0.692573510957396,1891,0.705633004124601,2229,-0.0130594931672046,-338
"359","3232211",0.649459302143893,3215,0.676839170924821,3262,-0.0273798687809286,-47
"360","4232211",0.607984971443353,4894,0.634428795803011,5211,-0.0264438243596582,-317
"361","1332211",0.727817213188809,1118,0.734956921432126,1422,-0.00713970824331722,-304
"362","2332211",0.66459404068062,2672,0.678582436791303,3183,-0.0139883961106828,-511
"363","3332211",0.621479831867117,4272,0.649788603591523,4428,-0.0283087717244068,-156
"364","4332211",0.580005501166577,6203,0.607378228469713,6633,-0.0273727273031364,-430
"365","1432211",0.688880715203813,1969,0.69432741746402,2599,-0.00544670226020738,-630
"366","2432211",0.625657542695624,4090,0.637952932823197,5041,-0.0122953901275731,-951
"367","3432211",0.582543333882121,6060,0.609159099623418,6545,-0.0266157657412971,-485
"368","4432211",0.541069003181581,8172,0.566748724501607,8954,-0.0256797213200267,-782
"369","1142211",0.760720896603752,661,0.776913273584046,676,-0.0161923769802945,-15
"370","2142211",0.697497724095563,1758,0.720538788943223,1792,-0.0230410648476601,-34
"371","3142211",0.654383515282059,3015,0.691744955743444,2681,-0.0373614404613841,334
"372","4142211",0.61290918458152,4662,0.649334580621633,4442,-0.0364253960401137,220
"373","1242211",0.706763119010756,1550,0.72160899463834,1765,-0.0148458756275844,-215
"374","2242211",0.643539946502567,3410,0.665234509997517,3735,-0.02169456349495,-325
"375","3242211",0.600425737689063,5206,0.636440676797737,5101,-0.036014939108674,105
"376","4242211",0.558951406988523,7227,0.594030301675927,7402,-0.0350788946874037,-175
"377","1342211",0.67878364873398,2261,0.694558427305042,2589,-0.0157747785710627,-328
"378","2342211",0.615560476225791,4520,0.638183942664219,5032,-0.0226234664384283,-512
"379","3342211",0.572446267412287,6562,0.609390109464439,6528,-0.0369438420521523,34
"380","4342211",0.530971936711747,8682,0.566979734342629,8941,-0.0360077976308819,-259
"381","1442211",0.639847150748983,3567,0.653928923336936,4239,-0.0140817725879528,-672
"382","2442211",0.576623978240795,6352,0.597554438696113,7208,-0.0209304604553185,-856
"383","3442211",0.533509769427291,8538,0.568760605496334,8848,-0.0352508360690426,-310
"384","4442211",0.492035438726751,10643,0.526350230374523,11181,-0.0343147916477722,-538
"385","1113211",0.882183078517615,41,0.890849581427327,42,-0.00866650290971172,-1
"386","2113211",0.818959906009426,202,0.834475096786504,194,-0.0155151907770773,8
"387","3113211",0.775845697195923,493,0.805681263586724,375,-0.0298355663908013,118
"388","4113211",0.734371366495383,1019,0.763270888464914,887,-0.0288995219695308,132
"389","1213211",0.828225300924619,166,0.835545302481621,185,-0.00732000155700152,-19
"390","2213211",0.76500212841643,609,0.779170817840797,648,-0.0141686894243671,-39
"391","3213211",0.721887919602927,1234,0.750376984641018,1095,-0.0284890650380911,139
"392","4213211",0.680413588902387,2216,0.707966609519208,2146,-0.0275530206168209,70
"393","1313211",0.800245830647843,311,0.808494735148323,354,-0.00824890450047977,-43
"394","2313211",0.737022658139654,976,0.7521202505075,1062,-0.0150975923678454,-86
"395","3313211",0.693908449326151,1846,0.72332641730772,1718,-0.0294179679815694,128
"396","4313211",0.652434118625611,3105,0.68091604218591,3095,-0.0284819235602991,10
"397","1413211",0.761309332662847,653,0.767865231180217,800,-0.00655589851736993,-147
"398","2413211",0.698086160154658,1741,0.711490746539394,2030,-0.0134045863847356,-289
"399","3413211",0.654971951341155,2987,0.682696913339614,3018,-0.0277249619984596,-31
"400","4413211",0.613497620640615,4637,0.640286538217804,4900,-0.0267889175771894,-263
"401","1123211",0.814203807651195,227,0.83028026976992,218,-0.0160764621187249,9
"402","2123211",0.750980635143006,772,0.773905785129097,715,-0.0229251499860905,57
"403","3123211",0.707866426329503,1523,0.745111951929317,1209,-0.0372455255998145,314
"404","4123211",0.666392095628963,2619,0.702701576807507,2331,-0.036309481178544,288
"405","1223211",0.760246030058199,667,0.774975990824214,696,-0.0147299607660147,-29
"406","2223211",0.69702285755001,1775,0.718601506183391,1839,-0.0215786486333803,-64
"407","3223211",0.653908648736507,3036,0.689807672983611,2750,-0.0358990242471043,286
"408","4223211",0.612434318035967,4686,0.647397297861801,4538,-0.0349629798258341,148
"409","1323211",0.732266559781423,1056,0.747925423490916,1150,-0.015658863709493,-94
"410","2323211",0.669043387273234,2539,0.691550938850093,2692,-0.0225075515768586,-153
"411","3323211",0.625929178459731,4073,0.662757105650313,3849,-0.0368279271905826,224
"412","4323211",0.584454847759191,5978,0.620346730528503,5926,-0.0358918827693123,52
"413","1423211",0.693330061796427,1868,0.70729591952281,2174,-0.0139658577263831,-306
"414","2423211",0.630106889288238,3912,0.650921434881987,4372,-0.0208145455937488,-460
"415","3423211",0.586992680474735,5827,0.622127601682208,5825,-0.0351349212074729,2
"416","4423211",0.545518349774195,7933,0.579717226560397,8214,-0.0341988767862026,-281
"417","1133211",0.770871285486096,540,0.791815177321891,496,-0.0209438918357956,44
"418","2133211",0.707648112977907,1530,0.735440692681068,1412,-0.0277925797031612,118
"419","3133211",0.664533904164403,2677,0.706646859481289,2201,-0.0421129553168852,476
"420","4133211",0.623059573463863,4216,0.664236484359478,3787,-0.0411769108956149,429
"421","1233211",0.7169135078931,1321,0.736510898376185,1389,-0.0195973904830856,-68
"422","2233211",0.653690335384911,3046,0.680136413735362,3130,-0.0264460783504512,-84
"423","3233211",0.610576126571407,4769,0.651342580535582,4354,-0.0407664539641752,415
"424","4233211",0.569101795870867,6731,0.608932205413772,6557,-0.0398304095429047,174
"425","1333211",0.688934037616323,1965,0.709460331042887,2102,-0.0205262934265639,-137
"426","2333211",0.625710865108134,4083,0.653085846402064,4278,-0.0273749812939295,-195
"427","3333211",0.582596656294631,6056,0.624292013202284,5706,-0.0416953569076535,350
"428","4333211",0.541122325594091,8167,0.581881638080474,8089,-0.040759312486383,78
"429","1433211",0.649997539631327,3191,0.668830827074781,3575,-0.018833287443454,-384
"430","2433211",0.586774367123138,5837,0.612456342433958,6364,-0.0256819753108197,-527
"431","3433211",0.543660158309635,8029,0.583662509234179,7971,-0.0400023509245437,58
"432","4433211",0.502185827609095,10154,0.541252134112368,10406,-0.0390663065032733,-252
"433","1143211",0.721837721031266,1235,0.751416683194807,1075,-0.0295789621635412,160
"434","2143211",0.658614548523077,2867,0.695042198553984,2577,-0.0364276500309068,290
"435","3143211",0.615500339709574,4525,0.666248365354205,3680,-0.0507480256446308,845
"436","4143211",0.574026009009034,6477,0.623837990232394,5734,-0.0498119812233603,743
"437","1243211",0.66787994343827,2576,0.696112404249101,2535,-0.028232460810831,41
"438","2243211",0.604656770930081,5020,0.639737919608278,4935,-0.0350811486781966,85
"439","3243211",0.561542562116578,7087,0.610944086408498,6440,-0.0494015242919206,647
"440","4243211",0.520068231416038,9233,0.568533711286688,8860,-0.0484654798706503,373
"441","1343211",0.639900473161494,3565,0.669061836915803,3562,-0.0291613637543092,3
"442","2343211",0.576677300653305,6349,0.61268735227498,6351,-0.0360100516216748,-2
"443","3343211",0.533563091839802,8534,0.5838935190752,7953,-0.0503304272353988,581
"444","4343211",0.492088761139261,10640,0.54148314395339,10394,-0.0493943828141286,246
"445","1443211",0.600963975176498,5187,0.628432332947697,5481,-0.0274683577711994,-294
"446","2443211",0.537740802668309,8341,0.572057848306874,8653,-0.0343170456385651,-312
"447","3443211",0.494626593854806,10514,0.543264015107095,10274,-0.0486374212522891,240
"448","4443211",0.453152263154266,12422,0.500853639985284,12449,-0.0477013768310188,-27
"449","1114211",0.829976006547046,160,0.846198968053671,138,-0.0162229615066256,22
"450","2114211",0.766752834038857,585,0.789824483412848,519,-0.0230716493739912,66
"451","3114211",0.723638625225353,1201,0.761030650213068,919,-0.0373920249877152,282
"452","4114211",0.682164294524813,2163,0.718620275091258,1838,-0.0364559805664448,325
"453","1214211",0.776018228954049,487,0.790894689107965,502,-0.0148764601539155,-15
"454","2214211",0.71279505644586,1407,0.734520204467142,1426,-0.0217251480212811,-19
"455","3214211",0.669680847632357,2514,0.705726371267362,2224,-0.0360455236350051,290
"456","4214211",0.628206516931817,3992,0.663315996145552,3824,-0.0351094792137348,168
"457","1314211",0.748038758677273,813,0.763844121774667,874,-0.0158053630973938,-61
"458","2314211",0.684815586169084,2080,0.707469637133844,2165,-0.0226540509647594,-85
"459","3314211",0.641701377355581,3497,0.678675803934064,3181,-0.0369744265784834,316
"460","4314211",0.600227046655041,5220,0.636265428812254,5111,-0.036038382157213,109
"461","1414211",0.709102260692277,1493,0.723214617806561,1721,-0.0141123571142839,-228
"462","2414211",0.645879088184088,3333,0.666840133165738,3655,-0.0209610449816496,-322
"463","3414211",0.602764879370585,5098,0.638046299965959,5038,-0.0352814205953736,60
"464","4414211",0.561290548670045,7104,0.595635924844148,7312,-0.0343453761741033,-208
"465","1124211",0.761996735680626,640,0.785629656396264,572,-0.0236329207156388,68
"466","2124211",0.698773563172437,1719,0.729255171755441,1550,-0.0304816085830044,169
"467","3124211",0.655659354358933,2960,0.700461338555662,2392,-0.0448019841967284,568
"468","4124211",0.614185023658393,4602,0.658050963433851,4052,-0.043865939775458,550
"469","1224211",0.708038958087629,1517,0.730325377450558,1519,-0.0222864193629287,-2
"470","2224211",0.64481578557944,3368,0.673950892809735,3347,-0.0291351072302943,21
"471","3224211",0.601701576765937,5147,0.645157059609955,4646,-0.0434554828440183,501
"472","4224211",0.560227246065397,7164,0.602746684488145,6889,-0.042519438422748,275
"473","1324211",0.680059487810853,2224,0.70327481011726,2306,-0.023215322306407,-82
"474","2324211",0.616836315302664,4463,0.646900325476437,4564,-0.0300640101737726,-101
"475","3324211",0.573722106489161,6493,0.618106492276657,6042,-0.0443843857874966,451
"476","4324211",0.532247775788621,8608,0.575696117154847,8450,-0.0434483413662262,158
"477","1424211",0.641122989825857,3520,0.662645306149154,3852,-0.0215223163232972,-332
"478","2424211",0.577899817317668,6299,0.606270821508331,6684,-0.0283710041906629,-385
"479","3424211",0.534785608504165,8472,0.577476988308552,8350,-0.0426913798043869,122
"480","4424211",0.493311277803625,10578,0.535066613186741,10733,-0.0417553353831165,-155
"481","1134211",0.718664213515526,1293,0.747164563948235,1165,-0.0285003504327096,128
"482","2134211",0.655441041007337,2974,0.690790079307412,2715,-0.0353490383000752,259
"483","3134211",0.612326832193834,4692,0.661996246107633,3884,-0.0496694139137992,808
"484","4134211",0.570852501493294,6643,0.619585870985822,5962,-0.0487333694925288,681
"485","1234211",0.66470643592253,2668,0.691860285002529,2676,-0.0271538490799995,-8
"486","2234211",0.601483263414341,5161,0.635485800361706,5145,-0.0340025369473651,16
"487","3234211",0.558369054600837,7261,0.606691967161927,6664,-0.0483229125610891,597
"488","4234211",0.516894723900297,9414,0.564281592040116,9087,-0.0473868681398187,327
"489","1334211",0.636726965645754,3684,0.664809717669231,3758,-0.0280827520234778,-74
"490","2334211",0.573503793137565,6506,0.608435233028408,6586,-0.0349314398908434,-80
"491","3334211",0.530389584324061,8712,0.579641399828629,8217,-0.0492518155045674,495
"492","4334211",0.488915253623521,10802,0.537231024706818,10624,-0.048315771083297,178
"493","1434211",0.597790467660758,5329,0.624180213701126,5711,-0.0263897460403679,-382
"494","2434211",0.534567295152569,8484,0.567805729060302,8898,-0.0332384339077336,-414
"495","3434211",0.491453086339065,10666,0.539011895860523,10521,-0.0475588095214576,145
"496","4434211",0.449978755638525,12546,0.496601520738713,12638,-0.0466227651001873,-92
"497","1144211",0.669630649060696,2521,0.706766069821151,2191,-0.0371354207604551,330
"498","2144211",0.606407476552507,4961,0.650391585180328,4401,-0.0439841086278207,560
"499","3144211",0.563293267739004,7000,0.621597751980549,5850,-0.0583044842415447,1150
"500","4144211",0.521818937038464,9156,0.579187376858738,8244,-0.0573684398202743,912
"501","1244211",0.6156728714677,4510,0.651461790875445,4341,-0.035788919407745,169
"502","2244211",0.552449698959511,7568,0.595087306234622,7339,-0.0426376072751106,229
"503","3244211",0.509335490146008,9781,0.566293473034842,8976,-0.0569579828888346,805
"504","4244211",0.467861159445468,11781,0.523883097913032,11303,-0.0560219384675642,478
"505","1344211",0.587693401190924,5790,0.624411223542147,5697,-0.0367178223512232,93
"506","2344211",0.524470228682735,9021,0.568036738901324,8883,-0.0435665102185888,138
"507","3344211",0.481356019869232,11163,0.539242905701545,10509,-0.0578868858323128,654
"508","4344211",0.439881689168692,12949,0.496832530579734,12627,-0.0569508414110425,322
"509","1444211",0.548756903205928,7752,0.583781719574041,7962,-0.0350248163681134,-210
"510","2444211",0.485533730697739,10973,0.527407234933218,11124,-0.0418735042354791,-151
"511","3444211",0.442419521884236,12854,0.498613401733439,12562,-0.0561938798492032,292
"512","4444211",0.400945191183696,14281,0.456203026611628,14200,-0.0552578354279328,81
"513","1111311",0.931697186846482,9,0.936615163417543,9,-0.00491797657106163,0
"514","2111311",0.868474014338293,63,0.88024067877672,56,-0.0117666644384272,7
"515","3111311",0.82535980552479,179,0.851446845576941,118,-0.0260870400521512,61
"516","4111311",0.783885474824249,420,0.80903647045513,346,-0.025150995630881,74
"517","1211311",0.877739409253486,47,0.881310884471837,53,-0.00357147521835166,-6
"518","2211311",0.814516236745297,225,0.824936399831014,244,-0.0104201630857172,-19
"519","3211311",0.771402027931793,536,0.796142566631235,454,-0.0247405386994413,82
"520","4211311",0.729927697231253,1094,0.753732191509424,1028,-0.0238044942781708,66
"521","1311311",0.849759938976709,94,0.854260317138539,109,-0.00450037816182991,-15
"522","2311311",0.78653676646852,399,0.797885832497716,432,-0.0113490660291955,-33
"523","3311311",0.743422557655017,877,0.769091999297937,784,-0.0256694416429195,93
"524","4311311",0.701948226954477,1656,0.726681624176126,1623,-0.024733397221649,33
"525","1411311",0.810823440991713,244,0.813630813170434,309,-0.00280737217872007,-65
"526","2411311",0.747600268483525,820,0.75725632852961,976,-0.00965606004608577,-156
"527","3411311",0.704486059670021,1604,0.728462495329831,1574,-0.0239764356598098,30
"528","4411311",0.663011728969481,2729,0.68605212020802,2888,-0.0230403912385393,-159
"529","1121311",0.863717915980062,69,0.876045851760137,63,-0.0123279357800749,6
"530","2121311",0.800494743471873,310,0.819671367119313,274,-0.0191766236474404,36
"531","3121311",0.75738053465837,694,0.790877533919534,504,-0.0334969992611645,190
"532","4121311",0.71590620395783,1349,0.748467158797724,1136,-0.0325609548398942,213
"533","1221311",0.809760138387066,247,0.82074157281443,265,-0.0109814344273649,-18
"534","2221311",0.746536965878877,835,0.764367088173607,864,-0.0178301222947305,-29
"535","3221311",0.703422757065373,1623,0.735573254973828,1408,-0.0321504979084545,215
"536","4221311",0.661948426364833,2759,0.693162879852017,2636,-0.031214453487184,123
"537","1321311",0.78178066811029,432,0.793691005481133,471,-0.0119103373708431,-39
"538","2321311",0.718557495602101,1296,0.737316520840309,1366,-0.0187590252382087,-70
"539","3321311",0.675443286788597,2353,0.70852268764053,2130,-0.0330794008519327,223
"540","4321311",0.633968956088057,3777,0.66611231251872,3690,-0.0321433564306622,87
"541","1421311",0.742844170125293,884,0.753061501513027,1040,-0.0102173313877333,-156
"542","2421311",0.679620997617105,2238,0.696687016872204,2517,-0.017066019255099,-279
"543","3421311",0.636506788803601,3698,0.667893183672424,3617,-0.031386394868823,81
"544","4421311",0.595032458103061,5469,0.625482808550614,5639,-0.0304503504475525,-170
"545","1131311",0.820385393814962,195,0.837580759312108,177,-0.0171953654971457,18
"546","2131311",0.757162221306773,695,0.781206274671285,621,-0.0240440533645113,74
"547","3131311",0.71404801249327,1385,0.752412441471505,1054,-0.0383644289782353,331
"548","4131311",0.67257368179273,2430,0.710002066349695,2083,-0.0374283845569648,347
"549","1231311",0.766427616221966,592,0.782276480366402,607,-0.0158488641444355,-15
"550","2231311",0.703204443713777,1627,0.725901995725578,1642,-0.0226975520118011,-15
"551","3231311",0.660090234900274,2810,0.697108162525799,2504,-0.0370179276255251,306
"552","4231311",0.618615904199734,4398,0.654697787403989,4202,-0.0360818832042549,196
"553","1331311",0.73844814594519,951,0.755225913033104,1005,-0.0167777670879138,-54
"554","2331311",0.675224973437001,2357,0.69885142839228,2445,-0.0236264549552794,-88
"555","3331311",0.632110764623498,3840,0.670057595192501,3507,-0.0379468305690034,333
"556","4331311",0.590636433922958,5653,0.627647220070691,5529,-0.0370107861477331,124
"557","1431311",0.699511647960194,1705,0.714596409064998,1945,-0.0150847611048039,-240
"558","2431311",0.636288475452005,3704,0.658221924424175,4041,-0.0219334489721696,-337
"559","3431311",0.593174266638502,5546,0.629428091224395,5437,-0.0362538245858937,109
"560","4431311",0.551699935937962,7615,0.587017716102585,7774,-0.0353177801646234,-159
"561","1141311",0.771351829360133,537,0.797182265185024,440,-0.0258304358248911,97
"562","2141311",0.708128656851944,1516,0.7408077805442,1296,-0.0326791236922567,220
"563","3141311",0.66501444803844,2659,0.712013947344421,2010,-0.0469994993059807,649
"564","4141311",0.6235401173379,4202,0.669603572222611,3532,-0.0460634548847104,670
"565","1241311",0.717394051767136,1318,0.741877986239318,1272,-0.0244839344721811,46
"566","2241311",0.654170879258948,3025,0.685503501598494,2910,-0.0313326223395467,115
"567","3241311",0.611056670445444,4753,0.656709668398715,4120,-0.0456529979532707,633
"568","4241311",0.569582339744904,6717,0.614299293276904,6249,-0.0447169535320002,468
"569","1341311",0.68941458149036,1957,0.71482741890602,1939,-0.0254128374156594,18
"570","2341311",0.626191408982171,4069,0.658452934265196,4031,-0.032261525283025,38
"571","3341311",0.583077200168668,6045,0.629659101065417,5426,-0.046581900896749,619
"572","4341311",0.541602869468128,8140,0.587248725943607,7758,-0.0456458564754785,382
"573","1441311",0.650478083505364,3169,0.674197914937914,3340,-0.0237198314325495,-171
"574","2441311",0.587254910997175,5819,0.617823430297091,6057,-0.0305685192999152,-238
"575","3441311",0.544140702183672,8011,0.589029597097311,7656,-0.0448888949136392,355
"576","4441311",0.502666371483132,10130,0.546619221975501,10075,-0.0439528504923687,55
"577","1112311",0.898612275084793,27,0.898296181888891,30,0.000316093195901535,-3
"578","2112311",0.835389102576604,140,0.841921697248068,158,-0.00653259467146405,-18
"579","3112311",0.792274893763101,362,0.813127864048289,312,-0.0208529702851881,50
"580","4112311",0.75080056306256,776,0.770717488926478,760,-0.0199169258639178,16
"581","1212311",0.844654497491797,113,0.842991902943185,152,0.00166259454861151,-39
"582","2212311",0.781431324983608,438,0.786617418302362,560,-0.00518609331875408,-122
"583","3212311",0.738317116170104,954,0.757823585102582,964,-0.0195064689324781,-10
"584","4212311",0.696842785469564,1780,0.715413209980772,1920,-0.0185704245112076,-140
"585","1312311",0.81667502721502,213,0.815941335609887,296,0.000733691605133258,-83
"586","2312311",0.753451854706832,743,0.759566850969064,939,-0.00611499626223233,-196
"587","3312311",0.710337645893328,1465,0.730773017769284,1515,-0.0204353718759563,-50
"588","4312311",0.668863315192788,2546,0.688362642647474,2799,-0.0194993274546859,-253
"589","1412311",0.777738529230025,472,0.775311831641781,691,0.0024266975882431,-219
"590","2412311",0.714515356721836,1378,0.718937347000958,1829,-0.0044219902791226,-451
"591","3412311",0.671401147908332,2464,0.690143513801179,2736,-0.0187423658928466,-272
"592","4412311",0.629926817207792,3918,0.647733138679368,4515,-0.0178063214715761,-597
"593","1122311",0.830633004218373,157,0.837726870231485,175,-0.00709386601311168,-18
"594","2122311",0.767409831710184,580,0.781352385590661,620,-0.0139425538804773,-40
"595","3122311",0.724295622896681,1190,0.752558552390882,1050,-0.0282629294942013,140
"596","4122311",0.68282129219614,2141,0.710148177269072,2078,-0.027326885072931,63
"597","1222311",0.776675226625377,481,0.782422591285778,602,-0.00574736466040171,-121
"598","2222311",0.713452054117188,1399,0.726048106644955,1639,-0.0125960525277673,-240
"599","3222311",0.670337845303684,2496,0.697254273445176,2498,-0.0269164281414913,-2
"600","4222311",0.628863514603144,3969,0.654843898323365,4196,-0.0259803837202208,-227
"601","1322311",0.7486957563486,802,0.75537202395248,1002,-0.00667626760387996,-200
"602","2322311",0.685472583840412,2070,0.698997539311657,2442,-0.0135249554712455,-372
"603","3322311",0.642358375026908,3470,0.670203706111878,3502,-0.0278453310849696,-32
"604","4322311",0.600884044326368,5189,0.627793330990067,5521,-0.0269092866636991,-332
"605","1422311",0.709759258363605,1478,0.714742519984375,1942,-0.00498326162077012,-464
"606","2422311",0.646536085855416,3316,0.658368035343551,4036,-0.0118319494881358,-720
"607","3422311",0.603421877041912,5070,0.629574202143772,5430,-0.0261523251018598,-360
"608","4422311",0.561947546341372,7067,0.587163827021962,7765,-0.0252162806805893,-698
"609","1132311",0.787300482053273,393,0.799261777783456,426,-0.0119612957301826,-33
"610","2132311",0.724077309545084,1191,0.742887293142632,1248,-0.0188099835975482,-57
"611","3132311",0.680963100731581,2198,0.714093459942853,1962,-0.0331303592112722,236
"612","4132311",0.639488770031041,3586,0.671683084821043,3450,-0.0321943147900017,136
"613","1232311",0.733342704460277,1037,0.74395749883775,1233,-0.0106147943774724,-196
"614","2232311",0.670119531952088,2501,0.687583014196926,2829,-0.017463482244838,-328
"615","3232311",0.627005323138585,4036,0.658789180997147,4021,-0.031783857858562,15
"616","4232311",0.585530992438045,5921,0.616378805875336,6148,-0.0308478134372917,-227
"617","1332311",0.705363234183501,1582,0.716906931504452,1890,-0.0115436973209506,-308
"618","2332311",0.642140061675312,3478,0.660532446863628,3949,-0.0183923851883162,-471
"619","3332311",0.599025852861809,5277,0.631738613663849,5329,-0.0327127608020402,-52
"620","4332311",0.557551522161269,7300,0.589328238542039,7642,-0.03177671638077,-342
"621","1432311",0.666426736198505,2617,0.676277427536346,3280,-0.00985069133784078,-663
"622","2432311",0.603203563690316,5080,0.619902942895523,5941,-0.0166993792052065,-861
"623","3432311",0.560089354876813,7170,0.591109109695743,7544,-0.0310197548189305,-374
"624","4432311",0.518615024176273,9305,0.548698734573933,9965,-0.0300837103976602,-660
"625","1142311",0.738266917598444,955,0.758863283656372,950,-0.0205963660579279,5
"626","2142311",0.675043745090255,2361,0.702488799015548,2338,-0.0274450539252935,23
"627","3142311",0.631929536276751,3846,0.673694965815769,3363,-0.0417654295390175,483
"628","4142311",0.590455205576211,5668,0.631284590693959,5345,-0.0408293851177473,323
"629","1242311",0.684309140005448,2097,0.703559004710665,2293,-0.0192498647052179,-196
"630","2242311",0.621085967497259,4285,0.647184520069842,4550,-0.0260985525725835,-265
"631","3242311",0.577971758683755,6296,0.618390686870063,6026,-0.0404189281863075,270
"632","4242311",0.536497427983215,8396,0.575980311748252,8427,-0.0394828837650371,-31
"633","1342311",0.656329669728671,2944,0.676508437377368,3272,-0.0201787676486962,-328
"634","2342311",0.593106497220482,5548,0.620133952736544,5933,-0.0270274555160618,-385
"635","3342311",0.549992288406979,7704,0.591340119536765,7537,-0.0413478311297858,167
"636","4342311",0.508517957706439,9821,0.548929744414954,9955,-0.0404117867085153,-134
"637","1442311",0.617393171743675,4449,0.635878933409262,5127,-0.0184857616655864,-678
"638","2442311",0.554169999235486,7494,0.579504448768439,8225,-0.0253344495329521,-731
"639","3442311",0.511055790421983,9718,0.550710615568659,9858,-0.0396548251466761,-140
"640","4442311",0.469581459721443,11713,0.508300240446849,12095,-0.0387187807254056,-382
"641","1113311",0.859729099512307,75,0.872799591499652,71,-0.0130704919873451,4
"642","2113311",0.796505927004118,333,0.816425106858829,293,-0.0199191798547107,40
"643","3113311",0.753391718190615,744,0.78763127365905,549,-0.0342395554684347,195
"644","4113311",0.711917387490075,1424,0.745220898537239,1205,-0.0333035110471642,219
"645","1213311",0.805771321919311,273,0.817495312553946,286,-0.0117239906346349,-13
"646","2213311",0.742548149411122,889,0.761120827913123,918,-0.0185726785020005,-29
"647","3213311",0.699433940597619,1709,0.732326994713343,1486,-0.0328930541157245,223
"648","4213311",0.657959609897079,2891,0.689916619591533,2744,-0.0319570096944543,147
"649","1313311",0.777791851642535,470,0.790444745220648,513,-0.0126528935781132,-43
"650","2313311",0.714568679134346,1376,0.734070260579825,1436,-0.0195015814454788,-60
"651","3313311",0.671454470320843,2460,0.705276427380045,2243,-0.0338219570592028,217
"652","4313311",0.629980139620303,3915,0.662866052258235,3847,-0.0328859126379325,68
"653","1413311",0.738855353657539,937,0.749815241252542,1105,-0.0109598875950033,-168
"654","2413311",0.67563218114935,2346,0.693440756611719,2627,-0.017808575462369,-281
"655","3413311",0.632517972335847,3827,0.66464692341194,3769,-0.032128951076093,58
"656","4413311",0.591043641635307,5629,0.622236548290129,5818,-0.0311929066548228,-189
"657","1123311",0.791749828645887,364,0.812230279842246,321,-0.0204804511963583,43
"658","2123311",0.728526656137698,1112,0.755855795201422,998,-0.0273291390637239,114
"659","3123311",0.685412447324195,2073,0.727061962001643,1611,-0.0416495146774479,462
"660","4123311",0.643938116623655,3398,0.684651586879833,2942,-0.0407134702561774,456
"661","1223311",0.737792051052891,960,0.756926000896539,978,-0.0191339498436481,-18
"662","2223311",0.674568878544702,2382,0.700551516255716,2389,-0.0259826377110137,-7
"663","3223311",0.631454669731199,3863,0.671757683055937,3446,-0.0403030133247377,417
"664","4223311",0.589980339030659,5690,0.629347307934126,5441,-0.0393669689034675,249
"665","1323311",0.709812580776115,1472,0.729875433563241,1536,-0.0200628527871264,-64
"666","2323311",0.646589408267926,3311,0.673500948922418,3375,-0.026911540654492,-64
"667","3323311",0.603475199454423,5064,0.644707115722639,4668,-0.041231916268216,396
"668","4323311",0.562000868753883,7062,0.602296740600828,6917,-0.0402958718469457,145
"669","1423311",0.670876082791119,2474,0.689245929595136,2765,-0.0183698468040165,-291
"670","2423311",0.60765291028293,4905,0.632871444954312,5275,-0.0252185346713822,-370
"671","3423311",0.564538701469427,6948,0.604077611754533,6822,-0.0395389102851063,126
"672","4423311",0.523064370768887,9088,0.561667236632723,9232,-0.038602865863836,-144
"673","1133311",0.748417306480788,809,0.773765187394217,717,-0.025347880913429,92
"674","2133311",0.685194133972599,2076,0.717390702753393,1876,-0.0321965687807946,200
"675","3133311",0.642079925159095,3481,0.688596869553614,2789,-0.0465169443945186,692
"676","4133311",0.600605594458555,5201,0.646186494431804,4598,-0.0455808999732483,603
"677","1233311",0.694459528887791,1833,0.71846090844851,1844,-0.024001379560719,-11
"678","2233311",0.631236356379603,3871,0.662086423807687,3876,-0.0308500674280846,-5
"679","3233311",0.588122147566099,5773,0.633292590607908,5254,-0.0451704430418086,519
"680","4233311",0.546647816865559,7865,0.590882215486097,7553,-0.0442343986205381,312
"681","1333311",0.666480058611015,2615,0.691410341115213,2695,-0.0249302825041973,-80
"682","2333311",0.603256886102826,5077,0.635035856474389,5176,-0.0317789703715629,-99
"683","3333311",0.560142677289323,7168,0.60624202327461,6685,-0.0460993459852869,483
"684","4333311",0.518668346588783,9297,0.5638316481528,9115,-0.0451633015640164,182
"685","1433311",0.627543560626019,4015,0.650780837147107,4380,-0.0232372765210874,-365
"686","2433311",0.56432038811783,6958,0.594406352506284,7378,-0.0300859643884531,-420
"687","3433311",0.521206179304327,9186,0.565612519306504,9009,-0.0444063400021771,177
"688","4433311",0.479731848603787,11229,0.523202144184694,11335,-0.0434702955809067,-106
"689","1143311",0.699383742025958,1710,0.733366693267133,1457,-0.0339829512411746,253
"690","2143311",0.636160569517769,3709,0.676992208626309,3250,-0.0408316391085402,459
"691","3143311",0.593046360704266,5550,0.64819837542653,4492,-0.0551520147222642,1058
"692","4143311",0.551572030003726,7620,0.60578800030472,6717,-0.0542159703009937,903
"693","1243311",0.645425964432962,3352,0.678062414321426,3207,-0.0326364498884644,145
"694","2243311",0.582202791924773,6087,0.621687929680603,5848,-0.03948513775583,239
"695","3243311",0.53908858311127,8274,0.592894096480824,7462,-0.053805513369554,812
"696","4243311",0.49761425241073,10382,0.550483721359013,9871,-0.0528694689482838,511
"697","1343311",0.617446494156186,4445,0.651011846988129,4368,-0.0335653528319426,77
"698","2343311",0.554223321647997,7492,0.594637362347305,7362,-0.0404140406993082,130
"699","3343311",0.511109112834494,9714,0.565843529147526,8997,-0.0547344163130322,717
"700","4343311",0.469634782133953,11708,0.523433154025715,11326,-0.053798371891762,382
"701","1443311",0.57850999617119,6274,0.610382343020023,6465,-0.0318723468488328,-191
"702","2443311",0.515286823663001,9506,0.5540078583792,9683,-0.0387210347161985,-177
"703","3443311",0.472172614849498,11609,0.52521402517942,11238,-0.0530414103299225,371
"704","4443311",0.430698284148957,13314,0.48280365005761,13223,-0.0521053659086522,91
"705","1114311",0.807522027541737,263,0.828148978125997,224,-0.0206269505842591,39
"706","2114311",0.744298855033549,862,0.771774493485173,741,-0.0274756384516247,121
"707","3114311",0.701184646220045,1671,0.742980660285394,1247,-0.0417960140653487,424
"708","4114311",0.659710315519505,2820,0.700570285163583,2388,-0.0408599696440782,432
"709","1214311",0.753564249948741,741,0.77284469918029,728,-0.0192804492315489,13
"710","2214311",0.690341077440553,1945,0.716470214539467,1899,-0.0261291370989145,46
"711","3214311",0.647226868627049,3295,0.687676381339688,2823,-0.0404495127126385,472
"712","4214311",0.605752537926509,4979,0.645266006217877,4640,-0.0395134682913683,339
"713","1314311",0.725584779671965,1170,0.745794131846992,1193,-0.0202093521750272,-23
"714","2314311",0.662361607163776,2751,0.689419647206169,2762,-0.0270580400423928,-11
"715","3314311",0.619247398350273,4376,0.66062581400639,3946,-0.0413784156561168,430
"716","4314311",0.577773067649733,6306,0.618215438884579,6038,-0.0404423712348465,268
"717","1414311",0.686648281686969,2034,0.705164627878887,2246,-0.0185163461919173,-212
"718","2414311",0.62342510917878,4206,0.648790143238063,4461,-0.025365034059283,-255
"719","3414311",0.580310900365277,6187,0.619996310038284,5938,-0.039685409673007,249
"720","4414311",0.538836569664737,8287,0.577585934916474,8344,-0.0387493652517368,-57
"721","1124311",0.739542756675317,932,0.76757966646859,806,-0.0280369097932723,126
"722","2124311",0.676319584167129,2334,0.711205181827766,2041,-0.0348855976606379,293
"723","3124311",0.633205375353625,3804,0.682411348627987,3027,-0.0492059732743619,777
"724","4124311",0.591731044653085,5595,0.640000973506177,4918,-0.0482699288530914,677
"725","1224311",0.685584979082321,2067,0.712275387522884,1997,-0.0266904084405621,70
"726","2224311",0.622361806574133,4251,0.65590090288206,4150,-0.0335390963079277,101
"727","3224311",0.579247597760629,6244,0.627107069682281,5556,-0.0478594719216517,688
"728","4224311",0.537773267060089,8339,0.58469669456047,7908,-0.0469234275003815,431
"729","1324311",0.657605508805545,2899,0.685224820189586,2918,-0.0276193113840404,-19
"730","2324311",0.594382336297356,5498,0.628850335548762,5462,-0.034467999251406,36
"731","3324311",0.551268127483853,7640,0.600056502348983,7055,-0.04878837486513,585
"732","4324311",0.509793796783313,9764,0.557646127227173,9468,-0.0478523304438597,296
"733","1424311",0.618669010820549,4393,0.64459531622148,4672,-0.0259263054009305,-279
"734","2424311",0.55544583831236,7429,0.588220831580657,7700,-0.0327749932682962,-271
"735","3424311",0.512331629498857,9653,0.559426998380877,9365,-0.0470953688820203,288
"736","4424311",0.470857298798317,11654,0.517016623259067,11664,-0.0461593244607499,-10
"737","1134311",0.696210234510218,1790,0.729114574020561,1554,-0.032904339510343,236
"738","2134311",0.632987062002029,3811,0.672740089379738,3404,-0.0397530273777086,407
"739","3134311",0.589872853188526,5695,0.643946256179958,4706,-0.0540734029914326,989
"740","4134311",0.548398522487985,7770,0.601535881058148,6960,-0.0531373585701623,810
"741","1234311",0.642252456917222,3475,0.673810295074855,3355,-0.031557838157633,120
"742","2234311",0.579029284409033,6255,0.617435810434031,6077,-0.0384065260249986,178
"743","3234311",0.535915075595529,8426,0.588641977234252,7679,-0.0527269016387226,747
"744","4234311",0.494440744894989,10521,0.546231602112442,10099,-0.0517908572174522,422
"745","1334311",0.614272986640445,4595,0.646759727741557,4574,-0.0324867411011113,21
"746","2334311",0.551049814132257,7654,0.590385243100733,7580,-0.0393354289684769,74
"747","3334311",0.507935605318753,9861,0.561591409900954,9239,-0.0536558045822009,622
"748","4334311",0.466461274618213,11835,0.519181034779144,11549,-0.0527197601609304,286
"749","1434311",0.57533648865545,6412,0.606130223773451,6692,-0.0307937351180014,-280
"750","2434311",0.512113316147261,9666,0.549755739132628,9904,-0.0376424229853671,-238
"751","3434311",0.468999107333757,11740,0.520961905932848,11446,-0.0519627985990911,294
"752","4434311",0.427524776633217,13410,0.478551530811038,13390,-0.0510267541778208,20
"753","1144311",0.647176670055388,3298,0.688716079893477,2786,-0.0415394098380886,512
"754","2144311",0.583953497547199,6004,0.632341595252654,5296,-0.0483880977054542,708
"755","3144311",0.540839288733696,8187,0.603547762052874,6847,-0.0627084733191782,1340
"756","4144311",0.499364958033156,10297,0.561137386931064,9259,-0.0617724288979077,1038
"757","1244311",0.593218892462392,5542,0.633411800947771,5250,-0.0401929084853784,292
"758","2244311",0.529995719954203,8736,0.577037316306947,8371,-0.047041596352744,365
"759","3244311",0.4868815111407,10912,0.548243483107168,9997,-0.061361971966468,915
"760","4244311",0.44540718044016,12739,0.505833107985358,12212,-0.0604259275451977,527
"761","1344311",0.565239422185616,6926,0.606361233614473,6680,-0.0411218114288566,246
"762","2344311",0.502016249677427,10168,0.549986748973649,9894,-0.0479704992962222,274
"763","3344311",0.458902040863924,12195,0.52119291577387,11435,-0.0622908749099463,760
"764","4344311",0.417427710163384,13770,0.47878254065206,13383,-0.061354830488676,387
"765","1444311",0.52630292420062,8942,0.565731729646367,9002,-0.0394288054457468,-60
"766","2444311",0.463079751692431,11997,0.509357245005544,12047,-0.0462774933131125,-50
"767","3444311",0.419965542878928,13696,0.480563411805764,13317,-0.0605978689268366,379
"768","4444311",0.378491212178388,14870,0.438153036683954,14754,-0.0596618245055662,116
"769","1111411",0.901905169834334,21,0.902490023580428,25,-0.00058485374609385,-4
"770","2111411",0.838681997326145,129,0.846115538939605,139,-0.00743354161345944,-10
"771","3111411",0.795567788512642,337,0.817321705739825,287,-0.0217539172271835,50
"772","4111411",0.754093457812102,731,0.774911330618015,699,-0.0208178728059131,32
"773","1211411",0.847947392241338,98,0.847185744634722,136,0.000761647606616234,-38
"774","2211411",0.784724219733149,407,0.790811259993899,506,-0.00608704026074935,-99
"775","3211411",0.741610010919646,897,0.762017426794119,912,-0.0204074158744734,-15
"776","4211411",0.700135680219106,1688,0.719607051672309,1814,-0.019471371453203,-126
"777","1311411",0.819967921964562,197,0.820135177301424,271,-0.000167255336862016,-74
"778","2311411",0.756744749456373,701,0.763760692660601,876,-0.0070159432042276,-175
"779","3311411",0.71363054064287,1394,0.734966859460821,1421,-0.0213363188179516,-27
"780","4311411",0.67215620994233,2441,0.692556484339011,2655,-0.0204002743966812,-214
"781","1411411",0.781031423979566,443,0.779505673333318,643,0.00152575064624783,-200
"782","2411411",0.717808251471377,1312,0.723131188692495,1722,-0.00532293722111787,-410
"783","3411411",0.674694042657874,2377,0.694337355492716,2598,-0.0196433128348419,-221
"784","4411411",0.633219711957334,3803,0.651926980370905,4324,-0.0187072684135715,-521
"785","1121411",0.833925898967914,146,0.841920711923021,159,-0.00799481295510707,-13
"786","2121411",0.770702726459725,546,0.785546227282198,574,-0.0148435008224727,-28
"787","3121411",0.727588517646222,1126,0.756752394082419,981,-0.0291638764361967,145
"788","4121411",0.686114186945682,2054,0.714342018960608,1954,-0.0282278320149263,100
"789","1221411",0.779968121374918,450,0.786616432977315,561,-0.00664831160239698,-111
"790","2221411",0.716744948866729,1327,0.730241948336492,1525,-0.0134969994697626,-198
"791","3221411",0.673630740053226,2397,0.701448115136712,2369,-0.0278173750834866,28
"792","4221411",0.632156409352686,3838,0.659037740014902,4010,-0.0268813306622162,-172
"793","1321411",0.751988651098142,759,0.759565865644017,940,-0.00757721454587523,-181
"794","2321411",0.688765478589953,1974,0.703191381003194,2309,-0.0144259024132408,-335
"795","3321411",0.64565126977645,3342,0.674397547803415,3335,-0.0287462780269648,7
"796","4321411",0.60417693907591,5043,0.631987172681604,5319,-0.0278102336056945,-276
"797","1421411",0.713052153113146,1406,0.718936361675911,1830,-0.00588420856276539,-424
"798","2421411",0.649828980604957,3198,0.662561877035088,3856,-0.0127328964301311,-658
"799","3421411",0.606714771791454,4945,0.633768043835309,5233,-0.0270532720438551,-288
"800","4421411",0.565240441090914,6925,0.591357668713498,7534,-0.0261172276225847,-609
"801","1131411",0.790593376802815,373,0.803455619474993,396,-0.0128622426721778,-23
"802","2131411",0.727370204294626,1129,0.747081134834169,1168,-0.0197109305395434,-39
"803","3131411",0.684255995481122,2100,0.71828730163439,1852,-0.0340313061532674,248
"804","4131411",0.642781664780582,3454,0.67587692651258,3292,-0.0330952617319971,162
"805","1231411",0.736635599209819,981,0.748151340529286,1143,-0.0115157413194678,-162
"806","2231411",0.67341242670163,2404,0.691776855888463,2680,-0.0183644291868333,-276
"807","3231411",0.630298217888126,3905,0.662983022688684,3843,-0.0326848048005574,62
"808","4231411",0.588823887187586,5739,0.620572647566873,5910,-0.031748760379287,-171
"809","1331411",0.708656128933042,1503,0.721100773195988,1778,-0.012444644262946,-275
"810","2331411",0.645432956424854,3351,0.664726288555165,3762,-0.0192933321303116,-411
"811","3331411",0.60231874761135,5122,0.635932455355386,5125,-0.0336137077440356,-3
"812","4331411",0.56084441691081,7126,0.593522080233575,7430,-0.0326776633227652,-304
"813","1431411",0.669719630948046,2512,0.680471269227883,3114,-0.0107516382798362,-602
"814","2431411",0.606496458439858,4954,0.624096784587059,5717,-0.0176003261472019,-763
"815","3431411",0.563382249626354,6996,0.59530295138728,7328,-0.0319207017609259,-332
"816","4431411",0.521907918925814,9153,0.55289257626547,9751,-0.0309846573396555,-598
"817","1141411",0.741559812347985,900,0.763057125347908,891,-0.0214973129999233,9
"818","2141411",0.678336639839796,2281,0.706682640707085,2198,-0.0283460008672889,83
"819","3141411",0.635222431026293,3737,0.677888807507306,3212,-0.0426663764810129,525
"820","4141411",0.593748100325753,5519,0.635478432385495,5146,-0.0417303320597425,373
"821","1241411",0.687602034754989,2006,0.707752846402202,2156,-0.0201508116472132,-150
"822","2241411",0.6243788622468,4163,0.651378361761379,4349,-0.0269994995145788,-186
"823","3241411",0.581264653433297,6134,0.6225845285616,5805,-0.0413198751283028,329
"824","4241411",0.539790322732757,8240,0.580174153439789,8178,-0.0403838307070324,62
"825","1341411",0.659622564478213,2825,0.680702279068904,3102,-0.0210797145906915,-277
"826","2341411",0.596399391970024,5401,0.624327794428081,5704,-0.0279284024580571,-303
"827","3341411",0.553285183156521,7528,0.595533961228302,7316,-0.0422487780717811,212
"828","4341411",0.511810852455981,9679,0.553123586106491,9736,-0.0413127336505107,-57
"829","1441411",0.620686066493217,4302,0.640072775100799,4912,-0.0193867086075816,-610
"830","2441411",0.557462893985028,7310,0.583698290459975,7966,-0.0262353964749473,-656
"831","3441411",0.514348685171525,9547,0.554904457260196,9630,-0.0405557720886713,-83
"832","4441411",0.472874354470985,11571,0.512494082138386,11903,-0.0396197276674009,-332
"833","1112411",0.868820258072645,61,0.864171042051776,86,0.00464921602086932,-25
"834","2112411",0.805597085564457,276,0.807796557410953,358,-0.00219947184649627,-82
"835","3112411",0.762482876750953,635,0.779002724211173,650,-0.0165198474602203,-15
"836","4112411",0.721008546050413,1252,0.736592349089363,1385,-0.0155838030389499,-133
"837","1212411",0.814862480479649,220,0.80886676310607,350,0.0059957173735794,-130
"838","2212411",0.75163930797146,761,0.752492278465247,1053,-0.000852970493786187,-292
"839","3212411",0.708525099157957,1506,0.723698445265467,1708,-0.0151733461075102,-202
"840","4212411",0.667050768457417,2595,0.681288070143657,3082,-0.0142373016862398,-487
"841","1312411",0.786883010202873,395,0.781816195772772,615,0.00506681443010115,-220
"842","2312411",0.723659837694684,1199,0.725441711131949,1660,-0.00178187343726444,-461
"843","3312411",0.680545628881181,2211,0.696647877932169,2519,-0.0161022490509884,-308
"844","4312411",0.639071298180641,3603,0.654237502810359,4226,-0.0151662046297181,-623
"845","1412411",0.747946512217877,816,0.741186691804666,1286,0.00675982041321099,-470
"846","2412411",0.684723339709688,2085,0.684812207163843,2935,-8.88674541547063e-05,-850
"847","3412411",0.641609130896185,3503,0.656018373964063,4143,-0.0144092430678787,-640
"848","4412411",0.600134800195645,5230,0.613607998842253,6289,-0.0134731986466083,-1059
"849","1122411",0.800840987206225,307,0.803601730394369,395,-0.0027607431881439,-88
"850","2122411",0.737617814698037,967,0.747227245753546,1164,-0.00960943105550949,-197
"851","3122411",0.694503605884533,1830,0.718433412553767,1845,-0.0239298066692335,-15
"852","4122411",0.653029275183993,3075,0.676023037431956,3289,-0.0229937622479631,-214
"853","1222411",0.746883209613229,827,0.748297451448663,1140,-0.00141424183543382,-313
"854","2222411",0.68366003710504,2112,0.69192296680784,2674,-0.0082629297027994,-562
"855","3222411",0.640545828291537,3542,0.66312913360806,3831,-0.0225833053165234,-289
"856","4222411",0.599071497590997,5275,0.62071875848625,5899,-0.021647260895253,-624
"857","1322411",0.718903739336453,1290,0.721246884115365,1775,-0.00234314477891207,-485
"858","2322411",0.655680566828264,2958,0.664872399474542,3756,-0.00919183264627765,-798
"859","3322411",0.612566358014761,4681,0.636078566274762,5119,-0.0235122082600017,-438
"860","4322411",0.571092027314221,6636,0.593668191152952,7426,-0.0225761638387313,-790
"861","1422411",0.679967241351457,2230,0.680617380147259,3107,-0.000650138795802224,-877
"862","2422411",0.616744068843268,4469,0.624242895506436,5709,-0.00749882666316792,-1240
"863","3422411",0.573629860029765,6500,0.595449062306657,7320,-0.0218192022768919,-820
"864","4422411",0.532155529329225,8616,0.553038687184846,9743,-0.0208831578556216,-1127
"865","1132411",0.757508465041126,692,0.76513663794634,854,-0.00762817290521467,-162
"866","2132411",0.694285292532937,1836,0.708762153305517,2123,-0.0144768607725803,-287
"867","3132411",0.651171083719433,3151,0.679968320105738,3140,-0.0287972363863043,11
"868","4132411",0.609696753018893,4813,0.637557944983927,5059,-0.0278611919650339,-246
"869","1232411",0.70355068744813,1619,0.709832359000634,2089,-0.00628167155250459,-470
"870","2232411",0.640327514939941,3551,0.653457874359811,4265,-0.0131303594198702,-714
"871","3232411",0.597213306126437,5364,0.624664041160031,5684,-0.0274507350335942,-320
"872","4232411",0.555738975425897,7414,0.582253666038221,8068,-0.0265146906123238,-654
"873","1332411",0.675571217171353,2350,0.682781791667336,3014,-0.00721057449598284,-664
"874","2332411",0.612348044663165,4689,0.626407307026513,5595,-0.0140592623633484,-906
"875","3332411",0.569233835849661,6729,0.597613473826734,7199,-0.0283796379770724,-470
"876","4332411",0.527759505149121,8855,0.555203098704923,9615,-0.0274435935558021,-760
"877","1432411",0.636634719186358,3689,0.64215228769923,4805,-0.00551756851287299,-1116
"878","2432411",0.573411546678169,6511,0.585777803058407,7845,-0.0123662563802387,-1334
"879","3432411",0.530297337864665,8718,0.556983969858628,9509,-0.0266866319939627,-791
"880","4432411",0.488823007164125,10809,0.514573594736818,11800,-0.0257505875726923,-991
"881","1142411",0.708474900586296,1510,0.724738143819256,1682,-0.0162632432329601,-172
"882","2142411",0.645251728078107,3360,0.668363659178433,3602,-0.0231119311003257,-242
"883","3142411",0.602137519264604,5128,0.639569825978654,4949,-0.0374323067140497,179
"884","4142411",0.560663188564064,7138,0.597159450856843,7225,-0.0364962622927794,-87
"885","1242411",0.6545171229933,3010,0.66943386487355,3545,-0.01491674188025,-535
"886","2242411",0.591293950485111,5618,0.613059380232727,6328,-0.0217654297476156,-710
"887","3242411",0.548179741671608,7780,0.584265547032947,7935,-0.0360858053613397,-155
"888","4242411",0.506705410971068,9917,0.541855171911137,10366,-0.0351497609400693,-449
"889","1342411",0.626537652716524,4056,0.642383297540252,4796,-0.0158456448237283,-740
"890","2342411",0.563314480208335,6997,0.586008812899429,7835,-0.0226943326910939,-838
"891","3342411",0.520200271394832,9228,0.55721497969965,9501,-0.0370147083048179,-273
"892","4342411",0.478725940694292,11287,0.514804604577839,11791,-0.0360786638835475,-504
"893","1442411",0.587601154731528,5799,0.601753793572146,6947,-0.0141526388406185,-1148
"894","2442411",0.524377982223339,9027,0.545379308931323,10152,-0.0210013267079842,-1125
"895","3442411",0.481263773409836,11171,0.516585475731544,11688,-0.0353217023217081,-517
"896","4442411",0.439789442709296,12954,0.474175100609733,13590,-0.0343856579004377,-636
"897","1113411",0.82993708250016,161,0.838674451662537,171,-0.00873736916237733,-10
"898","2113411",0.766713909991971,587,0.782299967021714,606,-0.0155860570297429,-19
"899","3113411",0.723599701178467,1203,0.753506133821934,1035,-0.0299064326434669,168
"900","4113411",0.682125370477928,2164,0.711095758700124,2047,-0.0289703882221964,117
"901","1213411",0.775979304907164,488,0.783370172716831,596,-0.00739086780966713,-108
"902","2213411",0.712756132398975,1409,0.726995688076008,1615,-0.0142395556770327,-206
"903","3213411",0.669641923585471,2518,0.698201854876228,2473,-0.0285599312907567,45
"904","4213411",0.628167592884931,3993,0.655791479754418,4156,-0.0276238868694865,-163
"905","1313411",0.747999834630388,814,0.756319605383533,991,-0.00831977075314538,-177
"906","2313411",0.684776662122199,2082,0.69994512074271,2410,-0.015168458620511,-328
"907","3313411",0.641662453308695,3499,0.67115128754293,3466,-0.029488834234235,33
"908","4313411",0.600188122608155,5225,0.62874091242112,5466,-0.0285527898129647,-241
"909","1413411",0.709063336645392,1495,0.715690101415427,1915,-0.00662676477003554,-420
"910","2413411",0.645840164137203,3335,0.659315616774604,3997,-0.0134754526374012,-662
"911","3413411",0.602725955323699,5102,0.630521783574824,5384,-0.0277958282511253,-282
"912","4413411",0.561251624623159,7106,0.588111408453014,7706,-0.026859783829855,-600
"913","1123411",0.76195781163374,643,0.77810514000513,665,-0.0161473283713905,-22
"914","2123411",0.698734639125551,1723,0.721730655364307,1763,-0.0229960162387561,-40
"915","3123411",0.655620430312047,2965,0.692936822164528,2645,-0.0373163918524801,320
"916","4123411",0.614146099611508,4606,0.650526447042717,4394,-0.0363803474312097,212
"917","1223411",0.708000034040744,1519,0.722800861059424,1733,-0.0148008270186804,-214
"918","2223411",0.644776861532555,3372,0.666426376418601,3674,-0.0216495148860459,-302
"919","3223411",0.601662652719051,5151,0.637632543218821,5054,-0.03596989049977,97
"920","4223411",0.560188322018511,7167,0.595222168097011,7334,-0.0350338460784997,-167
"921","1323411",0.680020563763968,2225,0.695750293726126,2549,-0.0157297299621586,-324
"922","2323411",0.616797391255779,4464,0.639375809085303,4962,-0.0225784178295242,-498
"923","3323411",0.573683182442275,6496,0.610581975885523,6453,-0.0368987934432482,43
"924","4323411",0.532208851741735,8610,0.568171600763713,8879,-0.0359627490219779,-269
"925","1423411",0.641084065778972,3523,0.65512078975802,4184,-0.0140367239790488,-661
"926","2423411",0.577860893270783,6302,0.598746305117197,7129,-0.0208854118464145,-827
"927","3423411",0.534746684457279,8478,0.569952471917418,8779,-0.0352057874601385,-301
"928","4423411",0.493272353756739,10583,0.527542096795607,11120,-0.0342697430388682,-537
"929","1133411",0.71862528946864,1294,0.739640047557101,1327,-0.0210147580884612,-33
"930","2133411",0.655402116960451,2976,0.683265562916278,2998,-0.0278634459558268,-22
"931","3133411",0.612287908146948,4693,0.654471729716499,4218,-0.0421838215695508,475
"932","4133411",0.570813577446408,6646,0.612061354594688,6388,-0.0412477771482805,258
"933","1233411",0.664667511875644,2669,0.684335768611395,2955,-0.0196682567357512,-286
"934","2233411",0.601444339367455,5163,0.627961283970572,5508,-0.0265169446031168,-345
"935","3233411",0.558330130553952,7262,0.599167450770792,7108,-0.0408373202168408,154
"936","4233411",0.516855799853412,9416,0.556757075648982,9525,-0.0399012757955703,-109
"937","1333411",0.636688041598868,3686,0.657285201278097,4093,-0.0205971596792295,-407
"938","2333411",0.573464869090679,6508,0.600910716637274,7005,-0.0274458475465951,-497
"939","3333411",0.530350660277175,8715,0.572116883437495,8646,-0.0417662231603191,69
"940","4333411",0.488876329576636,10805,0.529706508315684,11017,-0.0408301787390485,-212
"941","1433411",0.597751543613872,5331,0.616655697309991,6133,-0.0189041536961196,-802
"942","2433411",0.534528371105683,8487,0.560281212669168,9312,-0.0257528415634853,-825
"943","3433411",0.49141416229218,10668,0.531487379469389,10919,-0.0400732171772093,-251
"944","4433411",0.44993983159164,12548,0.489077004347578,12976,-0.0391371727559388,-428
"945","1143411",0.669591725013811,2523,0.699241553430017,2434,-0.0296498284162068,89
"946","2143411",0.606368552505622,4964,0.642867068789194,4771,-0.0364985162835724,193
"947","3143411",0.563254343692118,7002,0.614073235589415,6266,-0.0508188918972964,736
"948","4143411",0.521780012991578,9158,0.571662860467604,8680,-0.0498828474760259,478
"949","1243411",0.615633947420815,4514,0.643937274484311,4707,-0.0283033270634966,-193
"950","2243411",0.552410774912626,7573,0.587562789843488,7738,-0.0351520149308622,-165
"951","3243411",0.509296566099122,9785,0.558768956643708,9411,-0.0494723905445862,374
"952","4243411",0.467822235398582,11784,0.516358581521898,11700,-0.0485363461233159,84
"953","1343411",0.587654477144038,5792,0.616886707151013,6116,-0.0292322300069748,-324
"954","2343411",0.52443130463585,9023,0.56051222251019,9297,-0.0360809178743404,-274
"955","3343411",0.481317095822346,11165,0.53171838931041,10904,-0.0504012934880644,261
"956","4343411",0.439842765121806,12950,0.4893080141886,12963,-0.0494652490667941,-13
"957","1443411",0.548717979159042,7755,0.576257203182907,8412,-0.027539224023865,-657
"958","2443411",0.485494806650854,10976,0.519882718542084,11504,-0.0343879118912306,-528
"959","3443411",0.44238059783735,12857,0.491088885342305,12889,-0.0487082875049546,-32
"960","4443411",0.40090626713681,14283,0.448678510220494,14458,-0.0477722430836843,-175
"961","1114411",0.77773001052959,473,0.794023838288881,469,-0.0162938277592912,4
"962","2114411",0.714506838021401,1379,0.737649353648058,1357,-0.0231425156266568,22
"963","3114411",0.671392629207898,2465,0.708855520448278,2117,-0.0374628912403808,348
"964","4114411",0.629918298507358,3919,0.666445145326468,3673,-0.0365268468191104,246
"965","1214411",0.723772232936594,1195,0.738719559343175,1338,-0.0149473264065811,-143
"966","2214411",0.660549060428405,2798,0.682345074702352,3031,-0.0217960142739467,-233
"967","3214411",0.617434851614902,4446,0.653551241502572,4254,-0.0361163898876707,192
"968","4214411",0.575960520914362,6385,0.611140866380762,6432,-0.0351803454664004,-47
"969","1314411",0.695792762659818,1797,0.711668992009877,2021,-0.0158762293500594,-224
"970","2314411",0.632569590151629,3822,0.655294507369054,4173,-0.022724917217425,-351
"971","3314411",0.589455381338125,5712,0.626500674169274,5590,-0.037045292831149,122
"972","4314411",0.547981050637585,7793,0.584090299047464,7945,-0.0361092484098786,-152
"973","1414411",0.656856264674822,2926,0.671039488041771,3471,-0.0141832233669495,-545
"974","2414411",0.593633092166633,5526,0.614665003400948,6228,-0.0210319112343152,-702
"975","3414411",0.550518883353129,7677,0.585871170201169,7843,-0.0353522868480393,-166
"976","4414411",0.509044552652589,9799,0.543460795079358,10265,-0.0344162424267689,-466
"977","1124411",0.70975073966317,1480,0.733454526631474,1452,-0.0237037869683044,28
"978","2124411",0.646527567154981,3317,0.677080041990651,3245,-0.03055247483567,72
"979","3124411",0.603413358341478,5072,0.648286208790872,4484,-0.044872850449394,588
"980","4124411",0.561939027640938,7068,0.605875833669061,6710,-0.0439368060281237,358
"981","1224411",0.655792962070174,2953,0.678150247685768,3199,-0.0223572856155944,-246
"982","2224411",0.592569789561985,5567,0.621775763044945,5841,-0.0292059734829599,-274
"983","3224411",0.549455580748482,7724,0.592981929845166,7453,-0.043526349096684,271
"984","4224411",0.507981250047942,9858,0.550571554723355,9863,-0.0425903046754136,-5
"985","1324411",0.627813491793398,4001,0.65109968035247,4363,-0.0232861885590726,-362
"986","2324411",0.564590319285209,6944,0.594725195711647,7358,-0.0301348764264382,-414
"987","3324411",0.521476110471705,9173,0.565931362511868,8991,-0.0444552520401622,182
"988","4324411",0.480001779771165,11219,0.523520987390057,11321,-0.0435192076188918,-102
"989","1424411",0.588876993808402,5736,0.610470176384365,6458,-0.0215931825759628,-722
"990","2424411",0.525653821300213,8968,0.554095691743541,9676,-0.0284418704433285,-708
"991","3424411",0.482539612486709,11115,0.525301858543762,11230,-0.0427622460570524,-115
"992","4424411",0.44106528178617,12900,0.482891483421951,13218,-0.041826201635782,-318
"993","1134411",0.66641821749807,2618,0.694989434183446,2580,-0.0285712166853752,38
"994","2134411",0.603195044989882,5082,0.638614949542622,5009,-0.0354199045527408,73
"995","3134411",0.560080836176378,7173,0.609821116342843,6502,-0.0497402801664648,671
"996","4134411",0.518606505475838,9306,0.567410741221033,8916,-0.0488042357451944,390
"997","1234411",0.612460439905074,4684,0.639685155237739,4938,-0.0272247153326651,-254
"998","2234411",0.549237267396885,7734,0.583310670596916,7993,-0.0340734032000307,-259
"999","3234411",0.506123058583382,9945,0.554516837397137,9651,-0.0483937788137547,294
"1000","4234411",0.464648727882842,11925,0.512106462275326,11925,-0.0474577343924843,0
"1001","1334411",0.584480969628298,5977,0.612634587904441,6356,-0.0281536182761434,-379
"1002","2334411",0.521257797120109,9185,0.556260103263618,9559,-0.035002306143509,-374
"1003","3334411",0.478143588306606,11314,0.527466270063839,11123,-0.0493226817572329,191
"1004","4334411",0.436669257606066,13072,0.485055894942028,13136,-0.0483866373359625,-64
"1005","1434411",0.545544471643302,7931,0.572005083936336,8658,-0.0264606122930335,-727
"1006","2434411",0.482321299135113,11124,0.515630599295512,11743,-0.0333093001603992,-619
"1007","3434411",0.43920709032161,12970,0.486836766095733,13058,-0.0476296757741231,-88
"1008","4434411",0.39773275962107,14361,0.444426390973923,14587,-0.0466936313528528,-226
"1009","1144411",0.617384653043241,4452,0.654590940056362,4211,-0.0372062870131207,241
"1010","2144411",0.554161480535052,7496,0.598216455415538,7165,-0.0440549748804863,331
"1011","3144411",0.511047271721549,9720,0.569422622215759,8805,-0.0583753504942103,915
"1012","4144411",0.469572941021009,11715,0.527012247093948,11143,-0.0574393060729398,572
"1013","1244411",0.563426875450245,6991,0.599286661110655,7097,-0.0358597856604106,-106
"1014","2244411",0.500203702942056,10257,0.542912176469832,10293,-0.0427084735277762,-36
"1015","3244411",0.457089494128552,12255,0.514118343270053,11823,-0.0570288491415001,432
"1016","4244411",0.415615163428012,13827,0.471707968148242,13698,-0.0560928047202297,129
"1017","1344411",0.535447405173469,8444,0.572236093777357,8640,-0.0367886886038888,-196
"1018","2344411",0.47222423266528,11606,0.515861609136534,11727,-0.0436373764712544,-121
"1019","3344411",0.429110023851776,13373,0.487067775936755,13049,-0.0579577520849783,324
"1020","4344411",0.387635693151236,14643,0.444657400814944,14581,-0.057021707663708,62
"1021","1444411",0.496510907188473,10430,0.531606589809252,10910,-0.0350956826207789,-480
"1022","2444411",0.433287734680284,13221,0.475232105168428,13542,-0.0419443704881446,-321
"1023","3444411",0.39017352586678,14588,0.446438271968649,14531,-0.0562647461018687,57
"1024","4444411",0.34869919516624,15460,0.404027896846839,15519,-0.0553287016805983,-59
"1025","1111121",0.944951230192676,6,0.950211475890372,5,-0.00526024569769545,1
"1026","2111121",0.881728057684487,42,0.893836991249549,38,-0.012108933565061,4
"1027","3111121",0.838613848870984,131,0.865043158049769,84,-0.0264293091787851,47
"1028","4111121",0.797139518170444,330,0.822632782927959,257,-0.0254932647575148,73
"1029","1211121",0.89099345259968,31,0.894907196944666,35,-0.00391374434498548,-4
"1030","2211121",0.827770280091491,168,0.838532712303842,172,-0.0107624322123511,-4
"1031","3211121",0.784656071277988,411,0.809738879104063,339,-0.0250828078260751,72
"1032","4211121",0.743181740577448,880,0.767328503982252,816,-0.0241467634048046,64
"1033","1311121",0.863013982322904,71,0.867856629611368,79,-0.00484264728846373,-8
"1034","2311121",0.799790809814715,315,0.811482144970544,326,-0.0116913351558293,-11
"1035","3311121",0.756676601001212,704,0.782688311770765,599,-0.0260117107695533,105
"1036","4311121",0.715202270300672,1363,0.740277936648955,1312,-0.0250756663482828,51
"1037","1411121",0.824077484337908,183,0.827227125643262,232,-0.00314964130535389,-49
"1038","2411121",0.760854311829719,658,0.770852641002439,758,-0.00999832917271959,-100
"1039","3411121",0.717740103016216,1314,0.742058807802659,1267,-0.0243187047864436,47
"1040","4411121",0.676265772315676,2335,0.699648432680849,2420,-0.0233826603651731,-85
"1041","1121121",0.876971959326256,49,0.889642164232965,44,-0.0126702049067087,5
"1042","2121121",0.813748786818068,231,0.833267679592142,200,-0.0195188927740743,31
"1043","3121121",0.770634578004564,549,0.804473846392362,387,-0.0338392683877983,162
"1044","4121121",0.729160247304024,1101,0.762063471270552,910,-0.032903223966528,191
"1045","1221121",0.82301418173326,185,0.834337885287259,195,-0.0113237035539987,-10
"1046","2221121",0.759791009225071,673,0.777963400646436,668,-0.0181723914213643,5
"1047","3221121",0.716676800411568,1331,0.749169567446656,1122,-0.0324927670350883,209
"1048","4221121",0.675202469711028,2360,0.706759192324846,2193,-0.0315567226138178,167
"1049","1321121",0.795034711456484,341,0.807287317953961,362,-0.0122526064974769,-21
"1050","2321121",0.731811538948295,1065,0.750912833313138,1084,-0.0191012943648425,-19
"1051","3321121",0.688697330134792,1979,0.722119000113358,1749,-0.0334216699785665,230
"1052","4321121",0.647222999434252,3296,0.679708624991548,3152,-0.0324856255572961,144
"1053","1421121",0.756098213471488,710,0.766657813985855,830,-0.0105596005143671,-120
"1054","2421121",0.692875040963299,1879,0.710283329345032,2075,-0.0174082883817328,-196
"1055","3421121",0.649760832149796,3202,0.681489496145252,3075,-0.0317286639954568,127
"1056","4421121",0.608286501449256,4882,0.639079121023442,4982,-0.0307926195741863,-100
"1057","1131121",0.833639437161157,148,0.851177071784936,121,-0.0175376346237796,27
"1058","2131121",0.770416264652968,552,0.794802587144113,464,-0.0243863224911451,88
"1059","3131121",0.727302055839464,1132,0.766008753944333,843,-0.0387066981048692,289
"1060","4131121",0.685827725138924,2061,0.723598378822523,1714,-0.0377706536835987,347
"1061","1231121",0.779681659568161,455,0.79587279283923,457,-0.0161911332710694,-2
"1062","2231121",0.716458487059972,1337,0.739498308198407,1330,-0.0230398211384349,7
"1063","3231121",0.673344278246468,2407,0.710704474998627,2062,-0.037360196752159,345
"1064","4231121",0.631869947545928,3848,0.668294099876817,3607,-0.0364241523308887,241
"1065","1331121",0.751702189291384,760,0.768822225505932,787,-0.0171200362145476,-27
"1066","2331121",0.688479016783196,1985,0.712447740865109,1994,-0.0239687240819132,-9
"1067","3331121",0.645364807969692,3355,0.683653907665329,2980,-0.0382890996956372,375
"1068","4331121",0.603890477269152,5054,0.641243532543519,4859,-0.0373530552743669,195
"1069","1431121",0.712765691306388,1408,0.728192721537826,1582,-0.0154270302314378,-174
"1070","2431121",0.6495425187982,3210,0.671818236897003,3444,-0.0222757180988035,-234
"1071","3431121",0.606428309984696,4958,0.643024403697224,4758,-0.0365960937125275,200
"1072","4431121",0.564953979284156,6936,0.600614028575413,7028,-0.0356600492912572,-92
"1073","1141121",0.784605872706327,413,0.810778577657852,331,-0.0261727049515249,82
"1074","2141121",0.721382700198138,1248,0.754404093017029,1018,-0.0330213928188905,230
"1075","3141121",0.678268491384635,2284,0.725610259817249,1655,-0.0473417684326145,629
"1076","4141121",0.636794160684095,3680,0.683199884695439,3001,-0.0464057240113442,679
"1077","1241121",0.730648095113331,1084,0.755474298712146,1000,-0.0248262035988149,84
"1078","2241121",0.667424922605142,2587,0.699099814071323,2438,-0.0316748914661805,149
"1079","3241121",0.624310713791639,4168,0.670305980871543,3499,-0.0459952670799045,669
"1080","4241121",0.582836383091099,6051,0.627895605749733,5511,-0.045059222658634,540
"1081","1341121",0.702668624836555,1639,0.728423731378848,1575,-0.0257551065422932,64
"1082","2341121",0.639445452328366,3591,0.672049246738025,3436,-0.0326037944096588,155
"1083","3341121",0.596331243514862,5405,0.643255413538245,4749,-0.0469241700233828,656
"1084","4341121",0.554856912814323,7455,0.600845038416435,7011,-0.0459881256021123,444
"1085","1441121",0.663732126851559,2709,0.687794227410742,2816,-0.0240621005591833,-107
"1086","2441121",0.60050895434337,5204,0.631419742769919,5339,-0.030910788426549,-135
"1087","3441121",0.557394745529866,7315,0.60262590957014,6896,-0.045231164040273,419
"1088","4441121",0.515920414829327,9474,0.560215534448329,9315,-0.0442951196190026,159
"1089","1112121",0.911866318430987,17,0.91189249436172,18,-2.61759307322862e-05,-1
"1090","2112121",0.848643145922799,97,0.855518009720896,107,-0.00687486379809787,-10
"1091","3112121",0.805528937109295,277,0.826724176521117,236,-0.0211952394118219,41
"1092","4112121",0.764054606408755,616,0.784313801399307,586,-0.0202591949905516,30
"1093","1212121",0.857908540837991,79,0.856588215416013,104,0.00132032542197769,-25
"1094","2212121",0.794685368329802,344,0.80021373077519,423,-0.0055283624453879,-79
"1095","3212121",0.751571159516299,764,0.771419897575411,749,-0.0198487380591119,15
"1096","4212121",0.710096828815759,1468,0.7290095224536,1559,-0.0189126936378414,-91
"1097","1312121",0.829929070561215,162,0.829537648082716,222,0.000391422478499437,-60
"1098","2312121",0.766705898053026,588,0.773163163441892,725,-0.00645726538886615,-137
"1099","3312121",0.723591689239523,1205,0.744369330242113,1221,-0.0207776410025902,-16
"1100","4312121",0.682117358538983,2165,0.701958955120302,2361,-0.0198415965813197,-196
"1101","1412121",0.790992572576219,370,0.78890814411461,534,0.00208442846160928,-164
"1102","2412121",0.72776940006803,1120,0.732533659473787,1480,-0.00476425940575642,-360
"1103","3412121",0.684655191254527,2088,0.703739826274007,2286,-0.0190846350194804,-198
"1104","4412121",0.643180860553987,3433,0.661329451152197,3921,-0.0181485905982099,-488
"1105","1122121",0.843887047564567,117,0.851323182704313,119,-0.0074361351397455,-2
"1106","2122121",0.780663875056379,446,0.79494869806349,462,-0.0142848230071111,-16
"1107","3122121",0.737549666242875,971,0.76615486486371,839,-0.0286051986208351,132
"1108","4122121",0.696075335542335,1793,0.7237444897419,1707,-0.0276691541995648,86
"1109","1222121",0.789929269971571,377,0.796018903758607,456,-0.00608963378703553,-79
"1110","2222121",0.726706097463382,1148,0.739644419117783,1326,-0.0129383216544011,-178
"1111","3222121",0.683591888649879,2116,0.710850585918004,2058,-0.0272586972681251,58
"1112","4222121",0.642117557949339,3480,0.668440210796194,3596,-0.0263226528468546,-116
"1113","1322121",0.761949799694795,644,0.768968336425309,786,-0.00701853673051378,-142
"1114","2322121",0.698726627186606,1724,0.712593851784486,1991,-0.0138672245978794,-267
"1115","3322121",0.655612418373103,2966,0.683800018584706,2976,-0.0281876002116034,-10
"1116","4322121",0.614138087672563,4607,0.641389643462896,4852,-0.0272515557903329,-245
"1117","1422121",0.723013301709799,1212,0.728338832457203,1579,-0.00532553074740394,-367
"1118","2422121",0.65979012920161,2818,0.67196434781638,3441,-0.0121742186147696,-623
"1119","3422121",0.616675920388107,4475,0.6431705146166,4752,-0.0264945942284937,-277
"1120","4422121",0.575201589687567,6425,0.60076013949479,7020,-0.0255585498072232,-595
"1121","1132121",0.800554525399468,309,0.812858090256284,314,-0.0123035648568164,-5
"1122","2132121",0.737331352891279,973,0.756483605615461,988,-0.019152252724182,-15
"1123","3132121",0.694217144077775,1839,0.727689772415681,1595,-0.033472628337906,244
"1124","4132121",0.652742813377235,3089,0.685279397293871,2917,-0.0325365839166355,172
"1125","1232121",0.746596747806472,833,0.757553811310578,971,-0.0109570635041062,-138
"1126","2232121",0.683373575298283,2126,0.701179326669755,2380,-0.0178057513714718,-254
"1127","3232121",0.640259366484779,3555,0.672385493469975,3428,-0.0321261269851958,127
"1128","4232121",0.598785035784239,5283,0.629975118348165,5411,-0.0311900825639255,-128
"1129","1332121",0.718617277529696,1295,0.73050324397728,1516,-0.0118859664475844,-221
"1130","2332121",0.655394105021507,2977,0.674128759336457,3342,-0.01873465431495,-365
"1131","3332121",0.612279896208003,4694,0.645334926136677,4634,-0.033055029928674,60
"1132","4332121",0.570805565507463,6647,0.602924551014867,6882,-0.0321189855074038,-235
"1133","1432121",0.6796807795447,2234,0.689873740009174,2747,-0.0101929604644746,-513
"1134","2432121",0.616457607036511,4481,0.633499255368351,5245,-0.0170416483318403,-764
"1135","3432121",0.573343398223007,6519,0.604705422168571,6791,-0.0313620239455643,-272
"1136","4432121",0.531869067522467,8630,0.562295047046761,9205,-0.030425979524294,-575
"1137","1142121",0.751520960944638,765,0.7724595961292,733,-0.0209386351845617,32
"1138","2142121",0.688297788436449,1990,0.716085111488377,1906,-0.0277873230519273,84
"1139","3142121",0.645183579622946,3361,0.687291278288597,2843,-0.0421076986656513,518
"1140","4142121",0.603709248922406,5057,0.644880903166787,4658,-0.0411716542443811,399
"1141","1242121",0.697563183351642,1754,0.717155317183494,1886,-0.0195921338318518,-132
"1142","2242121",0.634340010843453,3769,0.66078083254267,3942,-0.0264408216992174,-173
"1143","3242121",0.59122580202995,5622,0.631986999342891,5320,-0.0407611973129414,302
"1144","4242121",0.54975147132941,7712,0.589576624221081,7629,-0.0398251528916709,83
"1145","1342121",0.669583713074866,2525,0.690104749850196,2738,-0.02052103677533,-213
"1146","2342121",0.606360540566677,4965,0.633730265209373,5234,-0.0273697246426956,-269
"1147","3342121",0.563246331753174,7003,0.604936432009593,6778,-0.0416901002564196,225
"1148","4342121",0.521772001052634,9159,0.562526056887783,9191,-0.0407540558351491,-32
"1149","1442121",0.63064721508987,3886,0.64947524588209,4436,-0.0188280307922202,-550
"1150","2442121",0.567424042581681,6824,0.593100761241267,7446,-0.0256767186595859,-622
"1151","3442121",0.524309833768178,9032,0.564306928041487,9085,-0.0399970942733099,-53
"1152","4442121",0.482835503067638,11102,0.521896552919677,11404,-0.0390610498520395,-302
"1153","1113121",0.872983142858502,54,0.886395903972481,49,-0.0134127611139789,5
"1154","2113121",0.809759970350313,248,0.830021419331657,220,-0.0202614489813445,28
"1155","3113121",0.766645761536809,589,0.801227586131878,413,-0.0345818245950685,176
"1156","4113121",0.72517143083627,1175,0.758817211010068,953,-0.033645780173798,222
"1157","1213121",0.819025365265506,201,0.831091625026774,210,-0.0120662597612687,-9
"1158","2213121",0.755802192757317,711,0.774717140385951,703,-0.0189149476286343,8
"1159","3213121",0.712687983943813,1413,0.745923307186172,1189,-0.0332353232423583,224
"1160","4213121",0.671213653243273,2468,0.703512932064361,2297,-0.0322992788210881,171
"1161","1313121",0.79104589498873,369,0.804041057693477,394,-0.012995162704747,-25
"1162","2313121",0.727822722480541,1117,0.747666573052653,1154,-0.0198438505721126,-37
"1163","3313121",0.684708513667037,2086,0.718872739852874,1833,-0.0341642261858366,253
"1164","4313121",0.643234182966497,3430,0.676462364731063,3276,-0.0332281817645663,154
"1165","1413121",0.752109397003734,757,0.763411553725371,884,-0.0113021567216371,-127
"1166","2413121",0.688886224495545,1967,0.707037069084548,2182,-0.0181508445890028,-215
"1167","3413121",0.645772015682041,3338,0.678243235884768,3196,-0.0324712202027269,142
"1168","4413121",0.604297684981501,5038,0.635832860762958,5131,-0.0315351757814566,-93
"1169","1123121",0.805003871992082,278,0.825826592315074,242,-0.0208227203229921,36
"1170","2123121",0.741780699483893,893,0.769452107674251,780,-0.0276714081903577,113
"1171","3123121",0.69866649067039,1726,0.740658274474471,1302,-0.0419917838040818,424
"1172","4123121",0.65719215996985,2918,0.698247899352661,2470,-0.0410557393828113,448
"1173","1223121",0.751046094399086,771,0.770522313369368,765,-0.019476218970282,6
"1174","2223121",0.687822921890897,1997,0.714147828728544,1961,-0.0263249068376475,36
"1175","3223121",0.644708713077393,3374,0.685353995528765,2914,-0.0406452824513716,460
"1176","4223121",0.603234382376853,5079,0.642943620406955,4762,-0.0397092380301013,317
"1177","1323121",0.72306662412231,1209,0.74347174603607,1244,-0.0204051219137602,-35
"1178","2323121",0.659843451614121,2813,0.687097261395247,2849,-0.0272538097811258,-36
"1179","3323121",0.616729242800617,4470,0.658303428195467,4039,-0.0415741853948498,431
"1180","4323121",0.575254912100077,6418,0.615893053073657,6174,-0.0406381409735795,244
"1181","1423121",0.684130126137314,2102,0.702842242067964,2326,-0.0187121159306504,-224
"1182","2423121",0.620906953629125,4293,0.646467757427141,4586,-0.0255608037980161,-293
"1183","3423121",0.577792744815621,6305,0.617673924227361,6066,-0.0398811794117401,239
"1184","4423121",0.536318414115081,8409,0.575263549105551,8476,-0.0389451349904698,-67
"1185","1133121",0.761671349826982,648,0.787361499867045,554,-0.0256901500400628,94
"1186","2133121",0.698448177318793,1731,0.730987015226222,1513,-0.0325388379074284,218
"1187","3133121",0.65533396850529,2979,0.702193182026442,2353,-0.0468592135211524,626
"1188","4133121",0.61385963780475,4620,0.659782806904632,3982,-0.0459231690998821,638
"1189","1233121",0.707713572233986,1528,0.732057220921339,1493,-0.0243436486873528,35
"1190","2233121",0.644490399725797,3383,0.675682736280516,3301,-0.0311923365547184,82
"1191","3233121",0.601376190912294,5167,0.646888903080736,4566,-0.0455127121684424,601
"1192","4233121",0.559901860211754,7178,0.604478527958926,6807,-0.044576667747172,371
"1193","1333121",0.67973410195721,2232,0.705006653588041,2249,-0.0252725516308311,-17
"1194","2333121",0.616510929449021,4478,0.648632168947218,4465,-0.0321212394981967,13
"1195","3333121",0.573396720635517,6513,0.619838335747438,5946,-0.0464416151119207,567
"1196","4333121",0.531922389934978,8627,0.577427960625628,8352,-0.0455055706906502,275
"1197","1433121",0.640797603972214,3530,0.664377149619935,3781,-0.0235795456477212,-251
"1198","2433121",0.577574431464025,6313,0.608002664979112,6606,-0.0304282335150869,-293
"1199","3433121",0.534460222650522,8490,0.579208831779332,8240,-0.044748609128811,250
"1200","4433121",0.492985891949982,10601,0.536798456657522,10648,-0.0438125647075405,-47
"1201","1143121",0.712637785372153,1415,0.746963005739961,1172,-0.0343252203678084,243
"1202","2143121",0.649414612863964,3218,0.690588521099138,2726,-0.041173908235174,492
"1203","3143121",0.60630040405046,4966,0.661794687899358,3896,-0.055494283848898,1070
"1204","4143121",0.56482607334992,6938,0.619384312777548,5973,-0.0545582394276275,965
"1205","1243121",0.658680007779157,2861,0.691658726794255,2686,-0.0329787190150982,175
"1206","2243121",0.595456835270968,5448,0.635284242153431,5165,-0.0398274068824638,283
"1207","3243121",0.552342626457464,7579,0.606490408953652,6676,-0.0541477824961878,903
"1208","4243121",0.510868295756924,9726,0.564080033831842,9100,-0.0532117380749175,626
"1209","1343121",0.63070053750238,3885,0.664608159460957,3770,-0.0339076219585764,115
"1210","2343121",0.567477364994192,6822,0.608233674820134,6597,-0.040756309825942,225
"1211","3343121",0.524363156180688,9029,0.579439841620354,8230,-0.055076685439666,799
"1212","4343121",0.482888825480148,11099,0.537029466498544,10634,-0.0541406410183958,465
"1213","1443121",0.591764039517384,5593,0.623978655492851,5724,-0.0322146159754666,-131
"1214","2443121",0.528540867009196,8809,0.567604170852028,8909,-0.0390633038428323,-100
"1215","3443121",0.485426658195692,10979,0.538810337652248,10532,-0.0533836794565564,447
"1216","4443121",0.443952327495152,12804,0.496399962530438,12652,-0.052447635035286,152
"1217","1114121",0.820776070887932,192,0.841745290598825,160,-0.0209692197108929,32
"1218","2114121",0.757552898379743,691,0.785370805958002,576,-0.0278179075782585,115
"1219","3114121",0.71443868956624,1381,0.756576972758222,984,-0.0421382831919825,397
"1220","4114121",0.6729643588657,2416,0.714166597636412,1959,-0.041202238770712,457
"1221","1214121",0.766818293294936,583,0.786441011653119,562,-0.0196227183581827,21
"1222","2214121",0.703595120786747,1618,0.730066527012295,1527,-0.0264714062255483,91
"1223","3214121",0.660480911973244,2801,0.701272693812516,2377,-0.0407917818392723,424
"1224","4214121",0.619006581272703,4385,0.658862318690706,4019,-0.0398557374180021,366
"1225","1314121",0.73883882301816,940,0.759390444319821,941,-0.020551621301661,-1
"1226","2314121",0.675615650509971,2349,0.703015959678997,2314,-0.0274003091690266,35
"1227","3314121",0.632501441696467,3829,0.674222126479218,3339,-0.0417206847827506,490
"1228","4314121",0.591027110995927,5631,0.631811751357408,5328,-0.0407846403614803,303
"1229","1414121",0.699902325033164,1695,0.718760940351715,1835,-0.0188586153185512,-140
"1230","2414121",0.636679152524975,3687,0.662386455710892,3864,-0.0257073031859169,-177
"1231","3414121",0.593564943711471,5531,0.633592622511112,5242,-0.0400276787996409,289
"1232","4414121",0.552090613010931,7593,0.591182247389302,7543,-0.0390916343783706,50
"1233","1124121",0.752796800021512,748,0.781175978941418,622,-0.0283791789199062,126
"1234","2124121",0.689573627513323,1953,0.724801494300595,1678,-0.0352278667872717,275
"1235","3124121",0.64645941869982,3321,0.696007661100815,2537,-0.0495482424009958,784
"1236","4124121",0.60498508799928,5009,0.653597285979005,4253,-0.0486121979797253,756
"1237","1224121",0.698839022428516,1717,0.725871699995712,1643,-0.027032677567196,74
"1238","2224121",0.635615849920327,3723,0.669497215354889,3539,-0.0338813654345616,184
"1239","3224121",0.592501641106824,5571,0.640703382155109,4886,-0.0482017410482856,685
"1240","4224121",0.551027310406283,7655,0.598293007033299,7158,-0.0472656966270153,497
"1241","1324121",0.67085955215174,2476,0.698821132662414,2447,-0.0279615805106742,29
"1242","2324121",0.607636379643551,4907,0.642446648021591,4788,-0.0348102683780398,119
"1243","3324121",0.564522170830047,6952,0.613652814821811,6287,-0.0491306439917638,665
"1244","4324121",0.523047840129507,9090,0.571242439700001,8712,-0.0481945995704935,378
"1245","1424121",0.631923054166744,3847,0.658191628694308,4044,-0.0262685745275644,-197
"1246","2424121",0.568699881658555,6750,0.601817144053485,6942,-0.0331172623949301,-192
"1247","3424121",0.525585672845051,8975,0.573023310853706,8594,-0.0474376380086541,381
"1248","4424121",0.484111342144511,11043,0.530612935731895,10963,-0.0465015935873838,80
"1249","1134121",0.709464277856412,1488,0.742710886493389,1256,-0.0332466086369768,232
"1250","2134121",0.646241105348224,3325,0.686336401852566,2880,-0.0400952965043424,445
"1251","3134121",0.60312689653472,5087,0.657542568652786,4079,-0.0544156721180664,1008
"1252","4134121",0.56165256583418,7080,0.615132193530976,6206,-0.0534796276967962,874
"1253","1234121",0.655506500263416,2970,0.687406607547683,2838,-0.0319001072842668,132
"1254","2234121",0.592283327755227,5577,0.63103212290686,5360,-0.0387487951516324,217
"1255","3234121",0.549169118941724,7738,0.60223828970708,6922,-0.0530691707653564,816
"1256","4234121",0.507694788241184,9868,0.55982791458527,9350,-0.052133126344086,518
"1257","1334121",0.62752702998664,4017,0.660356040214385,3956,-0.0328290102277451,61
"1258","2334121",0.564303857478451,6960,0.603981555573562,6827,-0.0396776980951107,133
"1259","3334121",0.521189648664948,9188,0.575187722373782,8479,-0.0539980737088347,709
"1260","4334121",0.479715317964408,11231,0.532777347251972,10863,-0.0530620292875643,368
"1261","1434121",0.588590532001644,5751,0.619726536246279,5958,-0.0311360042446353,-207
"1262","2434121",0.525367359493455,8986,0.563352051605456,9141,-0.037984692112001,-155
"1263","3434121",0.482253150679952,11127,0.534558218405677,10760,-0.0523050677257249,367
"1264","4434121",0.440778819979412,12917,0.492147843283866,12846,-0.0513690233044546,71
"1265","1144121",0.660430713401583,2803,0.702312392366305,2349,-0.0418816789647224,454
"1266","2144121",0.597207540893394,5365,0.645937907725482,4613,-0.048730366832088,752
"1267","3144121",0.55409333207989,7499,0.617144074525702,6101,-0.063050742445812,1398
"1268","4144121",0.512619001379351,9643,0.574733699403892,8509,-0.0621146980245415,1134
"1269","1244121",0.606472935808587,4955,0.647008113420599,4558,-0.0405351776120122,397
"1270","2244121",0.543249763300398,8056,0.590633628779776,7567,-0.0473838654793778,489
"1271","3244121",0.500135554486894,10262,0.561839795579996,9227,-0.0617042410931018,1035
"1272","4244121",0.458661223786354,12207,0.519429420458186,11533,-0.0607681966718315,674
"1273","1344121",0.578493465531811,6277,0.619957546087301,5939,-0.0414640805554904,338
"1274","2344121",0.515270293023622,9509,0.563583061446478,9124,-0.048312768422856,385
"1275","3344121",0.472156084210118,11612,0.534789228246698,10749,-0.0626331440365801,863
"1276","4344121",0.430681753509578,13317,0.492378853124888,12833,-0.0616970996153098,484
"1277","1444121",0.539556967546815,8251,0.579328042119195,8234,-0.0397710745723806,17
"1278","2444121",0.476333795038626,11407,0.522953557478372,11350,-0.0466197624397464,57
"1279","3444121",0.433219586225122,13225,0.494159724278593,12752,-0.0609401380534704,473
"1280","4444121",0.391745255524582,14551,0.451749349156782,14356,-0.0600040936322,195
"1281","1111221",0.899102396044466,24,0.90487662923559,23,-0.00577423319112369,1
"1282","2111221",0.835879223536277,137,0.848502144594767,132,-0.0126229210584893,5
"1283","3111221",0.792765014722774,358,0.819708311394987,273,-0.0269432966722133,85
"1284","4111221",0.751290684022234,767,0.777297936273177,672,-0.026007252250943,95
"1285","1211221",0.84514461845147,109,0.849572350289884,128,-0.00442773183841372,-19
"1286","2211221",0.781921445943281,431,0.79319786564906,480,-0.0112764197057793,-49
"1287","3211221",0.738807237129778,941,0.764404032449281,862,-0.0255967953195033,79
"1288","4211221",0.697332906429238,1764,0.72199365732747,1751,-0.0246607508982328,13
"1289","1311221",0.817165148174694,209,0.822521782956586,259,-0.00535663478189197,-50
"1290","2311221",0.753941975666505,734,0.766147298315762,841,-0.0122053226492576,-107
"1291","3311221",0.710827766853001,1452,0.737353465115983,1365,-0.0265256982629816,87
"1292","4311221",0.669353436152462,2531,0.694943089994173,2581,-0.0255896538417111,-50
"1293","1411221",0.778228650189698,466,0.78189227898848,612,-0.00366362879878213,-146
"1294","2411221",0.715005477681509,1367,0.725517794347657,1657,-0.0105123166661478,-290
"1295","3411221",0.671891268868005,2449,0.696723961147877,2514,-0.0248326922798718,-65
"1296","4411221",0.630416938167466,3898,0.654313586026067,4222,-0.0238966478586013,-324
"1297","1121221",0.831123125178046,154,0.844307317578183,150,-0.0131841924001369,4
"1298","2121221",0.767899952669857,572,0.78793283293736,545,-0.0200328802675025,27
"1299","3121221",0.724785743856354,1183,0.75913899973758,947,-0.0343532558812265,236
"1300","4121221",0.683311413155814,2128,0.71672862461577,1895,-0.0334172114599562,233
"1301","1221221",0.77716534758505,476,0.789003038632477,531,-0.0118376910474269,-55
"1302","2221221",0.713942175076861,1386,0.732628553991654,1478,-0.0186863789147925,-92
"1303","3221221",0.670827966263358,2478,0.703834720791874,2282,-0.0330067545285165,196
"1304","4221221",0.629353635562818,3944,0.661424345670064,3914,-0.032070710107246,30
"1305","1321221",0.749185877308274,796,0.761952471299179,914,-0.0127665939909052,-118
"1306","2321221",0.685962704800085,2056,0.705577986658356,2232,-0.0196152818582708,-176
"1307","3321221",0.642848495986581,3449,0.676784153458576,3264,-0.0339356574719948,185
"1308","4321221",0.601374165286042,5168,0.634373778336766,5215,-0.0329996130507243,-47
"1309","1421221",0.710249379323278,1466,0.721322967331073,1774,-0.0110735880077953,-308
"1310","2421221",0.647026206815089,3300,0.66494848269025,3753,-0.017922275875161,-453
"1311","3421221",0.603911998001585,5053,0.63615464949047,5117,-0.0322426514888851,-64
"1312","4421221",0.562437667301046,7039,0.59374427436866,7423,-0.0313066070676146,-384
"1313","1131221",0.787790603012946,390,0.805842225130154,372,-0.0180516221172078,18
"1314","2131221",0.724567430504758,1186,0.749467740489331,1113,-0.0249003099845734,73
"1315","3131221",0.681453221691254,2188,0.720673907289551,1788,-0.0392206855982974,400
"1316","4131221",0.639978890990714,3562,0.678263532167741,3194,-0.0382846411770269,368
"1317","1231221",0.73383282541995,1028,0.750537946184448,1093,-0.0167051207644976,-65
"1318","2231221",0.670609652911762,2486,0.694163461543625,2606,-0.0235538086318632,-120
"1319","3231221",0.627495444098258,4018,0.665369628343845,3727,-0.0378741842455872,291
"1320","4231221",0.586021113397718,5888,0.622959253222035,5786,-0.0369381398243169,102
"1321","1331221",0.705853355143174,1569,0.72348737885115,1716,-0.0176340237079758,-147
"1322","2331221",0.642630182634985,3458,0.667112894210327,3647,-0.0244827115753414,-189
"1323","3331221",0.599515973821482,5254,0.638319061010547,5025,-0.0388030871890654,229
"1324","4331221",0.558041643120942,7273,0.595908685888737,7298,-0.0378670427677952,-25
"1325","1431221",0.666916857158178,2598,0.682857874883044,3012,-0.015941017724866,-414
"1326","2431221",0.603693684649989,5058,0.626483390242221,5592,-0.0227897055922317,-534
"1327","3431221",0.560579475836486,7143,0.597689557042442,7195,-0.0371100812059557,-52
"1328","4431221",0.519105145135946,9278,0.555279181920631,9612,-0.0361740367846854,-334
"1329","1141221",0.738757038558117,943,0.76544373100307,851,-0.0266866924449531,92
"1330","2141221",0.675533866049928,2351,0.709069246362247,2111,-0.0335353803123187,240
"1331","3141221",0.632419657236425,3832,0.680275413162467,3125,-0.0478557559260427,707
"1332","4141221",0.590945326535885,5633,0.637865038040657,5045,-0.0469197115047725,588
"1333","1241221",0.684799260965121,2081,0.710139452057364,2080,-0.0253401910922432,1
"1334","2241221",0.621576088456932,4271,0.653764967416541,4246,-0.0321888789596088,25
"1335","3241221",0.578461879643428,6278,0.624971134216761,5669,-0.0465092545733328,609
"1336","4241221",0.536987548942889,8369,0.582560759094951,8049,-0.0455732101520623,320
"1337","1341221",0.656819790688345,2928,0.683088884724066,3008,-0.0262690940357214,-80
"1338","2341221",0.593596618180156,5529,0.626714400083243,5584,-0.033117781903087,-55
"1339","3341221",0.550482409366652,7683,0.597920566883463,7189,-0.047438157516811,494
"1340","4341221",0.509008078666112,9801,0.555510191761653,9602,-0.0465021130955405,199
"1341","1441221",0.617883292703349,4426,0.64245938075596,4787,-0.0245760880526116,-361
"1342","2441221",0.55466012019516,7460,0.586084896115137,7828,-0.0314247759199773,-368
"1343","3441221",0.511545911381656,9692,0.557291062915358,9490,-0.0457451515337013,202
"1344","4441221",0.470071580681116,11688,0.514880687793547,11783,-0.0448091071124309,-95
"1345","1112221",0.866017484282777,66,0.866557647706938,80,-0.000540163424160522,-14
"1346","2112221",0.802794311774588,293,0.810183163066114,335,-0.00738885129152611,-42
"1347","3112221",0.759680102961085,674,0.781389329866335,619,-0.0217092269052501,55
"1348","4112221",0.718205772260545,1301,0.738978954744525,1334,-0.0207731824839799,-33
"1349","1212221",0.812059706689781,237,0.811253368761232,328,0.00080633792854945,-91
"1350","2212221",0.748836534181592,799,0.754878884120408,1011,-0.00604234993881614,-212
"1351","3212221",0.705722325368089,1573,0.726085050920629,1636,-0.0203627255525402,-63
"1352","4212221",0.664247994667549,2688,0.683674675798818,2977,-0.0194266811312697,-289
"1353","1312221",0.784080236413005,418,0.784202801427934,588,-0.000122565014928799,-170
"1354","2312221",0.720857063904816,1256,0.72782831678711,1591,-0.00697125288229439,-335
"1355","3312221",0.677742855091312,2298,0.699034483587331,2441,-0.0212916284960184,-143
"1356","4312221",0.636268524390773,3706,0.65662410846552,4125,-0.0203555840747479,-419
"1357","1412221",0.745143738428009,854,0.743573297459828,1241,0.00157044096818104,-387
"1358","2412221",0.68192056591982,2168,0.687198812819005,2845,-0.00527824689918466,-677
"1359","3412221",0.638806357106317,3606,0.658404979619225,4034,-0.0195986225129087,-428
"1360","4412221",0.597332026405777,5360,0.615994604497415,6170,-0.0186625780916382,-810
"1361","1122221",0.798038213416357,327,0.805988336049531,370,-0.00795012263317374,-43
"1362","2122221",0.734815040908168,1012,0.749613851408708,1109,-0.0147988105005393,-97
"1363","3122221",0.691700832094665,1918,0.720820018208928,1785,-0.0291191861142633,133
"1364","4122221",0.650226501394125,3185,0.678409643087118,3190,-0.0281831416929931,-5
"1365","1222221",0.744080435823361,865,0.750684057103825,1089,-0.00660362128046377,-224
"1366","2222221",0.680857263315172,2202,0.694309572463002,2601,-0.0134523091478294,-399
"1367","3222221",0.637743054501669,3646,0.665515739263222,3721,-0.0277726847615534,-75
"1368","4222221",0.596268723801129,5410,0.623105364141412,5776,-0.0268366403402829,-366
"1369","1322221",0.716100965546585,1346,0.723633489770527,1712,-0.00753252422394202,-366
"1370","2322221",0.652877793038396,3081,0.667259005129704,3638,-0.0143812120913076,-557
"1371","3322221",0.609763584224893,4808,0.638465171929924,5020,-0.0287015877050316,-212
"1372","4322221",0.568289253524353,6785,0.596054796808114,7289,-0.0277655432837611,-504
"1373","1422221",0.677164467561589,2313,0.683003985802421,3009,-0.00583951824083218,-696
"1374","2422221",0.6139412950534,4617,0.626629501161598,5587,-0.0126882061081979,-970
"1375","3422221",0.570827086239897,6645,0.597835667961818,7192,-0.0270085817219219,-547
"1376","4422221",0.529352755539357,8774,0.555425292840008,9608,-0.0260725373006514,-834
"1377","1132221",0.754705691251258,725,0.767523243601502,808,-0.0128175523502446,-83
"1378","2132221",0.691482518743069,1924,0.711148758960679,2043,-0.0196662402176102,-119
"1379","3132221",0.648368309929565,3254,0.682354925760899,3030,-0.0339866158313342,224
"1380","4132221",0.606893979229025,4934,0.639944550639089,4922,-0.0330505714100637,12
"1381","1232221",0.700747913658262,1678,0.712218964655796,2000,-0.0114710509975344,-322
"1382","2232221",0.637524741150073,3657,0.655844480014973,4153,-0.0183197388649,-496
"1383","3232221",0.594410532336569,5497,0.627050646815193,5560,-0.032640114478624,-63
"1384","4232221",0.552936201636029,7546,0.584640271693383,7909,-0.0317040700573538,-363
"1385","1332221",0.672768443381485,2419,0.685168397322498,2920,-0.0123999539410127,-501
"1386","2332221",0.609545270873296,4820,0.628793912681675,5463,-0.0192486418083783,-643
"1387","3332221",0.566431062059793,6863,0.600000079481895,7057,-0.0335690174221023,-194
"1388","4332221",0.524956731359253,9001,0.557589704360085,9471,-0.032632973000832,-470
"1389","1432221",0.633831945396489,3780,0.644538893354392,4674,-0.0107069479579028,-894
"1390","2432221",0.5706087728883,6654,0.588164408713569,7701,-0.0175556358252685,-1047
"1391","3432221",0.527494564074797,8868,0.55937057551379,9369,-0.0318760114389925,-501
"1392","4432221",0.486020233374257,10953,0.516960200391979,11666,-0.0309399670177222,-713
"1393","1142221",0.705672126796428,1575,0.727124749474418,1606,-0.02145262267799,-31
"1394","2142221",0.642448954288239,3465,0.670750264833595,3479,-0.0283013105453556,-14
"1395","3142221",0.599334745474736,5265,0.641956431633815,4818,-0.0426216861590796,447
"1396","4142221",0.557860414774196,7283,0.599546056512005,7081,-0.0416856417378093,202
"1397","1242221",0.651714349203432,3129,0.671820470528712,3443,-0.02010612132528,-314
"1398","2242221",0.588491176695243,5757,0.615445985887889,6191,-0.0269548091926456,-434
"1399","3242221",0.54537696788174,7947,0.586652152688109,7797,-0.0412751848063696,150
"1400","4242221",0.5039026371812,10069,0.544241777566299,10224,-0.0403391403850991,-155
"1401","1342221",0.623734878926656,4191,0.644769903195414,4666,-0.0210350242687583,-475
"1402","2342221",0.560511706418467,7148,0.588395418554591,7692,-0.0278837121361238,-544
"1403","3342221",0.517397497604963,9387,0.559601585354811,9360,-0.0422040877498479,27
"1404","4342221",0.475923166904423,11430,0.517191210233001,11655,-0.0412680433285774,-225
"1405","1442221",0.58479838094166,5959,0.604140399227308,6817,-0.0193420182856484,-858
"1406","2442221",0.521575208433471,9166,0.547765914586485,10020,-0.0261907061530141,-854
"1407","3442221",0.478460999619967,11299,0.518972081386705,11557,-0.0405110817667381,-258
"1408","4442221",0.436986668919427,13060,0.476561706264895,13489,-0.0395750373454677,-429
"1409","1113221",0.827134308710292,169,0.841061057317699,164,-0.0139267486074072,5
"1410","2113221",0.763911136202103,617,0.784686572676875,584,-0.0207754364747728,33
"1411","3113221",0.720796927388599,1259,0.755892739477096,996,-0.0350958120884968,263
"1412","4113221",0.679322596688059,2249,0.713482364355286,1974,-0.0341597676672263,275
"1413","1213221",0.773176531117296,517,0.785756778371993,570,-0.012580247254697,-53
"1414","2213221",0.709953358609107,1470,0.729382293731169,1548,-0.0194289351220626,-78
"1415","3213221",0.666839149795603,2601,0.70058846053139,2386,-0.0337493107357866,215
"1416","4213221",0.625364819095063,4111,0.65817808540958,4045,-0.0328132663145163,66
"1417","1313221",0.745197060840519,853,0.758706211038695,956,-0.0135091501981752,-103
"1418","2313221",0.68197388833233,2166,0.702331726397871,2348,-0.0203578380655408,-182
"1419","3313221",0.638859679518827,3605,0.673537893198092,3374,-0.0346782136792648,231
"1420","4313221",0.597385348818287,5358,0.631127518076282,5354,-0.0337421692579946,4
"1421","1413221",0.706260562855523,1565,0.718076707070589,1857,-0.0118161442150654,-292
"1422","2413221",0.643037390347335,3439,0.661702222429766,3903,-0.0186648320824311,-464
"1423","3413221",0.599923181533831,5234,0.632908389229986,5270,-0.0329852076961551,-36
"1424","4413221",0.558448850833291,7254,0.590498014108176,7572,-0.0320491632748848,-318
"1425","1123221",0.759155037843872,677,0.780491745660292,636,-0.0213367078164204,41
"1426","2123221",0.695931865335683,1794,0.724117261019469,1696,-0.028185395683786,98
"1427","3123221",0.652817656522179,3086,0.695323427819689,2566,-0.04250577129751,520
"1428","4123221",0.611343325821639,4741,0.652913052697879,4284,-0.0415697268762395,457
"1429","1223221",0.705197260250876,1586,0.725187466714586,1669,-0.0199902064637102,-83
"1430","2223221",0.641974087742687,3485,0.668812982073762,3576,-0.0268388943310758,-91
"1431","3223221",0.598859878929183,5281,0.640019148873983,4915,-0.0411592699447998,366
"1432","4223221",0.557385548228643,7317,0.597608773752173,7200,-0.0402232255235295,117
"1433","1323221",0.677217789974099,2310,0.698136899381288,2477,-0.0209191094071884,-167
"1434","2323221",0.61399461746591,4612,0.641762414740465,4829,-0.027767797274554,-217
"1435","3323221",0.570880408652407,6640,0.612968581540685,6334,-0.042088172888278,306
"1436","4323221",0.529406077951867,8767,0.570558206418875,8749,-0.0411521284670078,18
"1437","1423221",0.638281291989103,3626,0.657507395413182,4082,-0.0192261034240786,-456
"1438","2423221",0.575058119480915,6434,0.601132910772359,6991,-0.0260747912914443,-557
"1439","3423221",0.531943910667411,8624,0.572339077572579,8632,-0.0403951669051683,-8
"1440","4423221",0.490469579966871,10712,0.529928702450769,11005,-0.0394591224838981,-293
"1441","1133221",0.715822515678772,1351,0.742026653212263,1268,-0.026204137533491,83
"1442","2133221",0.652599343170583,3096,0.68565216857144,2903,-0.0330528254008566,193
"1443","3133221",0.60948513435708,4825,0.65685833537166,4109,-0.0473732010145806,716
"1444","4133221",0.56801080365654,6798,0.61444796024985,6239,-0.0464371565933104,559
"1445","1233221",0.661864738085776,2762,0.686722374266557,2864,-0.0248576361807811,-102
"1446","2233221",0.598641565577587,5295,0.630347889625734,5390,-0.0317063240481467,-95
"1447","3233221",0.555527356764083,7426,0.601554056425954,6958,-0.0460266996618707,468
"1448","4233221",0.514053026063544,9565,0.559143681304144,9388,-0.0450906552406002,177
"1449","1333221",0.633885267809,3779,0.659671806933259,3986,-0.0257865391242593,-207
"1450","2333221",0.570662095300811,6652,0.603297322292436,6862,-0.0326352269916249,-210
"1451","3333221",0.527547886487307,8865,0.574503489092656,8519,-0.0469556026053489,346
"1452","4333221",0.486073555786767,10951,0.532093113970846,10885,-0.0460195581840785,66
"1453","1433221",0.594948769824004,5472,0.619042302965153,5989,-0.0240935331411495,-517
"1454","2433221",0.531725597315815,8638,0.56266781832433,9182,-0.0309422210085152,-544
"1455","3433221",0.488611388502311,10818,0.533873985124551,10797,-0.0452625966222392,21
"1456","4433221",0.447137057801771,12672,0.49146361000274,12866,-0.0443265522009688,-194
"1457","1143221",0.666788951223942,2602,0.701628159085179,2365,-0.0348392078612366,237
"1458","2143221",0.603565778715754,5060,0.645253674444356,4641,-0.0416878957286022,419
"1459","3143221",0.56045156990225,7154,0.616459841244576,6144,-0.0560082713423262,1010
"1460","4143221",0.51897723920171,9286,0.574049466122766,8544,-0.0550722269210557,742
"1461","1243221",0.612831173630946,4665,0.646323880139473,4592,-0.0334927065085264,73
"1462","2243221",0.549608001122758,7716,0.58994939549865,7604,-0.040341394375892,112
"1463","3243221",0.506493792309254,9927,0.56115556229887,9256,-0.054661769989616,671
"1464","4243221",0.465019461608714,11904,0.51874518717706,11572,-0.0537257255683458,332
"1465","1343221",0.58485170335417,5957,0.619273312806175,5981,-0.0344216094520047,-24
"1466","2343221",0.521628530845981,9164,0.562898828165352,9170,-0.0412702973193703,-6
"1467","3343221",0.478514322032478,11296,0.534104994965572,10787,-0.0555906729330943,509
"1468","4343221",0.437039991331938,13058,0.491694619843762,12859,-0.0546546285118241,199
"1469","1443221",0.545915205369174,7908,0.578643808838069,8276,-0.0327286034688948,-368
"1470","2443221",0.482692032860985,11108,0.522269324197246,11385,-0.0395772913362606,-277
"1471","3443221",0.439577824047482,12958,0.493475490997466,12776,-0.0538976669499846,182
"1472","4443221",0.398103493346942,14349,0.451065115875656,14375,-0.0529616225287143,-26
"1473","1114221",0.774927236739722,501,0.796410443944043,448,-0.0214832072043212,53
"1474","2114221",0.711704064231533,1429,0.74003595930322,1316,-0.0283318950716868,113
"1475","3114221",0.668589855418029,2554,0.71124212610344,2038,-0.0426522706854108,516
"1476","4114221",0.62711552471749,4033,0.66883175098163,3574,-0.0417162262641403,459
"1477","1214221",0.720969459146726,1253,0.741106164998337,1288,-0.020136705851611,-35
"1478","2214221",0.657746286638537,2894,0.684731680357513,2938,-0.0269853937189766,-44
"1479","3214221",0.614632077825033,4572,0.655937847157734,4147,-0.0413057693327006,425
"1480","4214221",0.573157747124493,6528,0.613527472035924,6296,-0.0403697249114303,232
"1481","1314221",0.69298998886995,1873,0.714055597665039,1963,-0.0210656087950892,-90
"1482","2314221",0.629766816361761,3921,0.657681113024216,4069,-0.0279142966624548,-148
"1483","3314221",0.586652607548257,5840,0.628887279824436,5459,-0.0422346722761788,381
"1484","4314221",0.545178276847717,7956,0.586476904702626,7809,-0.0412986278549086,147
"1485","1414221",0.654053490884954,3032,0.673426093696933,3377,-0.0193726028119794,-345
"1486","2414221",0.590830318376765,5638,0.61705160905611,6105,-0.0262212906793451,-467
"1487","3414221",0.547716109563261,7800,0.58825777585633,7698,-0.0405416662930691,102
"1488","4414221",0.506241778862721,9940,0.54584740073452,10121,-0.0396056218717988,-181
"1489","1124221",0.706947965873302,1546,0.735841132286636,1404,-0.0288931664133344,142
"1490","2124221",0.643724793365113,3402,0.679466647645813,3159,-0.0357418542807,243
"1491","3124221",0.600610584551609,5200,0.650672814446033,4386,-0.050062229894424,814
"1492","4124221",0.55913625385107,7220,0.608262439324223,6596,-0.0491261854731535,624
"1493","1224221",0.652990188280306,3076,0.68053685334093,3112,-0.0275466650606242,-36
"1494","2224221",0.589767015772117,5698,0.624162368700107,5714,-0.0343953529279898,-16
"1495","3224221",0.546652806958613,7864,0.595368535500327,7326,-0.0487157285417138,538
"1496","4224221",0.505178476258073,9997,0.552958160378517,9749,-0.0477796841204435,248
"1497","1324221",0.62501071800353,4128,0.653486286007632,4261,-0.0284755680041024,-133
"1498","2324221",0.561787545495341,7071,0.597111801366809,7228,-0.035324255871468,-157
"1499","3324221",0.518673336681837,9296,0.568317968167029,8870,-0.049644631485192,426
"1500","4324221",0.477199005981297,11364,0.525907593045219,11205,-0.0487085870639217,159
"1501","1424221",0.586074220018534,5884,0.612856782039526,6340,-0.0267825620209926,-456
"1502","2424221",0.522851047510345,9101,0.556482297398703,9542,-0.0336312498883583,-441
"1503","3424221",0.479736838696841,11228,0.527688464198924,11113,-0.0479516255020824,115
"1504","4424221",0.438262507996301,13005,0.485278089077113,13128,-0.047015581080812,-123
"1505","1134221",0.663615443708202,2714,0.697376039838607,2492,-0.033760596130405,222
"1506","2134221",0.600392271200013,5210,0.641001555197784,4872,-0.0406092839977706,338
"1507","3134221",0.55727806238651,7326,0.612207721998005,6378,-0.0549296596114947,948
"1508","4134221",0.51580373168597,9476,0.569797346876194,8786,-0.0539936151902244,690
"1509","1234221",0.609657666115206,4814,0.642071760892901,4811,-0.0324140947776951,3
"1510","2234221",0.546434493607017,7877,0.585697276252078,7850,-0.0392627826450607,27
"1511","3234221",0.503320284793514,10100,0.556903443052298,9516,-0.0535831582587847,584
"1512","4234221",0.461845954092974,12053,0.514493067930488,11808,-0.0526471138375142,245
"1513","1334221",0.58167819583843,6106,0.615021193559603,6212,-0.0333429977211733,-106
"1514","2334221",0.518455023330241,9313,0.55864670891878,9415,-0.0401916855885389,-102
"1515","3334221",0.475340814516738,11450,0.529852875719,11009,-0.0545120612022629,441
"1516","4334221",0.433866483816198,13189,0.48744250059719,13035,-0.0535760167809925,154
"1517","1434221",0.542741697853434,8081,0.574391689591497,8528,-0.0316499917380635,-447
"1518","2434221",0.479518525345245,11239,0.518017204950674,11614,-0.0384986796054291,-375
"1519","3434221",0.436404316531742,13079,0.489223371750895,12966,-0.0528190552191531,113
"1520","4434221",0.394929985831202,14450,0.446812996629084,14520,-0.0518830107978828,-70
"1521","1144221",0.614581879253373,4578,0.656977545711523,4103,-0.0423956664581506,475
"1522","2144221",0.551358706745184,7631,0.6006030610707,7029,-0.0492443543255162,602
"1523","3144221",0.50824449793168,9845,0.57180922787092,8669,-0.0635647299392402,1176
"1524","4144221",0.46677016723114,11825,0.52939885274911,11033,-0.0626286855179698,792
"1525","1244221",0.560624101660377,7140,0.601673266765817,6951,-0.0410491651054404,189
"1526","2244221",0.497400929152188,10395,0.545298782124994,10157,-0.0478978529728061,238
"1527","3244221",0.454286720338684,12374,0.516504948925214,11691,-0.0622182285865301,683
"1528","4244221",0.412812389638144,13911,0.474094573803404,13597,-0.0612821841652597,314
"1529","1344221",0.5326446313836,8590,0.574622699432519,8512,-0.0419780680489187,78
"1530","2344221",0.469421458875411,11721,0.518248214791696,11601,-0.0488267559162843,120
"1531","3344221",0.426307250061908,13460,0.489454381591916,12957,-0.0631471315300083,503
"1532","4344221",0.384832919361368,14709,0.447044006470106,14514,-0.062211087108738,195
"1533","1444221",0.493708133398604,10560,0.533993195464413,10790,-0.0402850620658089,-230
"1534","2444221",0.430484960890415,13322,0.47761871082359,13440,-0.0471337499331746,-118
"1535","3444221",0.387370752076912,14648,0.448824877623811,14449,-0.0614541255468987,199
"1536","4444221",0.345896421376372,15493,0.406414502502,15475,-0.0605180811256283,18
"1537","1111321",0.876648417039158,50,0.886826639307915,47,-0.0101782222687571,3
"1538","2111321",0.813425244530969,232,0.830452154667092,216,-0.0170269101361227,16
"1539","3111321",0.770311035717466,554,0.801658321467313,408,-0.0313472857498467,146
"1540","4111321",0.728836705016926,1107,0.759247946345502,943,-0.0304112413285764,164
"1541","1211321",0.822690639446162,187,0.831522360362209,206,-0.00883172091604711,-19
"1542","2211321",0.759467466937973,676,0.775147875721386,694,-0.0156804087834127,-18
"1543","3211321",0.71635325812447,1340,0.746354042521606,1181,-0.0300007843971367,159
"1544","4211321",0.67487892742393,2366,0.703943667399796,2278,-0.0290647399758662,88
"1545","1311321",0.794711169169386,343,0.804471793028911,388,-0.00976062385952536,-45
"1546","2311321",0.731487996661197,1071,0.748097308388088,1144,-0.016609311726891,-73
"1547","3311321",0.688373787847693,1988,0.719303475188308,1821,-0.030929687340615,167
"1548","4311321",0.646899457147154,3306,0.676893100066498,3254,-0.0299936429193445,52
"1549","1411321",0.75577467118439,713,0.763842289060805,875,-0.00806761787641552,-162
"1550","2411321",0.692551498676201,1893,0.707467804419982,2166,-0.0149163057437812,-273
"1551","3411321",0.649437289862697,3217,0.678673971220203,3182,-0.0292366813575052,35
"1552","4411321",0.607962959162158,4895,0.636263596098392,5112,-0.0283006369362347,-217
"1553","1121321",0.808669146172738,257,0.826257327650509,240,-0.0175881814777703,17
"1554","2121321",0.745445973664549,852,0.769882843009685,776,-0.0244368693451359,76
"1555","3121321",0.702331764851046,1652,0.741089009809906,1289,-0.0387572449588599,363
"1556","4121321",0.660857434150506,2789,0.698678634688095,2456,-0.0378212005375896,333
"1557","1221321",0.754711368579742,724,0.770953048704802,757,-0.0162416801250603,-33
"1558","2221321",0.691488196071553,1923,0.714578564063979,1947,-0.0230903679924259,-24
"1559","3221321",0.64837398725805,3253,0.6857847308642,2898,-0.0374107436061499,355
"1560","4221321",0.60689965655751,4933,0.643374355742389,4742,-0.0364746991848794,191
"1561","1321321",0.726731898302966,1145,0.743902481371504,1235,-0.0171705830685386,-90
"1562","2321321",0.663508725794777,2718,0.687527996730681,2830,-0.0240192709359042,-112
"1563","3321321",0.620394516981273,4322,0.658734163530902,4024,-0.0383396465496282,298
"1564","4321321",0.578920186280734,6263,0.616323788409091,6152,-0.0374036021283577,111
"1565","1421321",0.68779540031797,1998,0.703272977403399,2307,-0.0154775770854287,-309
"1566","2421321",0.624572227809781,4151,0.646898492762575,4565,-0.0223262649527944,-414
"1567","3421321",0.581458018996277,6124,0.618104659562796,6043,-0.0366466405665185,81
"1568","4421321",0.539983688295738,8231,0.575694284440986,8451,-0.035710596145248,-220
"1569","1131321",0.765336624007638,606,0.78779223520248,547,-0.0224556111948412,59
"1570","2131321",0.70211345149945,1654,0.731417750561656,1505,-0.0293042990622068,149
"1571","3131321",0.658999242685946,2848,0.702623917361877,2333,-0.0436246746759308,515
"1572","4131321",0.617524911985406,4440,0.660213542240067,3961,-0.0426886302546603,479
"1573","1231321",0.711378846414642,1443,0.732487956256773,1482,-0.021109109842131,-39
"1574","2231321",0.648155673906454,3262,0.67611347161595,3287,-0.0279577977094966,-25
"1575","3231321",0.60504146509295,5008,0.647319638416171,4543,-0.0422781733232206,465
"1576","4231321",0.56356713439241,6980,0.60490926329436,6780,-0.0413421289019503,200
"1577","1331321",0.683399376137866,2125,0.705437388923476,2238,-0.0220380127856092,-113
"1578","2331321",0.620176203629677,4329,0.649062904282652,4455,-0.0288867006529748,-126
"1579","3331321",0.577061994816174,6336,0.620269071082873,5929,-0.0432070762666988,407
"1580","4331321",0.535587664115634,8438,0.577858695961062,8331,-0.0422710318454286,107
"1581","1431321",0.64446287815287,3384,0.66480788495537,3759,-0.0203450068024994,-375
"1582","2431321",0.581239705644681,6136,0.608433400314547,6587,-0.0271936946698651,-451
"1583","3431321",0.538125496831178,8326,0.579639567114767,8218,-0.0415140702835891,108
"1584","4431321",0.496651166130638,10422,0.537229191992957,10625,-0.0405780258623189,-203
"1585","1141321",0.716303059552809,1341,0.747393741075396,1159,-0.0310906815225865,182
"1586","2141321",0.65307988704462,3070,0.691019256434572,2706,-0.0379393693899521,364
"1587","3141321",0.609965678231117,4800,0.662225423234793,3870,-0.0522597450036761,930
"1588","4141321",0.568491347530577,6765,0.619815048112982,5950,-0.0513237005824059,815
"1589","1241321",0.662345281959813,2752,0.692089462129689,2665,-0.0297441801698766,87
"1590","2241321",0.599122109451624,5271,0.635714977488866,5135,-0.0365928680372422,136
"1591","3241321",0.55600790063812,7401,0.606921144289087,6654,-0.0509132436509662,747
"1592","4241321",0.514533569937581,9531,0.564510769167276,9073,-0.0499771992296957,458
"1593","1341321",0.634365811683037,3767,0.665038894796391,3749,-0.0306730831133548,18
"1594","2341321",0.571142639174848,6632,0.608664410155568,6575,-0.0375217709807204,57
"1595","3341321",0.528028430361344,8847,0.579870576955789,8207,-0.0518421465944444,640
"1596","4341321",0.486554099660804,10931,0.537460201833978,10613,-0.050906102173174,318
"1597","1441321",0.595429313698041,5450,0.624409390828286,5698,-0.028980077130245,-248
"1598","2441321",0.532206141189852,8611,0.568034906187462,8885,-0.0358287649976107,-274
"1599","3441321",0.489091932376348,10797,0.539241072987683,10510,-0.0501491406113347,287
"1600","4441321",0.447617601675808,12652,0.496830697865873,12628,-0.0492130961900643,24
"1601","1112321",0.843563505277469,118,0.848507657779263,131,-0.00494415250179392,-13
"1602","2112321",0.78034033276928,447,0.79213317313844,491,-0.0117928403691595,-44
"1603","3112321",0.737226123955777,974,0.76333933993866,885,-0.0261132159828835,89
"1604","4112321",0.695751793255237,1802,0.72092896481685,1781,-0.0251771715616133,21
"1605","1212321",0.789605727684473,383,0.793203378833557,479,-0.00359765114908395,-96
"1606","2212321",0.726382555176284,1153,0.736828894192734,1380,-0.0104463390164495,-227
"1607","3212321",0.683268346362781,2131,0.708035060992954,2142,-0.0247667146301735,-11
"1608","4212321",0.641794015662241,3492,0.665624685871144,3714,-0.0238306702089031,-222
"1609","1312321",0.761626257407697,649,0.766152811500259,840,-0.0045265540925622,-191
"1610","2312321",0.698403084899508,1732,0.709778326859436,2090,-0.0113752419599278,-358
"1611","3312321",0.655288876086005,2983,0.680984493659656,3093,-0.0256956175736518,-110
"1612","4312321",0.613814545385465,4623,0.638574118537846,5012,-0.0247595731523813,-389
"1613","1412321",0.722689759422701,1216,0.725523307532153,1656,-0.00283354810945236,-440
"1614","2412321",0.659466586914512,2831,0.66914882289133,3558,-0.00968223597681805,-727
"1615","3412321",0.616352378101009,4488,0.640354989691551,4898,-0.0240026115905421,-410
"1616","4412321",0.574878047400469,6444,0.59794461456974,7185,-0.0230665671692716,-741
"1617","1122321",0.775584234411049,496,0.787938346121856,544,-0.0123541117108071,-48
"1618","2122321",0.71236106190286,1421,0.731563861481033,1503,-0.0192027995781727,-82
"1619","3122321",0.669246853089357,2536,0.702770028281254,2327,-0.0335231751918967,209
"1620","4122321",0.627772522388817,4004,0.660359653159443,3955,-0.0325871307706265,49
"1621","1222321",0.721626456818053,1242,0.73263406717615,1477,-0.0110076103580972,-235
"1622","2222321",0.658403284309864,2878,0.676259582535327,3284,-0.0178562982254628,-406
"1623","3222321",0.615289075496361,4540,0.647465749335547,4534,-0.0321766738391868,6
"1624","4222321",0.573814744795821,6487,0.605055374213737,6768,-0.0312406294179163,-281
"1625","1322321",0.693646986541277,1853,0.705583499842852,2231,-0.0119365133015754,-378
"1626","2322321",0.630423814033088,3897,0.649209015202029,4449,-0.018785201168941,-552
"1627","3322321",0.587309605219585,5814,0.62041518200225,5922,-0.033105576782665,-108
"1628","4322321",0.545835274519045,7917,0.578004806880439,8320,-0.0321695323613945,-403
"1629","1422321",0.654710488556281,2996,0.664953995874746,3752,-0.0102435073184656,-756
"1630","2422321",0.591487316048092,5608,0.608579511233923,6581,-0.0170921951858313,-973
"1631","3422321",0.548373107234589,7772,0.579785678034144,8210,-0.0314125707995553,-438
"1632","4422321",0.506898776534049,9910,0.537375302912333,10620,-0.0304765263782848,-710
"1633","1132321",0.73225171224595,1057,0.749473253673828,1112,-0.017221541427878,-55
"1634","2132321",0.669028539737761,2540,0.693098769033004,2638,-0.0240702292952436,-98
"1635","3132321",0.625914330924257,4074,0.664304935833225,3784,-0.0383906049089676,290
"1636","4132321",0.584440000223717,5979,0.621894560711414,5833,-0.0374545604876971,146
"1637","1232321",0.678293934652954,2283,0.694168974728121,2605,-0.0158750400751678,-322
"1638","2232321",0.615070762144765,4553,0.637794490087298,5050,-0.0227237279425334,-497
"1639","3232321",0.571956553331261,6590,0.609000656887519,6554,-0.0370441035562574,36
"1640","4232321",0.530482222630721,8708,0.566590281765708,8963,-0.0361080591349872,-255
"1641","1332321",0.650314464376177,3181,0.667118407394823,3646,-0.0168039430186461,-465
"1642","2332321",0.587091291867988,5825,0.610743922754,6448,-0.0236526308860117,-623
"1643","3332321",0.543977083054485,8020,0.581950089554221,8087,-0.0379730064997357,-67
"1644","4332321",0.502502752353945,10138,0.53953971443241,10497,-0.0370369620784654,-359
"1645","1432321",0.611377966391181,4736,0.626488903426718,5591,-0.0151109370355362,-855
"1646","2432321",0.548154793882992,7783,0.570114418785894,8770,-0.0219596249029019,-987
"1647","3432321",0.505040585069489,10004,0.541320585586115,10401,-0.0362800005166259,-397
"1648","4432321",0.463566254368949,11971,0.498910210464305,12553,-0.0353439560953557,-582
"1649","1142321",0.68321814779112,2132,0.709074759546743,2110,-0.0258566117556234,22
"1650","2142321",0.619994975282931,4335,0.65270027490592,4293,-0.032705299622989,42
"1651","3142321",0.576880766469428,6341,0.623906441706141,5729,-0.047025675236713,612
"1652","4142321",0.535406435768888,8447,0.58149606658433,8105,-0.0460896308154427,342
"1653","1242321",0.629260370198124,3951,0.653770480601037,4244,-0.0245101104029134,-293
"1654","2242321",0.566037197689935,6886,0.597395995960214,7216,-0.031358798270279,-330
"1655","3242321",0.522922988876432,9096,0.568602162760435,8852,-0.045679173884003,244
"1656","4242321",0.481448658175892,11160,0.526191787638624,11189,-0.0447431294627326,-29
"1657","1342321",0.601280899921348,5177,0.626719913267739,5582,-0.0254390133463916,-405
"1658","2342321",0.538057727413159,8328,0.570345428626916,8761,-0.0322877012137572,-433
"1659","3342321",0.494943518599655,10502,0.541551595427137,10390,-0.0466080768274813,112
"1660","4342321",0.453469187899115,12411,0.499141220305326,12541,-0.0456720324062108,-130
"1661","1442321",0.562344401936352,7048,0.586090409299634,7827,-0.0237460073632818,-779
"1662","2442321",0.499121229428163,10311,0.52971592465881,11016,-0.0305946952306476,-705
"1663","3442321",0.456007020614659,12307,0.500922091459031,12444,-0.0449150708443716,-137
"1664","4442321",0.414532689914119,13862,0.458511716337221,14136,-0.0439790264231011,-274
"1665","1113321",0.804680329704984,280,0.823011067390024,253,-0.0183307376850406,27
"1666","2113321",0.741457157196795,902,0.766636582749201,831,-0.0251794255524062,71
"1667","3113321",0.698342948383291,1733,0.737842749549421,1354,-0.0394998011661302,379
"1668","4113321",0.656868617682751,2924,0.695432374427611,2563,-0.0385637567448597,361
"1669","1213321",0.750722552111988,777,0.767706788444318,803,-0.0169842363323304,-26
"1670","2213321",0.687499379603799,2011,0.711332303803495,2036,-0.023832924199696,-25
"1671","3213321",0.644385170790295,3388,0.682538470603715,3022,-0.03815329981342,366
"1672","4213321",0.602910840089755,5093,0.640128095481905,4908,-0.0372172553921497,185
"1673","1313321",0.722743081835211,1214,0.74065622111102,1303,-0.0179131392758086,-89
"1674","2313321",0.659519909327023,2827,0.684281736470197,2957,-0.0247618271431742,-130
"1675","3313321",0.616405700513519,4483,0.655487903270417,4167,-0.0390822027568982,316
"1676","4313321",0.574931369812979,6440,0.613077528148607,6322,-0.038146158335628,118
"1677","1413321",0.683806583850215,2105,0.700026717142914,2406,-0.0162201332926988,-301
"1678","2413321",0.620583411342027,4308,0.643652232502091,4725,-0.0230688211600645,-417
"1679","3413321",0.577469202528523,6317,0.614858399302312,6218,-0.0373891967737885,99
"1680","4413321",0.535994871827983,8423,0.572448024180501,8626,-0.0364531523525182,-203
"1681","1123321",0.736701058838564,980,0.762441755732617,902,-0.0257406968940538,78
"1682","2123321",0.673477886330375,2400,0.706067271091794,2216,-0.0325893847614194,184
"1683","3123321",0.630363677516871,3902,0.677273437892015,3237,-0.0469097603751434,665
"1684","4123321",0.588889346816331,5734,0.634863062770204,5191,-0.0459737159538729,543
"1685","1223321",0.682743281245568,2143,0.707137476786911,2178,-0.0243941955413436,-35
"1686","2223321",0.619520108737379,4359,0.650762992146088,4381,-0.0312428834087092,-22
"1687","3223321",0.576405899923875,6364,0.621969158946308,5829,-0.0455632590224332,535
"1688","4223321",0.534931569223335,8467,0.579558783824498,8221,-0.0446272146011629,246
"1689","1323321",0.654763810968791,2990,0.680086909453613,3134,-0.0253230984848218,-144
"1690","2323321",0.591540638460603,5598,0.62371242481279,5740,-0.0321717863521874,-142
"1691","3323321",0.548426429647099,7766,0.59491859161301,7348,-0.0464921619659114,418
"1692","4323321",0.506952098946559,9905,0.5525082164912,9773,-0.0455561175446412,132
"1693","1423321",0.615827312983795,4503,0.639457405485507,4956,-0.023630092501712,-453
"1694","2423321",0.552604140475607,7559,0.583082920844684,8013,-0.0304787803690777,-454
"1695","3423321",0.509489931662103,9777,0.554289087644905,9665,-0.0447991559828017,112
"1696","4423321",0.468015600961563,11777,0.511878712523094,11940,-0.0438631115615315,-163
"1697","1133321",0.693368536673464,1867,0.723976663284589,1700,-0.0306081266111244,167
"1698","2133321",0.630145364165275,3910,0.667602178643765,3625,-0.03745681447849,285
"1699","3133321",0.587031155351772,5826,0.638808345443986,4998,-0.051777190092214,828
"1700","4133321",0.545556824651232,7928,0.596397970322175,7271,-0.0508411456709438,657
"1701","1233321",0.639410759080468,3593,0.668672384338882,3582,-0.0292616252584145,11
"1702","2233321",0.576187586572279,6376,0.612297899698059,6372,-0.0361103131257801,4
"1703","3233321",0.533073377758776,8574,0.58350406649828,7979,-0.0504306887395041,595
"1704","4233321",0.491599047058236,10661,0.541093691376469,10416,-0.0494946443182336,245
"1705","1333321",0.611431288803692,4733,0.641621817005584,4840,-0.0301905282018927,-107
"1706","2333321",0.548208116295503,7777,0.585247332364761,7872,-0.0370392160692583,-95
"1707","3333321",0.505093907481999,10001,0.556453499164982,9546,-0.0513595916829823,455
"1708","4333321",0.463619576781459,11969,0.514043124043171,11829,-0.0504235472617119,140
"1709","1433321",0.572494790818696,6561,0.600992313037479,6998,-0.0284975222187829,-437
"1710","2433321",0.509271618310507,9787,0.544617828396655,10200,-0.0353462100861486,-413
"1711","3433321",0.466157409497003,11854,0.515823995196876,11728,-0.0496665856998726,126
"1712","4433321",0.424683078796463,13521,0.473413620075066,13627,-0.0487305412786022,-106
"1713","1143321",0.644334972218634,3389,0.683578169157504,2984,-0.03924319693887,405
"1714","2143321",0.581111799710446,6140,0.627203684516681,5551,-0.0460918848062356,589
"1715","3143321",0.537997590896942,8331,0.598409851316902,7150,-0.0604122604199596,1181
"1716","4143321",0.496523260196402,10427,0.555999476195091,9578,-0.0594762159986892,849
"1717","1243321",0.590377194625638,5675,0.628273890211798,5488,-0.0378966955861598,187
"1718","2243321",0.52715402211745,8894,0.571899405570975,8664,-0.0447453834535254,230
"1719","3243321",0.484039813303946,11051,0.543105572371195,10281,-0.0590657590672495,770
"1720","4243321",0.442565482603406,12849,0.500695197249385,12461,-0.0581297146459793,388
"1721","1343321",0.562397724348862,7045,0.6012233228785,6985,-0.0388255985296381,60
"1722","2343321",0.499174551840673,10306,0.544848838237677,10182,-0.0456742863970037,124
"1723","3343321",0.45606034302717,12305,0.516055005037898,11717,-0.0599946620107277,588
"1724","4343321",0.41458601232663,13860,0.473644629916087,13617,-0.0590586175894575,243
"1725","1443321",0.523461226363866,9065,0.560593818910395,9291,-0.0371325925465282,-226
"1726","2443321",0.460238053855677,12128,0.504219334269571,12288,-0.043981280413894,-160
"1727","3443321",0.417123845042174,13785,0.475425501069792,13534,-0.058301656027618,251
"1728","4443321",0.375649514341634,14930,0.433015125947982,14895,-0.0573656116063477,35
"1729","1114321",0.752473257734414,751,0.778360454016368,658,-0.0258871962819546,93
"1730","2114321",0.689250085226225,1961,0.721985969375545,1752,-0.0327358841493202,209
"1731","3114321",0.646135876412721,3328,0.693192136175766,2633,-0.0470562597630442,695
"1732","4114321",0.604661545712182,5019,0.650781761053955,4379,-0.0461202153417737,640
"1733","1214321",0.698515480141418,1728,0.723056175070662,1723,-0.0245406949292444,5
"1734","2214321",0.635292307633229,3731,0.666681690429839,3659,-0.03138938279661,72
"1735","3214321",0.592178098819725,5581,0.637887857230059,5044,-0.045709758410334,537
"1736","4214321",0.550703768119185,7665,0.595477482108249,7319,-0.0447737139890637,346
"1737","1314321",0.670536009864642,2487,0.696005607737364,2538,-0.0254695978727226,-51
"1738","2314321",0.607312837356453,4918,0.639631123096541,4941,-0.0323182857400882,-23
"1739","3314321",0.564198628542949,6961,0.610837289896761,6444,-0.0466386613538122,517
"1740","4314321",0.522724297842409,9105,0.568426914774951,8864,-0.045702616932542,241
"1741","1414321",0.631599511879646,3855,0.655376103769258,4170,-0.0237765918896128,-315
"1742","2414321",0.568376339371457,6774,0.599001619128435,7115,-0.0306252797569785,-341
"1743","3414321",0.525262130557953,8989,0.570207785928656,8766,-0.0449456553707025,223
"1744","4414321",0.483787799857413,11062,0.527797410806845,11108,-0.0440096109494323,-46
"1745","1124321",0.684493986867994,2092,0.717791142358962,1867,-0.0332971554909678,225
"1746","2124321",0.621270814359805,4280,0.661416657718138,3915,-0.0401458433583334,365
"1747","3124321",0.578156605546301,6291,0.632622824518359,5285,-0.0544662189720574,1006
"1748","4124321",0.536682274845762,8383,0.590212449396548,7590,-0.0535301745507869,793
"1749","1224321",0.630536209274998,3892,0.662486863413255,3858,-0.0319506541382576,34
"1750","2224321",0.567313036766809,6830,0.606112378772432,6695,-0.0387993420056232,135
"1751","3224321",0.524198827953305,9038,0.577318545572653,8360,-0.0531197176193472,678
"1752","4224321",0.482724497252765,11107,0.534908170450842,10743,-0.052183673198077,364
"1753","1324321",0.602556738998222,5106,0.635436296079957,5152,-0.0328795570817358,-46
"1754","2324321",0.539333566490033,8259,0.579061811439134,8254,-0.0397282449491014,5
"1755","3324321",0.496219357676529,10445,0.550267978239355,9881,-0.0540486205628255,564
"1756","4324321",0.454745026975989,12355,0.507857603117544,12126,-0.0531125761415552,229
"1757","1424321",0.563620241013226,6978,0.594806792111852,7352,-0.031186551098626,-374
"1758","2424321",0.500397068505037,10242,0.538432307471028,10557,-0.0380352389659917,-315
"1759","3424321",0.457282859691533,12249,0.509638474271249,12043,-0.0523556145797158,206
"1760","4424321",0.415808528990993,13821,0.467228099149439,13845,-0.0514195701584454,-24
"1761","1134321",0.641161464702894,3519,0.679326049910933,3163,-0.0381645852080384,356
"1762","2134321",0.577938292194705,6298,0.622951565270109,5787,-0.045013273075404,511
"1763","3134321",0.534824083381202,8471,0.59415773207033,7396,-0.059333648689128,1075
"1764","4134321",0.493349752680662,10575,0.55174735694852,9809,-0.0583976042678578,766
"1765","1234321",0.587203687109898,5823,0.624021770965226,5720,-0.0368180838553285,103
"1766","2234321",0.523980514601709,9046,0.567647286324403,8905,-0.0436667717226941,141
"1767","3234321",0.480866305788206,11191,0.538853453124624,10530,-0.0579871473364181,661
"1768","4234321",0.439391975087666,12967,0.496443078002813,12649,-0.0570511029151477,318
"1769","1334321",0.559224216833122,7214,0.596971203631929,7239,-0.0377469867988067,-25
"1770","2334321",0.496001044324933,10453,0.540596718991105,10448,-0.0445956746661724,5
"1771","3334321",0.452886835511429,12432,0.511802885791326,11945,-0.0589160502798964,487
"1772","4334321",0.41141250481089,13953,0.469392510669515,13784,-0.057980005858626,169
"1773","1434321",0.520287718848126,9223,0.556341699663823,9553,-0.0360539808156969,-330
"1774","2434321",0.457064546339937,12259,0.499967215023,12502,-0.0429026686830626,-243
"1775","3434321",0.413950337526434,13873,0.47117338182322,13715,-0.0572230442967866,158
"1776","4434321",0.372476006825893,14997,0.42876300670141,15009,-0.0562869998755163,-12
"1777","1144321",0.592127900248065,5582,0.638927555783849,4992,-0.046799655535784,590
"1778","2144321",0.528904727739876,8794,0.582553071143025,8050,-0.0536483434031496,744
"1779","3144321",0.485790518926372,10965,0.553759237943246,9700,-0.0679687190168737,1265
"1780","4144321",0.444316188225832,12787,0.511348862821436,11971,-0.0670326745956032,816
"1781","1244321",0.538170122655069,8322,0.583623276838142,7973,-0.0454531541830738,349
"1782","2244321",0.47494695014688,11474,0.527248792197319,11131,-0.0523018420504395,343
"1783","3244321",0.431832741333376,13276,0.49845495899754,12568,-0.0666222176641635,708
"1784","4244321",0.390358410632836,14582,0.456044583875729,14211,-0.0656861732428932,371
"1785","1344321",0.510190652378292,9751,0.556572709504844,9538,-0.0463820571265521,213
"1786","2344321",0.446967479870103,12682,0.500198224864021,12486,-0.0532307449939177,196
"1787","3344321",0.4038532710566,14200,0.471404391664242,13709,-0.0675511206076418,491
"1788","4344321",0.36237894035606,15220,0.428994016542431,15003,-0.0666150761863715,217
"1789","1444321",0.471254154393296,11641,0.515943205536739,11719,-0.0446890511434423,-78
"1790","2444321",0.408030981885107,14061,0.459568720895915,14099,-0.051537739010808,-38
"1791","3444321",0.364916773071604,15169,0.430774887696136,14961,-0.0658581146245321,208
"1792","4444321",0.323442442371064,15809,0.388364512574326,15750,-0.0649220702032617,59
"1793","1111421",0.846856400027011,105,0.8527014994708,113,-0.0058450994437893,-8
"1794","2111421",0.783633227518822,422,0.796327014829977,449,-0.0126937873111549,-27
"1795","3111421",0.740519018705318,919,0.767533181630197,807,-0.0270141629248789,112
"1796","4111421",0.699044688004778,1716,0.725122806508387,1673,-0.0260781185036086,43
"1797","1211421",0.792898622434014,354,0.797397220525094,437,-0.00449859809107933,-83
"1798","2211421",0.729675449925826,1095,0.74102273588427,1291,-0.0113472859584449,-196
"1799","3211421",0.686561241112322,2040,0.712228902684491,1999,-0.0256676615721689,41
"1800","4211421",0.645086910411782,3363,0.669818527562681,3517,-0.0247316171508984,-154
"1801","1311421",0.764919152157238,611,0.770346653191796,768,-0.00542750103455758,-157
"1802","2311421",0.701695979649049,1662,0.713972168550973,1964,-0.0122761889019232,-302
"1803","3311421",0.658581770835546,2871,0.685178335351193,2919,-0.0265965645156472,-48
"1804","4311421",0.617107440135006,4460,0.642767960229383,4775,-0.0256605200943767,-315
"1805","1411421",0.725982654172242,1159,0.72971714922369,1537,-0.00373449505144774,-378
"1806","2411421",0.662759481664053,2736,0.673342664582867,3379,-0.0105831829188134,-643
"1807","3411421",0.61964527285055,4352,0.644548831383087,4673,-0.0249035585325375,-321
"1808","4411421",0.57817094215001,6289,0.602138456261277,6925,-0.023967514111267,-636
"1809","1121421",0.778877129160591,462,0.792132187813393,492,-0.0132550586528025,-30
"1810","2121421",0.715653956652402,1356,0.73575770317257,1406,-0.0201037465201681,-50
"1811","3121421",0.672539747838898,2431,0.70696386997279,2184,-0.0344241221338921,247
"1812","4121421",0.631065417138358,3877,0.66455349485098,3775,-0.0334880777126219,102
"1813","1221421",0.724919351567594,1177,0.736827908867687,1381,-0.0119085573000925,-204
"1814","2221421",0.661696179059406,2766,0.680453424226864,3118,-0.0187572451674581,-352
"1815","3221421",0.618581970245902,4401,0.651659591027084,4332,-0.0330776207811821,69
"1816","4221421",0.577107639545362,6333,0.609249215905274,6537,-0.0321415763599117,-204
"1817","1321421",0.696939881290818,1777,0.709777341534389,2091,-0.0128374602435708,-314
"1818","2321421",0.633716708782629,3787,0.653402856893566,4267,-0.0196861481109364,-480
"1819","3321421",0.590602499969126,5658,0.624609023693786,5690,-0.0340065237246604,-32
"1820","4321421",0.549128169268586,7741,0.582198648571976,8071,-0.0330704793033899,-330
"1821","1421421",0.658003383305822,2889,0.669147837566283,3559,-0.011144454260461,-670
"1822","2421421",0.594780210797633,5478,0.61277335292546,6343,-0.0179931421278267,-865
"1823","3421421",0.55166600198413,7617,0.583979519725681,7947,-0.0323135177415507,-330
"1824","4421421",0.51019167128359,9750,0.54156914460387,10386,-0.0313774733202802,-636
"1825","1131421",0.735544606995491,1004,0.753667095365364,1030,-0.0181224883698734,-26
"1826","2131421",0.672321434487302,2435,0.697292610724541,2495,-0.024971176237239,-60
"1827","3131421",0.629207225673799,3955,0.668498777524762,3593,-0.039291551850963,362
"1828","4131421",0.587732894973259,5787,0.626088402402951,5611,-0.0383555074296925,176
"1829","1231421",0.681586829402495,2181,0.698362816419658,2466,-0.0167759870171632,-285
"1830","2231421",0.618363656894306,4412,0.641988331778835,4815,-0.0236246748845288,-403
"1831","3231421",0.575249448080803,6419,0.613194498579055,6314,-0.0379450504982528,105
"1832","4231421",0.533775117380263,8521,0.570784123457245,8738,-0.0370090060769825,-217
"1833","1331421",0.653607359125719,3051,0.67131224908636,3461,-0.0177048899606415,-410
"1834","2331421",0.59038418661753,5674,0.614937764445537,6215,-0.024553577828007,-541
"1835","3331421",0.547269977804026,7833,0.586143931245757,7825,-0.0388739534417311,8
"1836","4331421",0.505795647103486,9959,0.543733556123947,10250,-0.0379379090204608,-291
"1837","1431421",0.614670861140723,4567,0.630682745118254,5372,-0.0160118839775316,-805
"1838","2431421",0.551447688632534,7625,0.574308260477431,8533,-0.0228605718448973,-908
"1839","3431421",0.50833347981903,9836,0.545514427277652,10139,-0.0371809474586213,-303
"1840","4431421",0.46685914911849,11820,0.503104052155841,12341,-0.036244903037351,-521
"1841","1141421",0.686511042540662,2044,0.71326860123828,1977,-0.0267575586976188,67
"1842","2141421",0.623287870032473,4213,0.656894116597457,4108,-0.0336062465649843,105
"1843","3141421",0.580173661218969,6199,0.628100283397678,5496,-0.0479266221787084,703
"1844","4141421",0.538699330518429,8294,0.585689908275867,7851,-0.0469905777574381,443
"1845","1241421",0.632553264947665,3823,0.657964322292574,4056,-0.0254110573449088,-233
"1846","2241421",0.569330092439476,6725,0.601589837651751,6957,-0.0322597452122744,-232
"1847","3241421",0.526215883625973,8950,0.572796004451971,8603,-0.0465801208259984,347
"1848","4241421",0.484741552925433,11007,0.530385629330161,10981,-0.045644076404728,26
"1849","1341421",0.604573794670889,5025,0.630913754959276,5365,-0.026339960288387,-340
"1850","2341421",0.5413506221627,8159,0.574539270318453,8518,-0.0331886481557526,-359
"1851","3341421",0.498236413349197,10354,0.545745437118673,10126,-0.0475090237694766,228
"1852","4341421",0.456762082648657,12271,0.503335061996863,12330,-0.0465729793482062,-59
"1853","1441421",0.565637296685893,6906,0.59028425099117,7584,-0.0246469543052772,-678
"1854","2441421",0.502414124177704,10141,0.533909766350347,10796,-0.0314956421726429,-655
"1855","3441421",0.459299915364201,12175,0.505115933150568,12240,-0.0458160177863668,-65
"1856","4441421",0.417825584663661,13757,0.462705558028757,13988,-0.0448799733650964,-231
"1857","1112421",0.813771488265322,229,0.814382517942148,303,-0.000611029676826136,-74
"1858","2112421",0.750548315757133,781,0.758008033301325,960,-0.00745971754419172,-179
"1859","3112421",0.707434106943629,1538,0.729214200101545,1551,-0.0217800931579157,-13
"1860","4112421",0.665959776243089,2629,0.686803824979735,2861,-0.0208440487366455,-232
"1861","1212421",0.759813710672326,671,0.759078238996442,948,0.000735471675883836,-277
"1862","2212421",0.696590538164137,1785,0.702703754355618,2330,-0.00611321619148175,-545
"1863","3212421",0.653476329350633,3061,0.673909921155839,3348,-0.0204335918052058,-287
"1864","4212421",0.612001998650093,4704,0.631499546034029,5337,-0.0194975473839353,-633
"1865","1312421",0.731834240395549,1063,0.732027671663144,1494,-0.000193431267594413,-431
"1866","2312421",0.66861106788736,2552,0.67565318702232,3302,-0.00704211913496,-750
"1867","3312421",0.625496859073857,4106,0.646859353822541,4567,-0.021362494748684,-461
"1868","4312421",0.584022528373317,6002,0.604448978700731,6808,-0.0204264503274135,-806
"1869","1412421",0.692897742410553,1877,0.691398167695038,2696,0.00149957471551543,-819
"1870","2412421",0.629674569902364,3925,0.635023683054215,5177,-0.00534911315185027,-1252
"1871","3412421",0.586560361088861,5848,0.606229849854435,6686,-0.0196694887655743,-838
"1872","4412421",0.545086030388321,7962,0.563819474732625,9116,-0.0187334443443038,-1154
"1873","1122421",0.745792217398902,847,0.753813206284741,1026,-0.00802098888583935,-179
"1874","2122421",0.682569044890713,2154,0.697438721643918,2490,-0.0148696767532049,-336
"1875","3122421",0.639454836077209,3590,0.668644888444138,3584,-0.029190052366929,6
"1876","4122421",0.597980505376669,5326,0.626234513322328,5606,-0.0282540079456587,-280
"1877","1222421",0.691834439805906,1909,0.698508927339035,2460,-0.00667448753312938,-551
"1878","2222421",0.628611267297717,3980,0.642134442698212,4808,-0.013523175400495,-828
"1879","3222421",0.585497058484213,5924,0.613340609498432,6303,-0.027843551014219,-379
"1880","4222421",0.544022727783673,8018,0.570930234376622,8729,-0.0269075065929485,-711
"1881","1322421",0.663854969529129,2702,0.671458360005737,3457,-0.00760339047660763,-755
"1882","2322421",0.60063179702094,5197,0.615083875364914,6210,-0.0144520783439732,-1013
"1883","3322421",0.557517588207437,7305,0.586290042165134,7821,-0.0287724539576972,-516
"1884","4322421",0.516043257506897,9469,0.543879667043324,10244,-0.0278364095364267,-775
"1885","1422421",0.624918471544133,4135,0.630828856037631,5369,-0.00591038449349779,-1234
"1886","2422421",0.561695299035945,7078,0.574454371396808,8523,-0.0127590723608635,-1445
"1887","3422421",0.518581090222441,9308,0.545660538197029,10131,-0.0270794479745875,-823
"1888","4422421",0.477106759521901,11372,0.503250163075218,12336,-0.0261434035533171,-964
"1889","1132421",0.702459695233802,1645,0.715348113836712,1923,-0.0128884186029102,-278
"1890","2132421",0.639236522725613,3596,0.658973629195889,4013,-0.0197371064702758,-417
"1891","3132421",0.59612231391211,5418,0.63017979599611,5401,-0.0340574820839998,17
"1892","4132421",0.55464798321157,7461,0.587769420874299,7721,-0.0331214376627293,-260
"1893","1232421",0.648501917640806,3246,0.660043834891006,3968,-0.0115419172502,-722
"1894","2232421",0.585278745132617,5939,0.603669350250183,6843,-0.0183906051175656,-904
"1895","3232421",0.542164536319114,8114,0.574875517050403,8499,-0.0327109807312896,-385
"1896","4232421",0.500690205618574,10226,0.532465141928593,10871,-0.0317749363100194,-645
"1897","1332421",0.62052244736403,4312,0.632993267557708,5266,-0.0124708201936783,-954
"1898","2332421",0.557299274855841,7321,0.576618782916885,8392,-0.0193195080610439,-1071
"1899","3332421",0.514185066042337,9556,0.547824949717105,10017,-0.0336398836747679,-461
"1900","4332421",0.472710735341797,11578,0.505414574595295,12230,-0.0327038392534976,-652
"1901","1432421",0.581585949379034,6112,0.592363763589602,7484,-0.0107778142105684,-1372
"1902","2432421",0.518362776870845,9318,0.535989278948779,10684,-0.0176265020779341,-1366
"1903","3432421",0.475248568057341,11455,0.507195445749,12152,-0.0319468776916582,-697
"1904","4432421",0.433774237356802,13194,0.464785070627189,13927,-0.0310108332703878,-733
"1905","1142421",0.653426130778973,3065,0.674949619709628,3320,-0.0215234889306556,-255
"1906","2142421",0.590202958270784,5686,0.618575135068805,6014,-0.0283721767980212,-328
"1907","3142421",0.54708874945728,7850,0.589781301869025,7615,-0.0426925524117452,235
"1908","4142421",0.50561441875674,9972,0.547370926747215,10039,-0.0417565079904749,-67
"1909","1242421",0.599468353185976,5257,0.619645340763922,5960,-0.0201769875779456,-703
"1910","2242421",0.536245180677787,8415,0.563270856123099,9148,-0.0270256754453112,-733
"1911","3242421",0.493130971864284,10596,0.534477022923319,10764,-0.0413460510590352,-168
"1912","4242421",0.451656641163744,12474,0.492066647801509,12849,-0.0404100066377648,-375
"1913","1342421",0.5714888829092,6614,0.592594773430624,7475,-0.0211058905214239,-861
"1914","2342421",0.508265710401011,9841,0.536220288789801,10674,-0.0279545783887895,-833
"1915","3342421",0.465151501587508,11899,0.507426455590021,12141,-0.0422749540025134,-242
"1916","4342421",0.423677170886968,13557,0.465016080468211,13923,-0.041338909581243,-366
"1917","1442421",0.532552384924204,8595,0.551965269462518,9796,-0.019412884538314,-1201
"1918","2442421",0.469329212416015,11726,0.495590784821695,12688,-0.0262615724056797,-962
"1919","3442421",0.426215003602512,13466,0.466796951621916,13857,-0.0405819480194036,-391
"1920","4442421",0.384740672901972,14713,0.424386576500105,15101,-0.0396459035981332,-388
"1921","1113421",0.774888312692836,502,0.788885927552909,535,-0.0139976148600728,-33
"1922","2113421",0.711665140184647,1431,0.732511442912086,1481,-0.0208463027274384,-50
"1923","3113421",0.668550931371144,2556,0.703717609712306,2288,-0.0351666783411624,268
"1924","4113421",0.627076600670604,4034,0.661307234590496,3923,-0.0342306339198919,111
"1925","1213421",0.72093053509984,1254,0.733581648607203,1449,-0.0126511135073626,-195
"1926","2213421",0.657707362591651,2896,0.677207163966379,3241,-0.0194998013747282,-345
"1927","3213421",0.614593153778148,4575,0.6484133307666,4477,-0.0338201769884522,98
"1928","4213421",0.573118823077608,6529,0.60600295564479,6699,-0.0328841325671819,-170
"1929","1313421",0.692951064823064,1874,0.706531081273905,2206,-0.0135800164508408,-332
"1930","2313421",0.629727892314875,3922,0.650156596633081,4416,-0.0204287043182064,-494
"1931","3313421",0.586613683501372,5844,0.621362763433302,5868,-0.0347490799319304,-24
"1932","4313421",0.545139352800831,7958,0.578952388311492,8263,-0.0338130355106602,-305
"1933","1413421",0.654014566838068,3033,0.665901577305799,3700,-0.011887010467731,-667
"1934","2413421",0.590791394329879,5640,0.609527092664976,6522,-0.0187356983350967,-882
"1935","3413421",0.547677185516376,7802,0.580733259465196,8147,-0.0330560739488207,-345
"1936","4413421",0.506202854815835,9941,0.538322884343386,10562,-0.0321200295275504,-621
"1937","1123421",0.706909041826416,1547,0.728316615895502,1580,-0.021407574069086,-33
"1938","2123421",0.643685869318227,3406,0.671942131254679,3442,-0.0282562619364516,-36
"1939","3123421",0.600571660504724,5202,0.643148298054899,4753,-0.0425766375501756,449
"1940","4123421",0.559097329804184,7223,0.600737922933089,7021,-0.0416405931289051,202
"1941","1223421",0.65295126423342,3077,0.673012336949796,3397,-0.0200610727163758,-320
"1942","2223421",0.589728091725231,5700,0.616637852308973,6134,-0.0269097605837414,-434
"1943","3223421",0.546613882911728,7866,0.587844019109193,7716,-0.0412301361974654,150
"1944","4223421",0.505139552211188,9999,0.545433643987383,10144,-0.0402940917761951,-145
"1945","1323421",0.624971793956644,4130,0.645961769616498,4612,-0.0209899756598541,-482
"1946","2323421",0.561748621448455,7073,0.589587284975675,7628,-0.0278386635272196,-555
"1947","3323421",0.518634412634952,9302,0.560793451775895,9278,-0.0421590391409437,24
"1948","4323421",0.477160081934411,11367,0.518383076654085,11593,-0.0412229947196734,-226
"1949","1423421",0.586035295971648,5886,0.605332265648392,6753,-0.0192969696767442,-867
"1950","2423421",0.522812123463459,9102,0.548957781007569,9953,-0.0261456575441099,-851
"1951","3423421",0.479697914649956,11232,0.52016394780779,11484,-0.040466033157834,-252
"1952","4423421",0.438223583949416,13008,0.477753572685979,13434,-0.0395299887365637,-426
"1953","1133421",0.663576519661317,2715,0.689851523447473,2748,-0.0262750037861567,-33
"1954","2133421",0.600353347153128,5212,0.63347703880665,5247,-0.0331236916535222,-35
"1955","3133421",0.557239138339624,7328,0.60468320560687,6793,-0.0474440672672463,535
"1956","4133421",0.515764807639084,9478,0.56227283048506,9206,-0.046508022845976,272
"1957","1233421",0.60961874206832,4815,0.634547244501767,5205,-0.0249285024334467,-390
"1958","2233421",0.546395569560131,7879,0.578172759860944,8311,-0.0317771903008123,-432
"1959","3233421",0.503281360746628,10102,0.549378926661164,9926,-0.0460975659145363,176
"1960","4233421",0.461807030046088,12054,0.506968551539354,12164,-0.0451615214932659,-110
"1961","1333421",0.581639271791544,6108,0.607496677168469,6631,-0.0258574053769249,-523
"1962","2333421",0.518416099283355,9315,0.551122192527646,9839,-0.0327060932442905,-524
"1963","3333421",0.475301890469852,11452,0.522328359327866,11380,-0.0470264688580146,72
"1964","4333421",0.433827559769312,13190,0.479917984206056,13341,-0.046090424436744,-151
"1965","1433421",0.542702773806548,8082,0.566867173200363,8949,-0.0241643993938151,-867
"1966","2433421",0.479479601298359,11240,0.51049268855954,12011,-0.0310130872611808,-771
"1967","3433421",0.436365392484856,13081,0.481698855359761,13266,-0.0453334628749048,-185
"1968","4433421",0.394891061784316,14451,0.43928848023795,14728,-0.0443974184536343,-277
"1969","1143421",0.614542955206487,4580,0.649453029320389,4437,-0.0349100741139022,143
"1970","2143421",0.551319782698298,7637,0.593078544679566,7449,-0.0417587619812678,188
"1971","3143421",0.508205573884795,9847,0.564284711479786,9086,-0.0560791375949918,761
"1972","4143421",0.466731243184255,11827,0.521874336357976,11405,-0.0551430931737214,422
"1973","1243421",0.560585177613491,7142,0.594148750374683,7397,-0.033563572761192,-255
"1974","2243421",0.497362005105302,10398,0.53777426573386,10593,-0.0404122606285577,-195
"1975","3243421",0.454247796291799,12377,0.50898043253408,12064,-0.0547326362422817,313
"1976","4243421",0.412773465591258,13914,0.46657005741227,13865,-0.0537965918210114,49
"1977","1343421",0.532605707336715,8591,0.567098183041385,8935,-0.0344924757046703,-344
"1978","2343421",0.469382534828526,11723,0.510723698400562,11998,-0.0413411635720359,-275
"1979","3343421",0.426268326015022,13463,0.481929865200782,13255,-0.0556615391857599,208
"1980","4343421",0.384793995314482,14710,0.439519490078972,14723,-0.0547254947644896,-13
"1981","1443421",0.493669209351719,10563,0.526468679073279,11173,-0.0327994697215605,-610
"1982","2443421",0.43044603684353,13324,0.470094194432456,13762,-0.0396481575889261,-438
"1983","3443421",0.387331828030026,14649,0.441300361232677,14678,-0.0539685332026501,-29
"1984","4443421",0.345857497329486,15494,0.398889986110866,15601,-0.0530324887813798,-107
"1985","1114421",0.722681240722266,1217,0.744235314179253,1225,-0.0215540734569868,-8
"1986","2114421",0.659458068214077,2833,0.68786082953843,2815,-0.0284027613243524,18
"1987","3114421",0.616343859400574,4490,0.65906699633865,4007,-0.0427231369380764,483
"1988","4114421",0.574869528700034,6445,0.61665662121684,6132,-0.0417870925168059,313
"1989","1214421",0.66872346312927,2547,0.688931035233547,2775,-0.0202075721042766,-228
"1990","2214421",0.605500290621081,4986,0.632556550592724,5288,-0.0270562599716422,-302
"1991","3214421",0.562386081807578,7046,0.603762717392944,6837,-0.0413766355853662,209
"1992","4214421",0.520911751107038,9198,0.561352342271134,9248,-0.0404405911640959,-50
"1993","1314421",0.640743992852494,3531,0.661880467900249,3891,-0.0211364750477548,-360
"1994","2314421",0.577520820344305,6314,0.605505983259426,6735,-0.0279851629151204,-421
"1995","3314421",0.534406611530802,8496,0.576712150059646,8387,-0.0423055385288444,109
"1996","4314421",0.492932280830262,10602,0.534301774937836,10775,-0.0413694941075741,-173
"1997","1414421",0.601807494867498,5140,0.621250963932143,5874,-0.019443469064645,-734
"1998","2414421",0.538584322359309,8296,0.56487647929132,9047,-0.0262921569320107,-751
"1999","3414421",0.495470113545806,10469,0.53608264609154,10679,-0.0406125325457348,-210
"2000","4414421",0.453995782845266,12389,0.49367227096973,12769,-0.0396764881244644,-380
"2001","1124421",0.654701969855846,2997,0.683666002521846,2979,-0.028964032666,18
"2002","2124421",0.591478797347657,5609,0.627291517881023,5545,-0.0358127205333656,64
"2003","3124421",0.548364588534154,7774,0.598497684681244,7142,-0.0501330961470896,632
"2004","4124421",0.506890257833614,9911,0.556087309559433,9568,-0.0491970517258191,343
"2005","1224421",0.60074419226285,5191,0.62836172357614,5483,-0.0276175313132898,-292
"2006","2224421",0.537521019754661,8348,0.571987238935317,8660,-0.0344662191806554,-312
"2007","3224421",0.494406810941158,10524,0.543193405735537,10277,-0.0487865947943795,247
"2008","4224421",0.452932480240618,12431,0.500783030613727,12454,-0.0478505503731091,-23
"2009","1324421",0.572764721986074,6542,0.601311156242842,6978,-0.0285464342567681,-436
"2010","2324421",0.509541549477885,9774,0.544936671602019,10174,-0.0353951221241336,-400
"2011","3324421",0.466427340664382,11839,0.516142838402239,11709,-0.0497154977378577,130
"2012","4324421",0.424953009963842,13515,0.473732463280429,13612,-0.0487794533165873,-97
"2013","1424421",0.533828224001078,8518,0.560681652274736,9286,-0.0268534282736582,-768
"2014","2424421",0.470605051492889,11664,0.504307167633913,12281,-0.033702116141024,-617
"2015","3424421",0.427490842679386,13414,0.475513334434134,13527,-0.0480224917547479,-113
"2016","4424421",0.386016511978846,14678,0.433102959312323,14889,-0.0470864473334775,-211
"2017","1134421",0.611369447690747,4737,0.645200910073817,4645,-0.0338314623830707,92
"2018","2134421",0.548146275182558,7784,0.588826425432994,7668,-0.0406801502504363,116
"2019","3134421",0.505032066369054,10007,0.560032592233215,9333,-0.0550005258641603,674
"2020","4134421",0.463557735668514,11972,0.517622217111404,11635,-0.0540644814428899,337
"2021","1234421",0.55741167009775,7312,0.589896631128111,7609,-0.0324849610303607,-297
"2022","2234421",0.494188497589562,10537,0.533522146487288,10820,-0.0393336488977262,-283
"2023","3234421",0.451074288776058,12504,0.504728313287508,12260,-0.0536540245114502,244
"2024","4234421",0.409599958075518,14012,0.462317938165698,14007,-0.0527179800901798,5
"2025","1334421",0.529432199820974,8763,0.562846063794813,9175,-0.0334138639738389,-412
"2026","2334421",0.466209027312786,11851,0.50647157915399,12186,-0.0402625518412045,-335
"2027","3334421",0.423094818499282,13580,0.47767774595421,13438,-0.0545829274549284,142
"2028","4334421",0.381620487798742,14790,0.4352673708324,14838,-0.053646883033658,-48
"2029","1434421",0.490495701835978,10708,0.522216559826707,11391,-0.031720857990729,-683
"2030","2434421",0.42727252932779,13422,0.465842075185884,13896,-0.0385695458580947,-474
"2031","3434421",0.384158320514286,14726,0.437048241986105,14784,-0.0528899214718186,-58
"2032","4434421",0.342683989813746,15549,0.394637866864294,15663,-0.0519538770505483,-114
"2033","1144421",0.562335883235917,7051,0.604802415946733,6786,-0.0424665327108162,265
"2034","2144421",0.499112710727728,10314,0.54842793130591,9986,-0.0493152205781818,328
"2035","3144421",0.455998501914225,12309,0.519634098106131,11518,-0.0636355961919058,791
"2036","4144421",0.414524171213685,13864,0.47722372298432,13463,-0.0626995517706354,401
"2037","1244421",0.508378105642921,9833,0.549498137001027,9920,-0.041120031358106,-87
"2038","2244421",0.445154933134732,12753,0.493123652360204,12797,-0.0479687192254717,-44
"2039","3244421",0.402040724321229,14250,0.464329819160424,13936,-0.0622890948391956,314
"2040","4244421",0.360566393620689,15250,0.421919444038614,15149,-0.0613530504179252,101
"2041","1344421",0.480398635366145,11202,0.522447569667729,11376,-0.0420489343015844,-174
"2042","2344421",0.417175462857956,13782,0.466073085026906,13885,-0.0488976221689499,-103
"2043","3344421",0.374061254044453,14963,0.437279251827126,14776,-0.0632179977826738,187
"2044","4344421",0.332586923343913,15695,0.394868876705316,15661,-0.0622819533614035,34
"2045","1444421",0.441462137381149,12883,0.481818065699623,13260,-0.0403559283184745,-377
"2046","2444421",0.37823896487296,14879,0.4254435810588,15075,-0.0472046161858401,-196
"2047","3444421",0.335124756059457,15665,0.396649747859021,15634,-0.0615249917995642,31
"2048","4444421",0.293650425358917,16080,0.35423937273721,16097,-0.0605889473782938,-17
"2049","1111131",0.915901404394409,15,0.929620025796629,12,-0.0137186214022199,3
"2050","2111131",0.85267823188622,91,0.873245541155805,69,-0.0205673092695855,22
"2051","3111131",0.809564023072716,252,0.844451707956026,149,-0.0348876848833095,103
"2052","4111131",0.768089692372177,570,0.802041332834216,405,-0.0339516404620391,165
"2053","1211131",0.861943626801413,72,0.874315746850923,67,-0.0123721200495098,5
"2054","2211131",0.798720454293224,323,0.817941262210099,284,-0.0192208079168754,39
"2055","3211131",0.75560624547972,716,0.78914742901032,529,-0.0335411835305994,187
"2056","4211131",0.71413191477918,1382,0.746737053888509,1175,-0.032605139109329,207
"2057","1311131",0.833964156524637,145,0.847265179517625,135,-0.0133010229929881,10
"2058","2311131",0.770740984016448,544,0.790890694876801,503,-0.0201497108603537,41
"2059","3311131",0.727626775202944,1125,0.762096861677022,907,-0.0344700864740777,218
"2060","4311131",0.686152444502404,2053,0.719686486555212,1811,-0.0335340420528073,242
"2061","1411131",0.79502765853964,342,0.806635675549519,365,-0.0116080170098782,-23
"2062","2411131",0.731804486031452,1066,0.750261190908696,1099,-0.0184567048772439,-33
"2063","3411131",0.688690277217948,1980,0.721467357708916,1771,-0.032777080490968,209
"2064","4411131",0.647215946517408,3297,0.679056982587106,3170,-0.0318410360696976,127
"2065","1121131",0.847922133527989,99,0.869050714139222,77,-0.0211285806112331,22
"2066","2121131",0.7846989610198,409,0.812676229498399,318,-0.0279772684785987,91
"2067","3121131",0.741584752206296,899,0.783882396298619,589,-0.0422976440923227,310
"2068","4121131",0.700110421505757,1689,0.741472021176809,1280,-0.0413615996710524,409
"2069","1221131",0.793964355934993,347,0.813746435193516,308,-0.019782079258523,39
"2070","2221131",0.730741183426804,1081,0.757371950552692,975,-0.0266307671258886,106
"2071","3221131",0.6876269746133,2005,0.728578117352913,1571,-0.0409511427396126,434
"2072","4221131",0.64615264391276,3326,0.686167742231103,2885,-0.0400150983183423,441
"2073","1321131",0.765984885658217,594,0.786695867860218,558,-0.0207109822020013,36
"2074","2321131",0.702761713150028,1635,0.730321383219395,1520,-0.0275596700693669,115
"2075","3321131",0.659647504336524,2824,0.701527550019615,2366,-0.0418800456830909,458
"2076","4321131",0.618173173635984,4422,0.659117174897805,4003,-0.0409440012618205,419
"2077","1421131",0.72704838767322,1137,0.746066363892112,1185,-0.0190179762188915,-48
"2078","2421131",0.663825215165032,2705,0.689691879251289,2755,-0.0258666640862572,-50
"2079","3421131",0.620711006351528,4299,0.660898046051509,3938,-0.0401870396999812,361
"2080","4421131",0.579236675650988,6245,0.618487670929699,6019,-0.0392509952787108,226
"2081","1131131",0.804589611362889,281,0.830585621691193,215,-0.0259960103283039,66
"2082","2131131",0.7413664388547,904,0.77421113705037,712,-0.0328446981956695,192
"2083","3131131",0.698252230041197,1737,0.74541730385059,1199,-0.0471650738093935,538
"2084","4131131",0.656777899340657,2929,0.70300692872878,2315,-0.0462290293881231,614
"2085","1231131",0.750631833769893,778,0.775281342745487,693,-0.0246495089755938,85
"2086","2231131",0.687408661261704,2015,0.718906858104664,1832,-0.0314981968429594,183
"2087","3231131",0.644294452448201,3391,0.690113024904884,2737,-0.0458185724566834,654
"2088","4231131",0.602820121747661,5095,0.647702649783074,4519,-0.044882528035413,576
"2089","1331131",0.722652363493117,1219,0.748230775412189,1142,-0.0255784119190721,77
"2090","2331131",0.659429190984928,2834,0.691856290771366,2677,-0.0324270997864377,157
"2091","3331131",0.616314982171425,4492,0.663062457571586,3838,-0.0467474754001617,654
"2092","4331131",0.574840651470885,6447,0.620652082449776,5904,-0.0458114309788913,543
"2093","1431131",0.683715865508121,2108,0.707601271444083,2162,-0.0238854059359622,-54
"2094","2431131",0.620492692999932,4315,0.65122678680326,4359,-0.0307340938033279,-44
"2095","3431131",0.577378484186429,6321,0.62243295360348,5811,-0.0450544694170519,510
"2096","4431131",0.535904153485889,8427,0.58002257848167,8194,-0.0441184249957816,233
"2097","1141131",0.75555604690806,717,0.790187127564109,514,-0.0346310806560494,203
"2098","2141131",0.692332874399871,1899,0.733812642923286,1439,-0.041479768523415,460
"2099","3141131",0.649218665586367,3226,0.705018809723506,2248,-0.055800144137139,978
"2100","4141131",0.607744334885827,4902,0.662608434601696,3853,-0.0548640997158686,1049
"2101","1241131",0.701598269315064,1664,0.734882848618403,1423,-0.0332845793033393,241
"2102","2241131",0.638375096806875,3624,0.67850836397758,3187,-0.0401332671707049,437
"2103","3241131",0.595260887993371,5464,0.6497145307778,4429,-0.0544536427844289,1035
"2104","4241131",0.553786557292831,7508,0.60730415565599,6635,-0.0535175983631585,873
"2105","1341131",0.673618799038287,2398,0.707832281285105,2150,-0.0342134822468175,248
"2106","2341131",0.610395626530098,4780,0.651457796644282,4342,-0.0410621701141831,438
"2107","3341131",0.567281417716595,6832,0.622663963444502,5799,-0.0553825457279071,1033
"2108","4341131",0.525807087016055,8964,0.580253588322692,8173,-0.0544465013066368,791
"2109","1441131",0.634682301053291,3752,0.667202777316999,3641,-0.0325204762637077,111
"2110","2441131",0.571459128545103,6617,0.610828292676176,6445,-0.0393691641310734,172
"2111","3441131",0.528344919731599,8822,0.582034459476396,8082,-0.0536895397447974,740
"2112","4441131",0.486870589031059,10914,0.539624084354586,10491,-0.052753495323527,423
"2113","1112131",0.88281649263272,40,0.891301044267977,40,-0.00848455163525674,0
"2114","2112131",0.819593320124531,199,0.834926559627153,190,-0.0153332395026223,9
"2115","3112131",0.776479111311028,484,0.806132726427374,369,-0.0296536151163463,115
"2116","4112131",0.735004780610488,1009,0.763722351305564,878,-0.028717570695076,131
"2117","1212131",0.828858715039724,164,0.83599676532227,183,-0.00713805028254666,-19
"2118","2212131",0.765635542531535,602,0.779622280681447,642,-0.0139867381499122,-40
"2119","3212131",0.722521333718031,1223,0.750828447481668,1086,-0.0283071137636363,137
"2120","4212131",0.681047003017491,2196,0.708418072359857,2132,-0.0273710693423659,64
"2121","1312131",0.800879244762948,304,0.808946197988972,348,-0.00806695322602491,-44
"2122","2312131",0.737656072254759,964,0.752571713348149,1049,-0.0149156410933905,-85
"2123","3312131",0.694541863441255,1827,0.72377788014837,1706,-0.0292360167071145,121
"2124","4312131",0.653067532740715,3072,0.681367505026559,3079,-0.0282999722858441,-7
"2125","1412131",0.761942746777952,645,0.768316694020867,795,-0.00637394724291507,-150
"2126","2412131",0.698719574269763,1725,0.711942209380043,2014,-0.0132226351102808,-289
"2127","3412131",0.655605365456259,2967,0.683148376180264,3006,-0.0275430107240048,-39
"2128","4412131",0.614131034755719,4608,0.640738001058454,4883,-0.0266069663027344,-275
"2129","1122131",0.8148372217663,223,0.83073173261057,214,-0.01589451084427,9
"2130","2122131",0.751614049258111,763,0.774357247969747,710,-0.0227431987116355,53
"2131","3122131",0.708499840444608,1509,0.745563414769967,1196,-0.0370635743253596,313
"2132","4122131",0.667025509744068,2597,0.703153039648157,2312,-0.0361275299040892,285
"2133","1222131",0.760879444173304,657,0.775427453664864,689,-0.0145480094915599,-32
"2134","2222131",0.697656271665115,1752,0.71905296902404,1827,-0.0213966973589255,-75
"2135","3222131",0.654542062851611,3009,0.690259135824261,2735,-0.0357170729726495,274
"2136","4222131",0.613067732151071,4657,0.647848760702451,4511,-0.0347810285513791,146
"2137","1322131",0.732899973896528,1043,0.748376886331566,1138,-0.0154769124350381,-95
"2138","2322131",0.669676801388339,2515,0.692002401690742,2669,-0.0223256003024037,-154
"2139","3322131",0.626562592574835,4053,0.663208568490963,3830,-0.0366459759161277,223
"2140","4322131",0.585088261874295,5948,0.620798193369153,5897,-0.0357099314948573,51
"2141","1422131",0.693963475911532,1845,0.70774738236346,2157,-0.0137839064519283,-312
"2142","2422131",0.630740303403343,3884,0.651372897722637,4351,-0.020632594319294,-467
"2143","3422131",0.587626094589839,5797,0.622579064522857,5806,-0.034952969933018,-9
"2144","4422131",0.546151763889299,7895,0.580168689401047,8181,-0.0340169255117476,-286
"2145","1132131",0.7715046996012,534,0.792266640162541,490,-0.0207619405613407,44
"2146","2132131",0.708281527093011,1513,0.735892155521718,1403,-0.0276106284287063,110
"2147","3132131",0.665167318279508,2654,0.707098322321938,2179,-0.0419310040424303,475
"2148","4132131",0.623692987578968,4195,0.664687947200128,3763,-0.04099495962116,432
"2149","1232131",0.717546922008204,1316,0.736962361216835,1375,-0.0194154392086306,-59
"2150","2232131",0.654323749500015,3019,0.680587876576011,3111,-0.0262641270759962,-92
"2151","3232131",0.611209540686512,4747,0.651794043376232,4328,-0.0405845026897202,419
"2152","4232131",0.569735209985972,6706,0.609383668254422,6529,-0.0396484582684499,177
"2153","1332131",0.689567451731428,1954,0.709911793883537,2086,-0.0203443421521089,-132
"2154","2332131",0.626344279223239,4060,0.653537309242714,4256,-0.0271930300194745,-196
"2155","3332131",0.583230070409736,6038,0.624743476042934,5679,-0.0415134056331985,359
"2156","4332131",0.541755739709196,8136,0.582333100921124,8062,-0.0405773612119281,74
"2157","1432131",0.650630953746432,3162,0.669282289915431,3551,-0.0186513361689991,-389
"2158","2432131",0.587407781238243,5806,0.612907805274608,6338,-0.0255000240363648,-532
"2159","3432131",0.54429357242474,8001,0.584113972074828,7942,-0.0398203996500888,59
"2160","4432131",0.5028192417242,10125,0.541703596953018,10375,-0.0388843552288184,-250
"2161","1142131",0.722471135146371,1225,0.751868146035457,1066,-0.0293970108890862,159
"2162","2142131",0.659247962638182,2841,0.695493661394634,2557,-0.0362456987564518,284
"2163","3142131",0.616133753824678,4495,0.666699828194854,3658,-0.0505660743701758,837
"2164","4142131",0.574659423124138,6450,0.624289453073044,5707,-0.0496300299489054,743
"2165","1242131",0.668513357553375,2558,0.696563867089751,2523,-0.0280505095363761,35
"2166","2242131",0.605290185045186,4996,0.640189382448927,4904,-0.0348991974037417,92
"2167","3242131",0.562175976231682,7057,0.611395549249148,6423,-0.0492195730174657,634
"2168","4242131",0.520701645531142,9203,0.568985174127338,8834,-0.0482835285961953,369
"2169","1342131",0.640533887276598,3544,0.669513299756453,3538,-0.0289794124798544,6
"2170","2342131",0.57731071476841,6323,0.61313881511563,6317,-0.03582810034722,6
"2171","3342131",0.534196505954906,8501,0.58434498191585,7927,-0.050148475960944,574
"2172","4342131",0.492722175254366,10608,0.54193460679404,10359,-0.0492124315396736,249
"2173","1442131",0.601597389291602,5154,0.628883795788347,5460,-0.0272864064967445,-306
"2174","2442131",0.538374216783414,8310,0.572509311147524,8620,-0.0341350943641102,-310
"2175","3442131",0.49526000796991,10481,0.543715477947744,10254,-0.0484554699778342,227
"2176","4442131",0.45378567726937,12397,0.501305102825934,12430,-0.0475194255565639,-33
"2177","1113131",0.843933317060234,115,0.865804453878738,83,-0.0218711368185034,32
"2178","2113131",0.780710144552045,444,0.809429969237914,343,-0.028719824685869,101
"2179","3113131",0.737595935738542,969,0.780636136038135,634,-0.043040200299593,335
"2180","4113131",0.696121605038002,1791,0.738225760916325,1347,-0.0421041558783225,444
"2181","1213131",0.789975539467238,375,0.810500174933031,333,-0.0205246354657932,42
"2182","2213131",0.726752366959049,1144,0.754125690292208,1023,-0.0273733233331588,121
"2183","3213131",0.683638158145546,2114,0.725331857092429,1664,-0.0416936989468828,450
"2184","4213131",0.642163827445006,3476,0.682921481970618,3011,-0.0407576545256125,465
"2185","1313131",0.761996069190462,641,0.783449607599733,593,-0.0214535384092714,48
"2186","2313131",0.698772896682273,1720,0.72707512295891,1610,-0.028302226276637,110
"2187","3313131",0.65565868786877,2961,0.698281289759131,2469,-0.042622601890361,492
"2188","4313131",0.61418435716823,4603,0.65587091463732,4151,-0.0416865574690908,452
"2189","1413131",0.723059571205466,1210,0.742820103631628,1250,-0.0197605324261616,-40
"2190","2413131",0.659836398697277,2814,0.686445618990804,2873,-0.0266092202935273,-59
"2191","3413131",0.616722189883774,4472,0.657651785791025,4072,-0.0409295959072513,400
"2192","4413131",0.575247859183234,6420,0.615241410669215,6199,-0.039993551485981,221
"2193","1123131",0.775954046193814,489,0.805235142221331,380,-0.0292810960275166,109
"2194","2123131",0.712730873685625,1410,0.748860657580508,1129,-0.0361297838948822,281
"2195","3123131",0.669616664872122,2522,0.720066824380728,1807,-0.0504501595086062,715
"2196","4123131",0.628142334171582,3994,0.677656449258918,3222,-0.0495141150873357,772
"2197","1223131",0.721996268600818,1229,0.749930863275625,1102,-0.0279345946748064,127
"2198","2223131",0.658773096092629,2854,0.693556378634801,2621,-0.034783282542172,233
"2199","3223131",0.615658887279126,4513,0.664762545435022,3761,-0.049103658155896,752
"2200","4223131",0.574184556578586,6468,0.622352170313212,5814,-0.0481676137346257,654
"2201","1323131",0.694016798324042,1842,0.722880295942327,1729,-0.0288634976182847,113
"2202","2323131",0.630793625815853,3879,0.666505811301503,3667,-0.0357121854856502,212
"2203","3323131",0.58767941700235,5791,0.637711978101724,5052,-0.0500325610993743,739
"2204","4323131",0.54620508630181,7890,0.595301602979914,7329,-0.049096516678104,561
"2205","1423131",0.655080300339046,2985,0.682250791974221,3036,-0.0271704916351748,-51
"2206","2423131",0.591857127830857,5588,0.625876307333398,5619,-0.0340191795025405,-31
"2207","3423131",0.548742919017354,7753,0.597082474133618,7232,-0.0483395551162645,521
"2208","4423131",0.507268588316814,9887,0.554672099011808,9639,-0.0474035106949943,248
"2209","1133131",0.732621524028715,1047,0.766770049773302,827,-0.0341485257445873,220
"2210","2133131",0.669398351520526,2528,0.710395565132479,2072,-0.0409972136119529,456
"2211","3133131",0.626284142707022,4064,0.681601731932699,3071,-0.0553175892256769,993
"2212","4133131",0.584809812006482,5958,0.639191356810889,4970,-0.0543815448044066,988
"2213","1233131",0.678663746435718,2264,0.711465770827596,2031,-0.0328020243918773,233
"2214","2233131",0.61544057392753,4529,0.655091286186772,4186,-0.0396507122592429,343
"2215","3233131",0.572326365114026,6570,0.626297452986993,5603,-0.0539710878729669,967
"2216","4233131",0.530852034413486,8688,0.583887077865183,7954,-0.0530350434516964,734
"2217","1333131",0.650684276158942,3160,0.684415203494298,2950,-0.0337309273353555,210
"2218","2333131",0.587461103650753,5804,0.628040718853475,5500,-0.0405796152027211,304
"2219","3333131",0.54434689483725,7997,0.599246885653695,7100,-0.0548999908164451,897
"2220","4333131",0.50287256413671,10122,0.556836510531885,9520,-0.0539639463951747,602
"2221","1433131",0.611747778173946,4708,0.643785699526192,4713,-0.0320379213522457,-5
"2222","2433131",0.548524605665757,7760,0.587411214885369,7747,-0.0388866092196114,13
"2223","3433131",0.505410396852254,9979,0.558617381685589,9416,-0.0532069848333354,563
"2224","4433131",0.463936066151714,11958,0.516207006563779,11705,-0.0522709404120649,253
"2225","1143131",0.683587959573885,2117,0.726371555646218,1629,-0.0427835960723328,488
"2226","2143131",0.620364787065696,4325,0.669997071005395,3509,-0.0496322839396984,816
"2227","3143131",0.577250578252193,6327,0.641203237805615,4863,-0.0639526595534224,1464
"2228","4143131",0.535776247551653,8430,0.598792862683805,7124,-0.063016615132152,1306
"2229","1243131",0.629630181980889,3926,0.671067276700512,3469,-0.0414370947196226,457
"2230","2243131",0.5664070094727,6865,0.614692792059688,6225,-0.0482857825869882,640
"2231","3243131",0.523292800659197,9073,0.585898958859909,7841,-0.0626061582007122,1232
"2232","4243131",0.481818469958657,11142,0.543488583738099,10263,-0.061670113779442,879
"2233","1343131",0.601650711704113,5152,0.644016709367214,4695,-0.0423659976631009,457
"2234","2343131",0.538427539195924,8307,0.58764222472639,7729,-0.0492146855304665,578
"2235","3343131",0.495313330382421,10476,0.558848391526611,9404,-0.0635350611441905,1072
"2236","4343131",0.45383899968188,12395,0.516438016404801,11693,-0.0625990167229202,702
"2237","1443131",0.562714213719117,7025,0.603387205399108,6855,-0.0406729916799911,170
"2238","2443131",0.499491041210928,10291,0.547012720758285,10055,-0.0475216795473568,236
"2239","3443131",0.456376832397425,12283,0.518218887558505,11604,-0.0618420551610808,679
"2240","4443131",0.414902501696885,13850,0.475808512436695,13517,-0.0609060107398104,333
"2241","1114131",0.791726245089664,365,0.821153840505082,263,-0.0294275954154173,102
"2242","2114131",0.728503072581476,1113,0.764779355864258,858,-0.0362762832827829,255
"2243","3114131",0.685388863767972,2074,0.735985522664479,1400,-0.0505966588965069,674
"2244","4114131",0.643914533067432,3399,0.693575147542669,2620,-0.0496606144752365,779
"2245","1214131",0.737768467496668,961,0.765849561559376,846,-0.0280810940627072,115
"2246","2214131",0.67454529498848,2383,0.709475076918552,2100,-0.0349297819300728,283
"2247","3214131",0.631431086174976,3865,0.680681243718773,3103,-0.0492501575437968,762
"2248","4214131",0.589956755474436,5691,0.638270868596962,5027,-0.0483141131225264,664
"2249","1314131",0.709788997219892,1476,0.738798994226078,1336,-0.0290099970061855,140
"2250","2314131",0.646565824711703,3314,0.682424509585254,3025,-0.035858684873551,289
"2251","3314131",0.6034516158982,5068,0.653630676385475,4249,-0.050179060487275,819
"2252","4314131",0.56197728519766,7065,0.611220301263665,6427,-0.0492430160660047,638
"2253","1414131",0.670852499234896,2477,0.698169490257972,2475,-0.0273169910230756,2
"2254","2414131",0.607629326726707,4908,0.641795005617149,4827,-0.0341656788904413,81
"2255","3414131",0.564515117913204,6953,0.613001172417369,6332,-0.0484860545041653,621
"2256","4414131",0.523040787212664,9091,0.570590797295559,8747,-0.0475500100828949,344
"2257","1124131",0.723746974223245,1196,0.760584528847675,927,-0.0368375546244305,269
"2258","2124131",0.660523801715056,2799,0.704210044206852,2270,-0.0436862424917961,529
"2259","3124131",0.617409592901552,4448,0.675416211007072,3307,-0.0580066181055201,1141
"2260","4124131",0.575935262201012,6386,0.633005835885262,5265,-0.0570705736842497,1121
"2261","1224131",0.669789196630248,2510,0.705280249901969,2242,-0.0354910532717204,268
"2262","2224131",0.60656602412206,4950,0.648905765261146,4459,-0.042339741139086,491
"2263","3224131",0.563451815308556,6990,0.620111932061366,5934,-0.05666011675281,1056
"2264","4224131",0.521977484608016,9147,0.577701556939556,8339,-0.0557240723315396,808
"2265","1324131",0.641809726353472,3490,0.678229682568671,3197,-0.0364199562151987,293
"2266","2324131",0.578586553845283,6270,0.621855197927848,5836,-0.0432686440825643,434
"2267","3324131",0.53547234503178,8442,0.593061364728068,7450,-0.0575890196962883,992
"2268","4324131",0.49399801433124,10544,0.550650989606258,9862,-0.0566529752750179,682
"2269","1424131",0.602873228368476,5094,0.637600178600565,5057,-0.0347269502320888,37
"2270","2424131",0.539650055860287,8247,0.581225693959742,8122,-0.0415756380994545,125
"2271","3424131",0.496535847046784,10426,0.552431860759962,9776,-0.0558960137131785,650
"2272","4424131",0.455061516346244,12335,0.510021485638152,12026,-0.0549599692919082,309
"2273","1134131",0.680414452058145,2215,0.722119436399646,1748,-0.0417049843415013,467
"2274","2134131",0.617191279549956,4457,0.665744951758823,3707,-0.0485536722088669,750
"2275","3134131",0.574077070736453,6475,0.636951118559043,5077,-0.0628740478225909,1398
"2276","4134131",0.532602740035913,8592,0.594540743437233,7367,-0.0619380034013205,1225
"2277","1234131",0.626456674465149,4058,0.66681515745394,3656,-0.0403584829887912,402
"2278","2234131",0.56323350195696,7004,0.610440672813117,6460,-0.0472071708561568,544
"2279","3234131",0.520119293143456,9230,0.581646839613337,8095,-0.0615275464698808,1135
"2280","4234131",0.478644962442916,11289,0.539236464491527,10511,-0.0605915020486104,778
"2281","1334131",0.598477204188373,5301,0.639764590120642,4933,-0.0412873859322694,368
"2282","2334131",0.535254031680184,8452,0.583390105479819,7988,-0.048136073799635,464
"2283","3334131",0.49213982286668,10638,0.554596272280039,9646,-0.062456449413359,992
"2284","4334131",0.45066549216614,12518,0.512185897158229,11923,-0.0615204049920887,595
"2285","1434131",0.559540706203377,7192,0.599135086152536,7109,-0.0395943799491596,83
"2286","2434131",0.496317533695188,10443,0.542760601511713,10302,-0.0464430678165253,141
"2287","3434131",0.453203324881684,12420,0.513966768311934,11833,-0.0607634434302493,587
"2288","4434131",0.411728994181144,13948,0.471556393190123,13703,-0.0598273990089789,245
"2289","1144131",0.631380887603315,3866,0.681720942272562,3066,-0.0503400546692467,800
"2290","2144131",0.568157715095126,6794,0.625346457631739,5650,-0.0571887425366123,1144
"2291","3144131",0.525043506281623,8998,0.596552624431959,7263,-0.0715091181503363,1735
"2292","4144131",0.483569175581083,11072,0.554142249310149,9673,-0.070573073729066,1399
"2293","1244131",0.577423110010319,6318,0.626416663326856,5594,-0.0489935533165367,724
"2294","2244131",0.51419993750213,9554,0.570042178686033,8773,-0.0558422411839022,781
"2295","3244131",0.471085728688627,11647,0.541248345486253,10407,-0.0701626167976263,1240
"2296","4244131",0.429611397988087,13355,0.498837970364443,12555,-0.0692265723763559,800
"2297","1344131",0.549443639733543,7726,0.599366095993558,7089,-0.0499224562600149,637
"2298","2344131",0.486220467225354,10945,0.542991611352735,10285,-0.0567711441273805,660
"2299","3344131",0.443106258411851,12824,0.514197778152955,11819,-0.0710915197411045,1005
"2300","4344131",0.401631927711311,14261,0.471787403031145,13694,-0.0701554753198341,567
"2301","1444131",0.510507141748547,9740,0.558736592025452,9412,-0.0482294502769051,328
"2302","2444131",0.447283969240358,12669,0.502362107384629,12376,-0.0550781381442708,293
"2303","3444131",0.404169760426855,14184,0.47356827418485,13621,-0.0693985137579948,563
"2304","4444131",0.362695429726315,15214,0.431157899063039,14956,-0.0684624693367244,258
"2305","1111231",0.870052570246199,59,0.884285179141847,50,-0.0142326088956481,9
"2306","2111231",0.80682939773801,265,0.827910694501024,227,-0.0210812967630137,38
"2307","3111231",0.763715188924506,623,0.799116861301244,428,-0.0354016723767377,195
"2308","4111231",0.722240858223966,1228,0.756706486179434,982,-0.0344656279554674,246
"2309","1211231",0.816094792653203,215,0.828980900196141,223,-0.0128861075429381,-8
"2310","2211231",0.752871620145014,747,0.772606415555317,732,-0.0197347954103037,15
"2311","3211231",0.70975741133151,1479,0.743812582355538,1238,-0.0340551710240277,241
"2312","4211231",0.66828308063097,2565,0.701402207233727,2370,-0.0331191266027573,195
"2313","1311231",0.788115322376426,389,0.801930332862843,407,-0.0138150104864163,-18
"2314","2311231",0.724892149868237,1180,0.745555848222019,1198,-0.0206636983537819,-18
"2315","3311231",0.681777941054734,2174,0.71676201502224,1893,-0.0349840739675059,281
"2316","4311231",0.640303610354194,3554,0.67435163990043,3336,-0.0340480295462355,218
"2317","1411231",0.74917882439143,797,0.761300828894737,916,-0.0121220045033065,-119
"2318","2411231",0.685955651883241,2057,0.704926344253914,2252,-0.0189706923706722,-195
"2319","3411231",0.642841443069738,3450,0.676132511054134,3285,-0.0332910679843962,165
"2320","4411231",0.601367112369198,5170,0.633722135932324,5235,-0.0323550235631258,-65
"2321","1121231",0.802073299379779,297,0.82371586748444,250,-0.0216425681046614,47
"2322","2121231",0.73885012687159,938,0.767341382843617,815,-0.028491255972027,123
"2323","3121231",0.695735918058086,1803,0.738547549643837,1342,-0.042811631585751,461
"2324","4121231",0.654261587357546,3021,0.696137174522027,2532,-0.0418755871644806,489
"2325","1221231",0.748115521786783,812,0.768411588538734,792,-0.0202960667519513,20
"2326","2221231",0.684892349278594,2079,0.71203710389791,2009,-0.0271447546193169,70
"2327","3221231",0.64177814046509,3494,0.683243270698131,2999,-0.0414651302330409,495
"2328","4221231",0.60030380976455,5214,0.640832895576321,4878,-0.0405290858117705,336
"2329","1321231",0.720136051510006,1271,0.741361021205436,1283,-0.0212249696954295,-12
"2330","2321231",0.656912879001817,2922,0.684986536564613,2929,-0.0280736575627951,-7
"2331","3321231",0.613798670188314,4624,0.656192703364833,4138,-0.0423940331765191,486
"2332","4321231",0.572324339487774,6571,0.613782328243023,6283,-0.0414579887552488,288
"2333","1421231",0.68119955352501,2193,0.70073151723733,2382,-0.0195319637123197,-189
"2334","2421231",0.617976381016822,4425,0.644357032596507,4683,-0.0263806515796854,-258
"2335","3421231",0.574862172203318,6446,0.615563199396727,6187,-0.0407010271934094,259
"2336","4421231",0.533387841502778,8545,0.573152824274917,8590,-0.039764982772139,-45
"2337","1131231",0.758740777214679,681,0.785250775036411,578,-0.0265099978217321,103
"2338","2131231",0.69551760470649,1809,0.728876290395588,1567,-0.0333586856890977,242
"2339","3131231",0.652403395892987,3107,0.700082457195808,2403,-0.0476790613028217,704
"2340","4131231",0.610929065192447,4756,0.657672082073998,4070,-0.0467430168815514,686
"2341","1231231",0.704782999621683,1595,0.729946496090705,1533,-0.025163496469022,62
"2342","2231231",0.641559827113494,3506,0.673572011449882,3372,-0.0320121843363876,134
"2343","3231231",0.59844561829999,5303,0.644778178250102,4664,-0.0463325599501117,639
"2344","4231231",0.556971287599451,7345,0.602367803128292,6910,-0.0453965155288413,435
"2345","1331231",0.676803529344907,2319,0.702895928757407,2321,-0.0260923994125003,-2
"2346","2331231",0.613580356836718,4633,0.646521444116584,4584,-0.0329410872798659,49
"2347","3331231",0.570466148023214,6665,0.617727610916804,6063,-0.0472614628935899,602
"2348","4331231",0.528991817322674,8791,0.575317235794994,8470,-0.0463254184723195,321
"2349","1431231",0.637867031359911,3639,0.662266424789301,3869,-0.0243993934293905,-230
"2350","2431231",0.574643858851722,6451,0.605891940148478,6708,-0.0312480812967562,-257
"2351","3431231",0.531529650038218,8647,0.577098106948699,8366,-0.0455684569104802,281
"2352","4431231",0.490055319337678,10742,0.534687731826888,10753,-0.0446324124892098,-11
"2353","1141231",0.70970721275985,1481,0.744852280909327,1215,-0.0351450681494776,266
"2354","2141231",0.646484040251661,3320,0.688477796268504,2794,-0.0419937560168432,526
"2355","3141231",0.603369831438157,5075,0.659683963068724,3985,-0.0563141316305672,1090
"2356","4141231",0.561895500737617,7069,0.617273587946914,6090,-0.0553780872092968,979
"2357","1241231",0.655749435166853,2954,0.689548001963621,2757,-0.0337985667967675,197
"2358","2241231",0.592526262658664,5570,0.633173517322798,5260,-0.0406472546641331,310
"2359","3241231",0.549412053845161,7728,0.604379684123018,6813,-0.0549676302778571,915
"2360","4241231",0.507937723144621,9860,0.561969309001208,9217,-0.0540315858565867,643
"2361","1341231",0.627769964890077,4005,0.662497434630323,3857,-0.0347274697402458,148
"2362","2341231",0.564546792381888,6947,0.6061229499895,6694,-0.0415761576076114,253
"2363","3341231",0.521432583568385,9175,0.57732911678972,8359,-0.0558965332213354,816
"2364","4341231",0.479958252867845,11220,0.53491874166791,10741,-0.054960488800065,479
"2365","1441231",0.588833466905081,5738,0.621867930662217,5835,-0.0330344637571359,-97
"2366","2441231",0.525610294396892,8973,0.565493446021394,9016,-0.0398831516245016,-43
"2367","3441231",0.482496085583389,11119,0.536699612821614,10652,-0.0542035272382256,467
"2368","4441231",0.441021754882849,12904,0.494289237699804,12747,-0.0532674828169553,157
"2369","1112231",0.83696765848451,135,0.845966197613195,141,-0.00899853912868498,-6
"2370","2112231",0.773744485976321,511,0.789591712972371,523,-0.0158472269960506,-12
"2371","3112231",0.730630277162817,1085,0.760797879772592,924,-0.0301676026097746,161
"2372","4112231",0.689155946462277,1963,0.718387504650782,1848,-0.0292315581885042,115
"2373","1212231",0.783009880891514,424,0.790661918667488,508,-0.0076520377759749,-84
"2374","2212231",0.719786708383325,1275,0.734287434026665,1432,-0.0145007256433405,-157
"2375","3212231",0.676672499569821,2325,0.705493600826886,2235,-0.0288211012570645,90
"2376","4212231",0.635198168869281,3738,0.663083225705075,3834,-0.0278850568357941,-96
"2377","1312231",0.755030410614737,719,0.76361135133419,881,-0.00858094071945315,-162
"2378","2312231",0.691807238106549,1911,0.707236866693367,2176,-0.0154296285868187,-265
"2379","3312231",0.648693029293045,3236,0.678443033493588,3189,-0.0297500042005427,47
"2380","4312231",0.607218698592505,4922,0.636032658371777,5121,-0.0288139597792724,-199
"2381","1412231",0.716093912629741,1347,0.722981847366085,1725,-0.0068879347363433,-378
"2382","2412231",0.652870740121553,3082,0.666607362725262,3662,-0.013736622603709,-580
"2383","3412231",0.609756531308049,4809,0.637813529525482,5048,-0.028056998217433,-239
"2384","4412231",0.568282200607509,6786,0.595403154403672,7323,-0.0271209537961626,-537
"2385","1122231",0.76898838761809,566,0.785396885955788,575,-0.0164084983376982,-9
"2386","2122231",0.705765215109901,1571,0.729022401314965,1558,-0.0232571862050638,13
"2387","3122231",0.662651006296397,2742,0.700228568115185,2399,-0.0375775618187878,343
"2388","4122231",0.621176675595857,4284,0.657818192993375,4062,-0.0366415173975174,222
"2389","1222231",0.715030610025094,1366,0.730092607010082,1526,-0.0150619969849881,-160
"2390","2222231",0.651807437516905,3124,0.673718122369258,3362,-0.0219106848523537,-238
"2391","3222231",0.608693228703401,4866,0.644924289169479,4657,-0.0362310604660777,209
"2392","4222231",0.567218898002861,6836,0.602513914047669,6899,-0.0352950160448073,-63
"2393","1322231",0.687051139748317,2023,0.703042039676784,2313,-0.0159908999284664,-290
"2394","2322231",0.623827967240129,4184,0.64666755503596,4576,-0.022839587795832,-392
"2395","3322231",0.580713758426625,6163,0.617873721836181,6054,-0.037159963409556,109
"2396","4322231",0.539239427726085,8264,0.575463346714371,8461,-0.0362239189882856,-197
"2397","1422231",0.648114641763321,3265,0.662412535708678,3862,-0.0142978939453565,-597
"2398","2422231",0.584891469255133,5955,0.606038051067855,6698,-0.0211465818127222,-743
"2399","3422231",0.541777260441629,8134,0.577244217868075,8362,-0.0354669574264462,-228
"2400","4422231",0.500302929741089,10249,0.534833842746265,10746,-0.0345309130051759,-497
"2401","1132231",0.72565586545299,1169,0.746931793507759,1174,-0.021275928054769,-5
"2402","2132231",0.662432692944801,2749,0.690557308866936,2728,-0.0281246159221346,21
"2403","3132231",0.619318484131298,4373,0.661763475667156,3898,-0.0424449915358586,475
"2404","4132231",0.577844153430758,6304,0.619353100545346,5976,-0.0415089471145882,328
"2405","1232231",0.671698087859994,2455,0.691627514562053,2688,-0.0199294267020589,-233
"2406","2232231",0.608474915351805,4873,0.63525302992123,5169,-0.0267781145694245,-296
"2407","3232231",0.565360706538302,6920,0.60645919672145,6677,-0.0410984901831485,243
"2408","4232231",0.523886375837762,9052,0.56404882159964,9102,-0.0401624457618781,-50
"2409","1332231",0.643718617583218,3403,0.664576947228755,3772,-0.0208583296455371,-369
"2410","2332231",0.580495445075029,6174,0.608202462587932,6598,-0.0277070175129027,-424
"2411","3332231",0.537381236261525,8351,0.579408629388152,8231,-0.0420273931266267,120
"2412","4332231",0.495906905560985,10454,0.536998254266342,10636,-0.0410913487053564,-182
"2413","1432231",0.604782119598222,5014,0.623947443260649,5726,-0.0191653236624273,-712
"2414","2432231",0.541558947090033,8143,0.567572958619826,8910,-0.026014011529793,-767
"2415","3432231",0.498444738276529,10337,0.538779125420046,10533,-0.040334387143517,-196
"2416","4432231",0.45697040757599,12263,0.496368750298236,12653,-0.0393983427222466,-390
"2417","1142231",0.676622300998161,2327,0.706533299380675,2205,-0.0299109983825144,122
"2418","2142231",0.613399128489972,4644,0.650158814739852,4415,-0.03675968624988,229
"2419","3142231",0.570284919676468,6677,0.621364981540072,5867,-0.051080061863604,810
"2420","4142231",0.528810588975928,8798,0.578954606418262,8262,-0.0501440174423337,536
"2421","1242231",0.622664523405164,4230,0.651229020434969,4358,-0.0285644970298043,-128
"2422","2242231",0.559441350896976,7196,0.594854535794145,7351,-0.0354131848971699,-155
"2423","3242231",0.516327142083472,9451,0.566060702594366,8987,-0.049733560510894,464
"2424","4242231",0.474852811382932,11481,0.523650327472556,11313,-0.0487975160896236,168
"2425","1342231",0.594685053128388,5484,0.624178453101671,5712,-0.0294933999732826,-228
"2426","2342231",0.531461880620199,8652,0.567803968460848,8899,-0.0363420878406482,-247
"2427","3342231",0.488347671806696,10837,0.539010135261068,10522,-0.0506624634543722,315
"2428","4342231",0.446873341106156,12686,0.496599760139258,12639,-0.0497264190331018,47
"2429","1442231",0.555748555143392,7412,0.583548949133565,7975,-0.0278003939901728,-563
"2430","2442231",0.492525382635203,10619,0.527174464492742,11135,-0.0346490818575385,-516
"2431","3442231",0.4494111738217,12577,0.498380631292962,12569,-0.0489694574712625,8
"2432","4442231",0.40793684312116,14069,0.455970256171152,14213,-0.0480334130499921,-144
"2433","1113231",0.798084482912024,325,0.820469607223956,268,-0.0223851243119316,57
"2434","2113231",0.734861310403835,1010,0.764095122583132,870,-0.0292338121792972,140
"2435","3113231",0.691747101590332,1914,0.735301289383353,1415,-0.0435541877930212,499
"2436","4113231",0.650272770889792,3182,0.692890914261543,2647,-0.0426181433717507,535
"2437","1213231",0.744126705319028,863,0.76516532827825,853,-0.0210386229592214,10
"2438","2213231",0.680903532810839,2199,0.708790843637426,2122,-0.027887310826587,77
"2439","3213231",0.637789323997336,3644,0.679997010437647,3138,-0.042207686440311,506
"2440","4213231",0.596314993296796,5407,0.637586635315836,5058,-0.0412716420190408,349
"2441","1313231",0.716147235042252,1344,0.738114760944952,1349,-0.0219675259026997,-5
"2442","2313231",0.652924062534063,3079,0.681740276304128,3065,-0.0288162137700653,14
"2443","3313231",0.60980985372056,4805,0.652946443104349,4283,-0.0431365893837893,522
"2444","4313231",0.56833552302002,6781,0.610536067982538,6455,-0.042200544962519,326
"2445","1413231",0.677210737057256,2311,0.697485256976846,2486,-0.0202745199195898,-175
"2446","2413231",0.613987564549067,4613,0.641110772336023,4869,-0.0271232077869555,-256
"2447","3413231",0.570873355735564,6641,0.612316939136243,6370,-0.0414435834006796,271
"2448","4413231",0.529399025035023,8768,0.569906564014433,8781,-0.0405075389794093,-13
"2449","1123231",0.730105212045604,1092,0.759900295566549,936,-0.0297950835209448,156
"2450","2123231",0.666882039537415,2599,0.703525810925726,2296,-0.0366437713883104,303
"2451","3123231",0.623767830723912,4188,0.674731977725946,3328,-0.0509641470020344,860
"2452","4123231",0.582293500023372,6079,0.632321602604136,5299,-0.050028102580764,780
"2453","1223231",0.676147434452608,2336,0.704596016620843,2257,-0.0284485821682346,79
"2454","2223231",0.612924261944419,4661,0.648221531980019,4490,-0.0352972700356002,171
"2455","3223231",0.569810053130916,6701,0.61942769878024,5971,-0.0496176456493242,730
"2456","4223231",0.528335722430376,8823,0.57701732365843,8372,-0.048681601228054,451
"2457","1323231",0.648167964175832,3261,0.677545449287545,3224,-0.0293774851117129,37
"2458","2323231",0.584944791667643,5952,0.621170964646722,5878,-0.0362261729790785,74
"2459","3323231",0.54183058285414,8130,0.592377131446942,7483,-0.0505465485928025,647
"2460","4323231",0.500356252153599,10244,0.549966756325132,9895,-0.0496105041715322,349
"2461","1423231",0.609231466190836,4840,0.636915945319439,5079,-0.0276844791286031,-239
"2462","2423231",0.546008293682647,7904,0.580541460678616,8158,-0.0345331669959688,-254
"2463","3423231",0.502894084869144,10121,0.551747627478836,9808,-0.0488535426096928,313
"2464","4423231",0.461419754168603,12072,0.509337252357026,12049,-0.0479174981884225,23
"2465","1133231",0.686772689880505,2029,0.72143520311852,1772,-0.0346625132380155,257
"2466","2133231",0.623549517372316,4201,0.665060718477697,3748,-0.0415112011053811,453
"2467","3133231",0.580435308558812,6179,0.636266885277917,5109,-0.0558315767191051,1070
"2468","4133231",0.538960977858272,8280,0.593856510156107,7414,-0.0548955322978348,866
"2469","1233231",0.632814912287508,3815,0.666130924172814,3687,-0.0333160118853055,128
"2470","2233231",0.569591739779319,6715,0.60975643953199,6506,-0.0401646997526711,209
"2471","3233231",0.526477530965816,8934,0.580962606332211,8135,-0.0544850753663951,799
"2472","4233231",0.485003200265276,10997,0.538552231210401,10546,-0.0535490309451246,451
"2473","1333231",0.604835442010732,5011,0.639080356839516,4981,-0.0342449148287838,30
"2474","2333231",0.541612269502543,8139,0.582705872198693,8039,-0.0410936026961494,100
"2475","3333231",0.49849806068904,10333,0.553912038998913,9690,-0.0554139783098734,643
"2476","4333231",0.4570237299885,12260,0.511501663877103,11960,-0.0544779338886029,300
"2477","1433231",0.565898944025736,6891,0.59845085287141,7146,-0.0325519088456739,-255
"2478","2433231",0.502675771517547,10129,0.542076368230587,10350,-0.0394005967130396,-221
"2479","3433231",0.459561562704044,12158,0.513282535030807,11866,-0.0537209723267636,292
"2480","4433231",0.418087232003504,13749,0.470872159908997,13728,-0.0527849279054932,21
"2481","1143231",0.637739125425675,3647,0.681036708991436,3092,-0.0432975835657611,555
"2482","2143231",0.574515952917486,6458,0.624662224350613,5685,-0.0501462714331267,773
"2483","3143231",0.531401744103983,8660,0.595868391150833,7302,-0.0644666470468507,1358
"2484","4143231",0.489927413403443,10749,0.553458016029023,9717,-0.0635306026255802,1032
"2485","1243231",0.583781347832679,6006,0.62573243004573,5627,-0.0419510822130509,379
"2486","2243231",0.52055817532449,9207,0.569357945404906,8810,-0.0487997700804165,397
"2487","3243231",0.477443966510987,11349,0.540564112205127,10450,-0.0631201456941405,899
"2488","4243231",0.435969635810446,13101,0.498153737083317,12576,-0.0621841012728702,525
"2489","1343231",0.555801877555903,7409,0.598681862712432,7132,-0.0428799851565291,277
"2490","2343231",0.492578705047714,10615,0.542307378071609,10333,-0.0497286730238947,282
"2491","3343231",0.44946449623421,12573,0.513513544871829,11857,-0.0640490486376187,716
"2492","4343231",0.40799016553367,14065,0.471103169750019,13719,-0.0631130042163485,346
"2493","1443231",0.516865379570907,9415,0.558052358744326,9442,-0.0411869791734193,-27
"2494","2443231",0.453642207062718,12401,0.501677874103503,12415,-0.048035667040785,-14
"2495","3443231",0.410527998249214,13979,0.472884040903723,13653,-0.062356042654509,326
"2496","4443231",0.369053667548674,15071,0.430473665781913,14967,-0.0614199982332386,104
"2497","1114231",0.745877410941454,842,0.7758189938503,682,-0.0299415829088455,160
"2498","2114231",0.682654238433265,2145,0.719444509209477,1818,-0.0367902707762111,327
"2499","3114231",0.639540029619762,3580,0.690650676009697,2720,-0.0511106463899351,860
"2500","4114231",0.598065698919222,5318,0.648240300887887,4487,-0.0501746019686647,831
"2501","1214231",0.691919633348458,1905,0.720514714904594,1794,-0.0285950815561354,111
"2502","2214231",0.628696460840269,3976,0.66414023026377,3791,-0.035443769423501,185
"2503","3214231",0.585582252026766,5912,0.635346397063991,5157,-0.049764145037225,755
"2504","4214231",0.544107921326226,8014,0.59293602194218,7455,-0.0488281006159547,559
"2505","1314231",0.663940163071682,2698,0.693464147571296,2624,-0.0295239844996137,74
"2506","2314231",0.600716990563493,5193,0.637089662930472,5072,-0.0363726723669793,121
"2507","3314231",0.55760278174999,7293,0.608295829730693,6590,-0.0506930479807033,703
"2508","4314231",0.51612845104945,9460,0.565885454608883,8992,-0.0497570035594329,468
"2509","1414231",0.625003665086686,4129,0.65283464360319,4287,-0.0278309785165038,-158
"2510","2414231",0.561780492578497,7072,0.596460158962367,7266,-0.0346796663838695,-194
"2511","3414231",0.518666283764994,9298,0.567666325762587,8902,-0.0490000419975936,396
"2512","4414231",0.477191953064454,11365,0.525255950640777,11232,-0.0480639975763232,133
"2513","1124231",0.677898140075034,2290,0.715249682192893,1926,-0.0373515421178587,364
"2514","2124231",0.614674967566845,4566,0.65887519755207,4018,-0.0442002299852243,548
"2515","3124231",0.571560758753342,6604,0.63008136435229,5406,-0.0585206055989483,1198
"2516","4124231",0.530086428052802,8729,0.58767098923048,7727,-0.057584561177678,1002
"2517","1224231",0.623940362482038,4180,0.659945403247187,3972,-0.0360050407651487,208
"2518","2224231",0.560717189973849,7133,0.603570918606364,6846,-0.0428537286325142,287
"2519","3224231",0.517602981160346,9372,0.574777085406584,8505,-0.0571741042462383,867
"2520","4224231",0.476128650459806,11416,0.532366710284774,10874,-0.0562380598249679,542
"2521","1324231",0.595960892205262,5425,0.632894835913889,5272,-0.0369339437086269,153
"2522","2324231",0.532737719697073,8584,0.576520351273066,8398,-0.0437826315759925,186
"2523","3324231",0.48962351088357,10761,0.547726518073286,10023,-0.0581030071897165,738
"2524","4324231",0.44814918018303,12630,0.505316142951476,12233,-0.0571669627684461,397
"2525","1424231",0.557024394220266,7342,0.592265331945783,7487,-0.0352409377255171,-145
"2526","2424231",0.493801221712077,10554,0.53589084730496,10693,-0.0420896255928828,-139
"2527","3424231",0.450687012898574,12515,0.50709701410518,12160,-0.0564100012066068,355
"2528","4424231",0.409212682198034,14024,0.46468663898337,13928,-0.0554739567853364,96
"2529","1134231",0.634565617909935,3758,0.676784589744864,3263,-0.0422189718349295,495
"2530","2134231",0.571342445401746,6620,0.620410105104041,5923,-0.0490676597022951,697
"2531","3134231",0.528228236588242,8832,0.591616271904261,7521,-0.0633880353160191,1311
"2532","4134231",0.486753905887702,10917,0.549205896782451,9940,-0.0624519908947487,977
"2533","1234231",0.580607840316939,6169,0.621480310799158,5859,-0.0408724704822194,310
"2534","2234231",0.51738466780875,9390,0.565105826158335,9034,-0.047721158349585,356
"2535","3234231",0.474270458995246,11510,0.536311992958555,10668,-0.062041533963309,842
"2536","4234231",0.432796128294706,13238,0.493901617836745,12759,-0.0611054895420386,479
"2537","1334231",0.552628370040162,7557,0.59442974346586,7374,-0.0418013734256977,183
"2538","2334231",0.489405197531974,10776,0.538055258825037,10572,-0.0486500612930633,204
"2539","3334231",0.44629098871847,12702,0.509261425625257,12051,-0.0629704369067873,651
"2540","4334231",0.40481665801793,14170,0.466851050503447,13852,-0.0620343924855169,318
"2541","1434231",0.513691872055166,9582,0.553800239497754,9697,-0.0401083674425878,-115
"2542","2434231",0.450468699546978,12524,0.497425754856931,12604,-0.0469570553099535,-80
"2543","3434231",0.407354490733474,14086,0.468631921657152,13803,-0.0612774309236775,283
"2544","4434231",0.365880160032934,15150,0.426221546535341,15053,-0.0603413865024072,97
"2545","1144231",0.585532053455105,5920,0.63638609561778,5104,-0.050854042162675,816
"2546","2144231",0.522308880946916,9132,0.580011610976957,8195,-0.0577027300300406,937
"2547","3144231",0.479194672133413,11263,0.551217777777177,9834,-0.0720231056437646,1429
"2548","4144231",0.437720341432873,13029,0.508807402655367,12073,-0.0710870612224942,956
"2549","1244231",0.531574275862109,8644,0.581081816672074,8126,-0.0495075408099649,518
"2550","2244231",0.46835110335392,11764,0.524707332031251,11264,-0.0563562286773305,500
"2551","3244231",0.425236894540417,13500,0.495913498831471,12674,-0.0706766042910545,826
"2552","4244231",0.383762563839877,14738,0.453503123709661,14300,-0.0697405598697841,438
"2553","1344231",0.503594805585333,10086,0.554031249338776,9679,-0.0504364437534431,407
"2554","2344231",0.440371633077144,12929,0.497656764697953,12594,-0.0572851316208087,335
"2555","3344231",0.39725742426364,14374,0.468862931498173,13796,-0.0716055072345327,578
"2556","4344231",0.355783093563101,15334,0.426452556376363,15047,-0.0706694628132624,287
"2557","1444231",0.464658307600337,11924,0.51340174537067,11861,-0.0487434377703333,63
"2558","2444231",0.401435135092148,14265,0.457027260729847,14180,-0.055592125637699,85
"2559","3444231",0.358320926278645,15285,0.428233427530068,15020,-0.069912501251423,265
"2560","4444231",0.316846595578105,15878,0.385823052408257,15783,-0.0689764568301526,95
"2561","1111331",0.847598591240891,103,0.866235189214172,81,-0.0186365979732815,22
"2562","2111331",0.784375418732702,415,0.809860704573349,337,-0.0254852858406471,78
"2563","3111331",0.741261209919198,907,0.78106687137357,626,-0.0398056614543711,281
"2564","4111331",0.699786879218658,1700,0.738656496251759,1340,-0.0388696170331009,360
"2565","1211331",0.793640813647894,353,0.810930910268466,330,-0.0172900966205716,23
"2566","2211331",0.730417641139706,1089,0.754556425627643,1016,-0.0241387844879372,73
"2567","3211331",0.687303432326202,2018,0.725762592427863,1651,-0.0384591601016612,367
"2568","4211331",0.645829101625662,3337,0.683352217306053,2993,-0.0375231156803907,344
"2569","1311331",0.765661343371118,601,0.783880342935168,590,-0.0182189995640498,11
"2570","2311331",0.702438170862929,1649,0.727505858294345,1598,-0.0250676874314154,51
"2571","3311331",0.659323962049426,2840,0.698712025094565,2453,-0.0393880630451394,387
"2572","4311331",0.617849631348886,4431,0.656301649972755,4134,-0.0384520186238689,297
"2573","1411331",0.726724845386122,1147,0.743250838967062,1245,-0.01652599358094,-98
"2574","2411331",0.663501672877933,2719,0.686876354326239,2858,-0.0233746814483057,-139
"2575","3411331",0.62038746406443,4323,0.65808252112646,4049,-0.0376950570620297,274
"2576","4411331",0.57891313336389,6264,0.615672146004649,6182,-0.0367590126407592,82
"2577","1121331",0.779619320374471,456,0.805665877556765,377,-0.0260465571822948,79
"2578","2121331",0.716396147866282,1338,0.749291392915942,1121,-0.0328952450496603,217
"2579","3121331",0.673281939052778,2412,0.720497559716163,1797,-0.0472156206633844,615
"2580","4121331",0.631807608352238,3852,0.678087184594352,3205,-0.0462795762421141,647
"2581","1221331",0.725661542781474,1167,0.750361598611059,1096,-0.0247000558295848,71
"2582","2221331",0.662438370273286,2747,0.693987113970236,2610,-0.0315487436969504,137
"2583","3221331",0.619324161459782,4372,0.665193280770456,3738,-0.0458691193106744,634
"2584","4221331",0.577849830759242,6303,0.622782905648646,5795,-0.0449330748894039,508
"2585","1321331",0.697682072504698,1748,0.723311031277761,1719,-0.025628958773063,29
"2586","2321331",0.634458899996509,3763,0.666936546636938,3652,-0.0324776466404286,111
"2587","3321331",0.591344691183006,5616,0.638142713437159,5036,-0.0467980222541526,580
"2588","4321331",0.549870360482466,7706,0.595732338315348,7310,-0.0458619778328822,396
"2589","1421331",0.658745574519702,2858,0.682681527309655,3019,-0.0239359527899532,-161
"2590","2421331",0.595522402011513,5445,0.626307042668832,5602,-0.0307846406573189,-157
"2591","3421331",0.55240819319801,7574,0.597513209469053,7213,-0.0451050162710429,361
"2592","4421331",0.51093386249747,9724,0.555102834347243,9622,-0.0441689718497724,102
"2593","1131331",0.736286798209371,990,0.767200785108737,819,-0.0309139868993656,171
"2594","2131331",0.673063625701182,2415,0.710826300467913,2059,-0.0377626747667312,356
"2595","3131331",0.629949416887679,3917,0.682032467268134,3050,-0.0520830503804552,867
"2596","4131331",0.588475086187139,5760,0.639622092146323,4943,-0.0511470059591848,817
"2597","1231331",0.682329020616375,2160,0.71189650616303,2016,-0.0295674855466554,144
"2598","2231331",0.619105848108186,4382,0.655522021522207,4165,-0.036416173414021,217
"2599","3231331",0.575991639294683,6384,0.626728188322428,5581,-0.050736549027745,803
"2600","4231331",0.534517308594142,8488,0.584317813200617,7929,-0.0498005046064748,559
"2601","1331331",0.654349550339599,3018,0.684845938829732,2933,-0.0304963884901337,85
"2602","2331331",0.59112637783141,5626,0.628471454188909,5478,-0.0373450763574993,148
"2603","3331331",0.548012169017906,7792,0.59967762098913,7076,-0.0516654519712233,716
"2604","4331331",0.506537838317366,9925,0.557267245867319,9494,-0.050729407549953,431
"2605","1431331",0.615413052354603,4532,0.644216434861627,4687,-0.0288033825070239,-155
"2606","2431331",0.552189879846414,7590,0.587841950220803,7717,-0.0356520703743896,-127
"2607","3431331",0.50907567103291,9797,0.559048117021024,9394,-0.0499724459881136,403
"2608","4431331",0.46760134033237,11793,0.516637741899214,11683,-0.0490364015668433,110
"2609","1141331",0.687253233754542,2019,0.726802290981652,1619,-0.039549057227111,400
"2610","2141331",0.624030061246353,4178,0.670427806340829,3492,-0.0463977450944766,686
"2611","3141331",0.580915852432849,6153,0.64163397314105,4838,-0.0607181207082006,1315
"2612","4141331",0.539441521732309,8257,0.599223598019239,7102,-0.0597820762869303,1155
"2613","1241331",0.633295456161545,3799,0.671498012035946,3455,-0.038202555874401,344
"2614","2241331",0.570072283653356,6687,0.615123527395123,6207,-0.0450512437417666,480
"2615","3241331",0.526958074839853,8906,0.586329694195344,7817,-0.0593716193554906,1089
"2616","4241331",0.485483744139313,10977,0.543919319073533,10241,-0.0584355749342201,736
"2617","1341331",0.605315985884769,4995,0.644447444702648,4676,-0.0391314588178793,319
"2618","2341331",0.54209281337658,8119,0.588072960061825,7707,-0.0459801466852449,412
"2619","3341331",0.498978604563077,10321,0.559279126862046,9377,-0.0603005222989689,944
"2620","4341331",0.457504273862537,12241,0.516868751740235,11674,-0.0593644778776984,567
"2621","1441331",0.566379487899773,6867,0.603817940734543,6833,-0.0374384528347694,34
"2622","2441331",0.503156315391584,10113,0.547443456093719,10035,-0.0442871407021351,78
"2623","3441331",0.460042106578081,12142,0.51864962289394,11577,-0.0586075163158591,565
"2624","4441331",0.418567775877541,13738,0.47623924777213,13503,-0.0576714718945887,235
"2625","1112331",0.814513679479202,226,0.82791620768552,226,-0.0134025282063184,0
"2626","2112331",0.751290506971013,768,0.771541723044697,747,-0.020251216073684,21
"2627","3112331",0.708176298157509,1515,0.742747889844917,1255,-0.034571591687408,260
"2628","4112331",0.666701967456969,2606,0.700337514723107,2395,-0.0336355472661377,211
"2629","1212331",0.760555901886205,664,0.772611928739814,731,-0.0120560268536084,-67
"2630","2212331",0.697332729378017,1765,0.716237444098991,1904,-0.018904714720974,-139
"2631","3212331",0.654218520564513,3023,0.687443610899211,2835,-0.033225090334698,188
"2632","4212331",0.612744189863973,4671,0.645033235777401,4651,-0.0322890459134275,20
"2633","1312331",0.732576431609429,1050,0.745561361406516,1197,-0.0129849297970867,-147
"2634","2312331",0.66935325910124,2532,0.689186876765693,2768,-0.0198336176644522,-236
"2635","3312331",0.626239050287737,4067,0.660393043565913,3953,-0.0341539932781763,114
"2636","4312331",0.584764719587197,5964,0.617982668444103,6049,-0.0332179488569058,-85
"2637","1412331",0.693639933624433,1855,0.70493185743841,2251,-0.0112919238139768,-396
"2638","2412331",0.630416761116244,3899,0.648557372797587,4471,-0.0181406116813425,-572
"2639","3412331",0.587302552302741,5815,0.619763539597808,5954,-0.0324609872950665,-139
"2640","4412331",0.545828221602201,7918,0.577353164475997,8356,-0.031524942873796,-438
"2641","1122331",0.746534408612782,836,0.767346896028113,814,-0.0208124874153316,22
"2642","2122331",0.683311236104593,2129,0.71097241138729,2054,-0.0276611752826972,75
"2643","3122331",0.640197027291089,3559,0.682178578187511,3041,-0.0419815508964212,518
"2644","4122331",0.598722696590549,5289,0.6397682030657,4931,-0.0410455064751509,358
"2645","1222331",0.692576631019786,1890,0.712042617082407,2008,-0.0194659860626216,-118
"2646","2222331",0.629353458511597,3945,0.655668132441584,4162,-0.0263146739299872,-217
"2647","3222331",0.586239249698093,5873,0.626874299241804,5570,-0.0406350495437112,303
"2648","4222331",0.544764918997553,7977,0.584463924119994,7920,-0.0396990051224407,57
"2649","1322331",0.664597160743009,2671,0.684992049749109,2928,-0.0203948890060999,-257
"2650","2322331",0.60137398823482,5169,0.628617565108286,5471,-0.0272435768734655,-302
"2651","3322331",0.558259779421317,7265,0.599823731908506,7065,-0.0415639524871895,200
"2652","4322331",0.516785448720777,9421,0.557413356786696,9484,-0.040627908065919,-63
"2653","1422331",0.625660662758013,4089,0.644362545781003,4682,-0.01870188302299,-593
"2654","2422331",0.562437490249824,7040,0.58798806114018,7712,-0.0255505708903557,-672
"2655","3422331",0.519323281436321,9264,0.559194227940401,9384,-0.0398709465040797,-120
"2656","4422331",0.477848950735781,11329,0.51678385281859,11678,-0.0389349020828093,-349
"2657","1132331",0.703201886447682,1628,0.728881803580084,1566,-0.0256799171324025,62
"2658","2132331",0.639978713939493,3563,0.672507318939261,3423,-0.0325286049997681,140
"2659","3132331",0.59686450512599,5376,0.643713485739482,4720,-0.0468489806134921,656
"2660","4132331",0.55539017442545,7435,0.601303110617671,6980,-0.0459129361922216,455
"2661","1232331",0.649244108854686,3224,0.673577524634378,3370,-0.0243334157796923,-146
"2662","2232331",0.586020936346497,5889,0.617203039993555,6100,-0.0311821036470579,-211
"2663","3232331",0.542906727532994,8072,0.588409206793776,7691,-0.0455024792607819,381
"2664","4232331",0.501432396832454,10203,0.545998831671965,10115,-0.0445664348395116,88
"2665","1332331",0.62126463857791,4281,0.64652695730108,4583,-0.0252623187231705,-302
"2666","2332331",0.558041466069721,7274,0.590152472660257,7595,-0.0321110065905361,-321
"2667","3332331",0.514927257256217,9519,0.561358639460478,9247,-0.0464313822042601,272
"2668","4332331",0.473452926555677,11546,0.518948264338667,11560,-0.0454953377829899,-14
"2669","1432331",0.582328140592914,6077,0.605897453332975,6707,-0.0235693127400607,-630
"2670","2432331",0.519104968084725,9279,0.549522968692151,9919,-0.0304180006074264,-640
"2671","3432331",0.475990759271221,11425,0.520729135492372,11459,-0.0447383762211504,-34
"2672","4432331",0.434516428570681,13166,0.478318760370562,13407,-0.0438023317998801,-241
"2673","1142331",0.654168321992853,3026,0.688483309453,2793,-0.0343149874601478,233
"2674","2142331",0.590945149484664,5634,0.632108824812177,5310,-0.0411636753275134,324
"2675","3142331",0.54783094067116,7798,0.603314991612398,6861,-0.0554840509412374,937
"2676","4142331",0.50635660997062,9936,0.560904616490587,9268,-0.0545480065199672,668
"2677","1242331",0.600210544399856,5221,0.633179030507294,5259,-0.0329684861074379,-38
"2678","2242331",0.536987371891667,8370,0.576804545866471,8383,-0.0398171739748034,-13
"2679","3242331",0.493873163078164,10550,0.548010712666691,10009,-0.0541375495885275,541
"2680","4242331",0.452398832377624,12445,0.505600337544881,12220,-0.053201505167257,225
"2681","1342331",0.57223107412308,6577,0.606128463173996,6693,-0.0338973890509161,-116
"2682","2342331",0.509007901614891,9802,0.549753978533173,9905,-0.0407460769182817,-103
"2683","3342331",0.465893692801388,11864,0.520960145333394,11447,-0.0550664525320057,417
"2684","4342331",0.424419362100848,13532,0.478549770211583,13391,-0.0541304081107352,141
"2685","1442331",0.533294576138084,8555,0.56549895920589,9015,-0.0322043830678063,-460
"2686","2442331",0.470071403629895,11689,0.509124474565067,12059,-0.039053070935172,-370
"2687","3442331",0.426957194816392,13442,0.480330641365288,13324,-0.053373446548896,118
"2688","4442331",0.385482864115852,14696,0.437920266243477,14762,-0.0524374021276255,-66
"2689","1113331",0.775630503906716,494,0.802419617296281,404,-0.026789113389565,90
"2690","2113331",0.712407331398527,1419,0.746045132655458,1186,-0.0336378012569306,233
"2691","3113331",0.669293122585024,2534,0.717251299455678,1884,-0.0479581768706546,650
"2692","4113331",0.627818791884484,4000,0.674840924333868,3325,-0.0470221324493841,675
"2693","1213331",0.72167272631372,1240,0.747115338350575,1167,-0.0254426120368548,73
"2694","2213331",0.658449553805531,2875,0.690740853709752,2718,-0.0322912999042204,157
"2695","3213331",0.615335344992028,4538,0.661947020509972,3887,-0.0466116755179444,651
"2696","4213331",0.573861014291488,6485,0.619536645388162,5965,-0.0456756310966742,520
"2697","1313331",0.693693256036944,1850,0.720064771017277,1808,-0.0263715149803331,42
"2698","2313331",0.630470083528755,3894,0.663690286376454,3810,-0.0332202028476987,84
"2699","3313331",0.587355874715252,5808,0.634896453176674,5188,-0.0475405784614227,620
"2700","4313331",0.545881544014711,7912,0.592486078054864,7481,-0.0466045340401524,431
"2701","1413331",0.654756758051948,2992,0.679435267049171,3160,-0.0246785089972232,-168
"2702","2413331",0.591533585543759,5599,0.623060782408348,5780,-0.0315271968645889,-181
"2703","3413331",0.548419376730256,7767,0.594266949208568,7389,-0.045847572478313,378
"2704","4413331",0.506945046029715,9906,0.551856574086758,9803,-0.0449115280570427,103
"2705","1123331",0.707651233040296,1529,0.741850305638874,1274,-0.0341990725985782,255
"2706","2123331",0.644428060532107,3385,0.685475820998051,2912,-0.0410477604659438,473
"2707","3123331",0.601313851718604,5175,0.656681987798272,4122,-0.0553681360796678,1053
"2708","4123331",0.559839521018064,7179,0.614271612676461,6255,-0.0544320916583974,924
"2709","1223331",0.6536934554473,3045,0.686546026693168,2869,-0.032852571245868,176
"2710","2223331",0.590470282939111,5666,0.630171542052345,5402,-0.0397012591132336,264
"2711","3223331",0.547356074125608,7823,0.601377708852565,6971,-0.0540216347269576,852
"2712","4223331",0.505881743425068,9953,0.558967333730755,9399,-0.0530855903056874,554
"2713","1323331",0.625713985170524,4082,0.65949545935987,3991,-0.0337814741893463,91
"2714","2323331",0.562490812662335,7035,0.603120974719047,6873,-0.0406301620567119,162
"2715","3323331",0.519376603848832,9256,0.574327141519267,8532,-0.0549505376704359,724
"2716","4323331",0.477902273148291,11323,0.531916766397457,10896,-0.0540144932491656,427
"2717","1423331",0.586777487185528,5836,0.618865955391764,5999,-0.0320884682062365,-163
"2718","2423331",0.523554314677339,9060,0.562491470750941,9195,-0.0389371560736022,-135
"2719","3423331",0.480440105863836,11200,0.533697637551162,10813,-0.0532575316873262,387
"2720","4423331",0.438965775163295,12977,0.491287262429351,12875,-0.0523214872660559,102
"2721","1133331",0.664318710875197,2685,0.703385213190845,2302,-0.0390665023156489,383
"2722","2133331",0.601095538367008,5182,0.647010728550022,4557,-0.0459151901830145,625
"2723","3133331",0.557981329553504,7276,0.618216895350243,6037,-0.0602355657967385,1239
"2724","4133331",0.516506998852964,9437,0.575806520228432,8439,-0.0592995213754682,998
"2725","1233331",0.6103609332822,4783,0.648080934245139,4499,-0.0377200009629389,284
"2726","2233331",0.547137760774011,7844,0.591706449604316,7515,-0.0445686888303045,329
"2727","3233331",0.504023551960508,10062,0.562912616404536,9169,-0.0588890644440285,893
"2728","4233331",0.462549221259968,12019,0.520502241282726,11468,-0.057953020022758,551
"2729","1333331",0.582381463005424,6071,0.621030366911841,5887,-0.0386489039064172,184
"2730","2333331",0.519158290497235,9274,0.564655882271018,9060,-0.0454975917737828,214
"2731","3333331",0.476044081683732,11420,0.535862049071239,10694,-0.0598179673875068,726
"2732","4333331",0.434569750983192,13162,0.493451673949428,12780,-0.0588819229662363,382
"2733","1433331",0.543444965020428,8047,0.580400862943735,8164,-0.0369558979233073,-117
"2734","2433331",0.480221792512239,11209,0.524026378302912,11295,-0.043804585790673,-86
"2735","3433331",0.437107583698736,13053,0.495232545103133,12708,-0.058124961404397,345
"2736","4433331",0.395633252998196,14425,0.452822169981323,14317,-0.0571889169831266,108
"2737","1143331",0.615285146420367,4541,0.662986719063761,3842,-0.0477015726433945,699
"2738","2143331",0.552061973912178,7594,0.606612234422938,6668,-0.0545502605107601,926
"2739","3143331",0.508947765098675,9804,0.577818401223159,8336,-0.0688706361244841,1468
"2740","4143331",0.467473434398135,11794,0.535408026101348,10717,-0.0679345917032136,1077
"2741","1243331",0.561327368827371,7100,0.607682440118055,6622,-0.0463550712906843,478
"2742","2243331",0.498104196319182,10359,0.551307955477232,9829,-0.0532037591580499,530
"2743","3243331",0.454989987505679,12343,0.522514122277452,11373,-0.0675241347717739,970
"2744","4243331",0.413515656805138,13883,0.480103747155642,13333,-0.0665880903505036,550
"2745","1343331",0.533347898550595,8549,0.580631872784757,8154,-0.0472839742341625,395
"2746","2343331",0.470124726042406,11684,0.524257388143934,11286,-0.0541326621015281,398
"2747","3343331",0.427010517228902,13436,0.495463554944155,12698,-0.0684530377152521,738
"2748","4343331",0.385536186528362,14690,0.453053179822344,14311,-0.0675169932939819,379
"2749","1443331",0.494411400565599,10523,0.540002368816651,10475,-0.0455909682510527,48
"2750","2443331",0.43118822805741,13295,0.483627884175828,13199,-0.0524396561184184,96
"2751","3443331",0.388074019243906,14632,0.454834050976049,14259,-0.0667600317321424,373
"2752","4443331",0.346599688543366,15481,0.412423675854238,15357,-0.0658239873108721,124
"2753","1114331",0.723423431936146,1206,0.757769003922625,965,-0.034345571986479,241
"2754","2114331",0.660200259427957,2807,0.701394519281802,2371,-0.0411942598538446,436
"2755","3114331",0.617086050614454,4461,0.672600686082023,3415,-0.0555146354675686,1046
"2756","4114331",0.575611719913914,6394,0.630190310960212,5399,-0.0545785910462981,995
"2757","1214331",0.66946565434315,2527,0.702464724976919,2339,-0.0329990706337688,188
"2758","2214331",0.606242481834961,4967,0.646090240336096,4604,-0.0398477585011344,363
"2759","3214331",0.563128273021458,7008,0.617296407136316,6088,-0.0541681341148584,920
"2760","4214331",0.521653942320918,9162,0.574886032014506,8496,-0.0532320896935882,666
"2761","1314331",0.641486184066374,3510,0.675414157643621,3308,-0.0339279735772471,202
"2762","2314331",0.578263011558185,6288,0.619039673002798,5990,-0.0407766614446127,298
"2763","3314331",0.535148802744682,8458,0.590245839803018,7585,-0.0550970370583367,873
"2764","4314331",0.493674472044142,10562,0.547835464681208,10016,-0.0541609926370664,546
"2765","1414331",0.602549686081378,5108,0.634784653675515,5192,-0.0322349675941372,-84
"2766","2414331",0.539326513573189,8260,0.578410169034692,8293,-0.0390836554615029,-33
"2767","3414331",0.496212304759686,10446,0.549616335834913,9911,-0.053404031075227,535
"2768","4414331",0.454737974059146,12356,0.507205960713102,12151,-0.0524679866539567,205
"2769","1124331",0.655444161069726,2972,0.697199692265218,2501,-0.0417555311954922,471
"2770","2124331",0.592220988561537,5578,0.640825207624395,4880,-0.0486042190628578,698
"2771","3124331",0.549106779748034,7743,0.612031374424616,6391,-0.0629245946765818,1352
"2772","4124331",0.507632449047494,9870,0.569620999302805,8798,-0.0619885502553114,1072
"2773","1224331",0.60148638347673,5159,0.641895413319512,4820,-0.040409029842782,339
"2774","2224331",0.538263210968541,8314,0.585520928678689,7861,-0.0472577177101476,453
"2775","3224331",0.495149002155038,10489,0.55672709547891,9526,-0.0615780933238717,963
"2776","4224331",0.453674671454498,12400,0.514316720357099,11816,-0.0606420489026014,584
"2777","1324331",0.573506913199954,6504,0.614844845986214,6219,-0.0413379327862603,285
"2778","2324331",0.510283740691765,9749,0.558470361345391,9425,-0.0481866206536259,324
"2779","3324331",0.467169531878262,11807,0.529676528145612,11018,-0.0625069962673499,789
"2780","4324331",0.425695201177722,13485,0.487266153023801,13045,-0.0615709518460796,440
"2781","1424331",0.534570415214958,8482,0.574215342018109,8536,-0.0396449268031505,-54
"2782","2424331",0.471347242706769,11637,0.517840857377285,11624,-0.0464936146705162,13
"2783","3424331",0.428233033893266,13395,0.489047024177506,12977,-0.0608139902842402,418
"2784","4424331",0.386758703192726,14662,0.446636649055696,14525,-0.0598779458629698,137
"2785","1134331",0.612111638904627,4701,0.65873459981719,4023,-0.0466229609125629,678
"2786","2134331",0.548888466396438,7749,0.602360115176366,6911,-0.0534716487799285,838
"2787","3134331",0.505774257582934,9961,0.573566281976587,8570,-0.0677920243936525,1391
"2788","4134331",0.464299926882394,11940,0.531155906854777,10933,-0.0668559799723822,1007
"2789","1234331",0.55815386131163,7271,0.603430320871483,6852,-0.0452764595598529,419
"2790","2234331",0.494930688803442,10503,0.54705583623066,10053,-0.0521251474272185,450
"2791","3234331",0.451816479989938,12467,0.518262003030881,11599,-0.0664455230409425,868
"2792","4234331",0.410342149289398,13987,0.47585162790907,13514,-0.065509478619672,473
"2793","1334331",0.530174391034854,8725,0.576379753538185,8402,-0.0462053625033312,323
"2794","2334331",0.466951218526665,11818,0.520005268897362,11495,-0.0530540503706968,323
"2795","3334331",0.423837009713162,13551,0.491211435697583,12879,-0.0673744259844208,672
"2796","4334331",0.382362679012622,14774,0.448801060575772,14452,-0.0664383815631503,322
"2797","1434331",0.491237893049858,10681,0.53575024957008,10700,-0.0445123565202213,-19
"2798","2434331",0.428014720541669,13402,0.479375764929256,13360,-0.051361044387587,42
"2799","3434331",0.384900511728166,14708,0.450581931729477,14395,-0.0656814200013109,313
"2800","4434331",0.343426181027626,15536,0.408171556607667,15439,-0.0647453755800407,97
"2801","1144331",0.563078074449797,7009,0.618336105690106,6028,-0.0552580312403085,981
"2802","2144331",0.499854901941608,10275,0.561961621049282,9218,-0.0621067191076741,1057
"2803","3144331",0.456740693128105,12273,0.533167787849503,10838,-0.0764270947213981,1435
"2804","4144331",0.415266362427565,13839,0.490757412727692,12901,-0.0754910503001276,938
"2805","1244331",0.509120296856801,9793,0.563031826744399,9160,-0.0539115298875983,633
"2806","2244331",0.445897124348612,12719,0.506657342103576,12177,-0.0607602177549639,542
"2807","3244331",0.402782915535109,14222,0.477863508903797,13426,-0.0750805933686879,796
"2808","4244331",0.361308584834569,15233,0.435453133781986,14832,-0.0741445489474175,401
"2809","1344331",0.481140826580025,11177,0.535981259411101,10685,-0.0548404328310765,492
"2810","2344331",0.417917654071836,13756,0.479606774770278,13348,-0.0616891206984421,408
"2811","3344331",0.374803445258333,14947,0.450812941570499,14384,-0.0760094963121661,563
"2812","4344331",0.333329114557792,15687,0.408402566448688,15434,-0.0750734518908959,253
"2813","1444331",0.442204328595029,12860,0.495351755442996,12703,-0.0531474268479667,157
"2814","2444331",0.37898115608684,14857,0.438977270802172,14736,-0.0599961147153324,121
"2815","3444331",0.335866947273336,15657,0.410183437602393,15398,-0.0743164903290565,259
"2816","4444331",0.294392616572796,16075,0.367773062480583,15996,-0.0733804459077861,79
"2817","1111431",0.817806574228743,205,0.832110049377057,203,-0.0143034751483138,2
"2818","2111431",0.754583401720554,727,0.775735564736234,685,-0.0211521630156793,42
"2819","3111431",0.711469192907051,1439,0.746941731536454,1173,-0.0354725386294034,266
"2820","4111431",0.669994862206511,2505,0.704531356414644,2260,-0.034536494208133,245
"2821","1211431",0.763848796635747,618,0.776805770431351,677,-0.0129569737956037,-59
"2822","2211431",0.700625624127558,1679,0.720431285790527,1800,-0.0198056616629693,-121
"2823","3211431",0.657511415314055,2905,0.691637452590748,2687,-0.0341260372766933,218
"2824","4211431",0.616037084613515,4497,0.649227077468938,4446,-0.0331899928554229,51
"2825","1311431",0.735869326358971,997,0.749755203098053,1107,-0.0138858767390819,-110
"2826","2311431",0.672646153850782,2424,0.69338071845723,2629,-0.0207345646064475,-205
"2827","3311431",0.629531945037278,3937,0.66458688525745,3771,-0.0350549402201715,166
"2828","4311431",0.588057614336739,5776,0.62217651013564,5819,-0.0341188957989011,-43
"2829","1411431",0.696932828373975,1778,0.709125699129947,2109,-0.0121928707559721,-331
"2830","2411431",0.633709655865786,3788,0.652751214489124,4291,-0.0190415586233378,-503
"2831","3411431",0.590595447052283,5659,0.623957381289344,5725,-0.0333619342370618,-66
"2832","4411431",0.549121116351743,7742,0.581547006167534,8100,-0.0324258898157914,-358
"2833","1121431",0.749827303362323,783,0.77154073771965,748,-0.021713434357327,35
"2834","2121431",0.686604130854134,2036,0.715166253078827,1931,-0.0285621222246926,105
"2835","3121431",0.643489922040631,3417,0.686372419879047,2879,-0.0428824978384166,538
"2836","4121431",0.602015591340091,5132,0.643962044757237,4702,-0.0419464534171462,430
"2837","1221431",0.695869525769327,1795,0.716236458773944,1905,-0.0203669330046169,-110
"2838","2221431",0.632646353261138,3818,0.659861974133121,3978,-0.0272156208719825,-160
"2839","3221431",0.589532144447635,5708,0.631068140933341,5357,-0.0415359964857065,351
"2840","4221431",0.548057813747095,7787,0.588657765811531,7675,-0.0405999520644361,112
"2841","1321431",0.667890055492551,2575,0.689185891440646,2769,-0.0212958359480951,-194
"2842","2321431",0.604666882984362,5018,0.632811406799823,5278,-0.0281445238154607,-260
"2843","3321431",0.561552674170859,7086,0.604017573600043,6825,-0.0424648994291847,261
"2844","4321431",0.520078343470319,9232,0.561607198478233,9235,-0.0415288550079144,-3
"2845","1421431",0.628953557507555,3964,0.64855638747254,4472,-0.0196028299649853,-508
"2846","2421431",0.565730384999366,6899,0.592181902831717,7493,-0.026451517832351,-594
"2847","3421431",0.522616176185863,9114,0.563388069631938,9140,-0.040771893446075,-26
"2848","4421431",0.481141845485323,11176,0.520977694510127,11443,-0.0398358490248046,-267
"2849","1131431",0.706494781197224,1558,0.733075645271621,1463,-0.0265808640743977,95
"2850","2131431",0.643271608689035,3427,0.676701160630798,3267,-0.0334295519417633,160
"2851","3131431",0.600157399875531,5227,0.647907327431019,4508,-0.0477499275554873,719
"2852","4131431",0.558683069174991,7240,0.605496952309208,6736,-0.046813883134217,504
"2853","1231431",0.652537003604227,3098,0.677771366325915,3215,-0.0252343627216877,-117
"2854","2231431",0.589313831096039,5721,0.621396881685092,5864,-0.0320830505890533,-143
"2855","3231431",0.546199622282535,7891,0.592603048485312,7473,-0.0464034262027773,418
"2856","4231431",0.504725291581995,10017,0.550192673363502,9884,-0.0454673817815069,133
"2857","1331431",0.624557533327451,4152,0.650720798992617,4384,-0.0261632656651659,-232
"2858","2331431",0.561334360819262,7099,0.594346314351794,7382,-0.0330119535325315,-283
"2859","3331431",0.518220152005759,9337,0.565552481152014,9013,-0.0473323291462555,324
"2860","4331431",0.476745821305219,11388,0.523142106030204,11339,-0.0463962847249851,49
"2861","1431431",0.585621035342455,5909,0.610091295024511,6478,-0.0244702596820561,-569
"2862","2431431",0.522397862834266,9125,0.553716810383688,9702,-0.0313189475494218,-577
"2863","3431431",0.479283654020763,11255,0.524922977183909,11251,-0.0456393231631458,4
"2864","4431431",0.437809323320223,13023,0.482512602062098,13231,-0.0447032787418754,-208
"2865","1141431",0.657461216742394,2907,0.692677151144537,2654,-0.0352159344021432,253
"2866","2141431",0.594238044234205,5505,0.636302666503714,5108,-0.0420646222695088,397
"2867","3141431",0.551123835420702,7651,0.607508833303934,6630,-0.0563849978832328,1021
"2868","4141431",0.509649504720162,9771,0.565098458182124,9035,-0.0554489534619624,736
"2869","1241431",0.603503439149398,5063,0.637372872198831,5067,-0.0338694330494331,-4
"2870","2241431",0.540280266641209,8221,0.580998387558008,8133,-0.0407181209167987,88
"2871","3241431",0.497166057827706,10405,0.552204554358228,9787,-0.0550384965305227,618
"2872","4241431",0.455691727127166,12316,0.509794179236418,12035,-0.0541024521092524,281
"2873","1341431",0.575523968872622,6399,0.610322304865533,6468,-0.0347983359929114,-69
"2874","2341431",0.512300796364433,9658,0.55394782022471,9687,-0.041647023860277,-29
"2875","3341431",0.469186587550929,11734,0.52515398702493,11240,-0.055967399474001,494
"2876","4341431",0.427712256850389,13407,0.48274361190312,13224,-0.0550313550527306,183
"2877","1441431",0.536587470887626,8387,0.569692800897427,8791,-0.0331053300098015,-404
"2878","2441431",0.473364298379437,11553,0.513318316256604,11865,-0.0399540178771672,-312
"2879","3441431",0.430250089565933,13335,0.484524483056825,13159,-0.0542743934908912,176
"2880","4441431",0.388775758865394,14615,0.442114107935014,14655,-0.0533383490696208,-40
"2881","1112431",0.784721662467054,408,0.793791067848405,470,-0.00906940538135059,-62
"2882","2112431",0.721498489958865,1245,0.737416583207582,1364,-0.0159180932487162,-119
"2883","3112431",0.678384281145362,2278,0.708622750007802,2128,-0.0302384688624402,150
"2884","4112431",0.636909950444822,3676,0.666212374885992,3683,-0.0293024244411698,-7
"2885","1212431",0.730763884874058,1080,0.738486788902699,1343,-0.00772290402864051,-263
"2886","2212431",0.667540712365869,2586,0.682112304261875,3045,-0.0145715918960061,-459
"2887","3212431",0.624426503552366,4161,0.653318471062096,4270,-0.0288919675097301,-109
"2888","4212431",0.582952172851826,6048,0.610908095940286,6441,-0.0279559230884597,-393
"2889","1312431",0.702784414597282,1633,0.711436221569401,2033,-0.00865180697211876,-400
"2890","2312431",0.639561242089093,3576,0.655061736928577,4188,-0.0155004948394843,-612
"2891","3312431",0.59644703327559,5396,0.626267903728798,5604,-0.0298208704532084,-208
"2892","4312431",0.55497270257505,7450,0.583857528606988,7955,-0.028884826031938,-505
"2893","1412431",0.663847916612286,2703,0.670806717601295,3477,-0.00695880098900892,-774
"2894","2412431",0.600624744104097,5198,0.614432232960472,6240,-0.0138074888563746,-1042
"2895","3412431",0.557510535290594,7306,0.585638399760692,7854,-0.0281278644700986,-548
"2896","4412431",0.516036204590054,9471,0.543228024638882,10275,-0.0271918200488283,-804
"2897","1122431",0.716742391600634,1328,0.733221756190998,1460,-0.0164793645903638,-132
"2898","2122431",0.653519219092445,3057,0.676847271550175,3261,-0.0233280524577294,-204
"2899","3122431",0.610405010278942,4779,0.648053438350395,4501,-0.0376484280714534,278
"2900","4122431",0.568930679578402,6741,0.605643063228585,6727,-0.036712383650183,14
"2901","1222431",0.662784614007638,2735,0.677917477245292,3210,-0.0151328632376537,-475
"2902","2222431",0.599561441499449,5250,0.621542992604469,5856,-0.0219815511050193,-606
"2903","3222431",0.556447232685946,7375,0.592749159404689,7468,-0.0363019267187433,-93
"2904","4222431",0.514972901985406,9518,0.550338784282879,9875,-0.035365882297473,-357
"2905","1322431",0.634805143730862,3747,0.650866909911994,4375,-0.016061766181132,-628
"2906","2322431",0.571581971222673,6601,0.594492425271171,7372,-0.0229104540484976,-771
"2907","3322431",0.52846776240917,8814,0.565698592071391,9003,-0.0372308296622216,-189
"2908","4322431",0.48699343170863,10906,0.523288216949581,11330,-0.0362947852409512,-424
"2909","1422431",0.595868645745866,5431,0.610237405943888,6472,-0.0143687601980221,-1041
"2910","2422431",0.532645473237677,8589,0.553862921303065,9695,-0.0212174480653878,-1106
"2911","3422431",0.489531264424174,10769,0.525069088103285,11244,-0.0355378236791118,-475
"2912","4422431",0.448056933723634,12636,0.482658712981475,13229,-0.0346017792578415,-593
"2913","1132431",0.673409869435535,2405,0.694756663742969,2586,-0.0213467943074346,-181
"2914","2132431",0.610186696927346,4788,0.638382179102146,5024,-0.0281954821748002,-236
"2915","3132431",0.567072488113842,6841,0.609588345902366,6517,-0.0425158577885242,324
"2916","4132431",0.525598157413302,8974,0.567177970780556,8929,-0.0415798133672538,45
"2917","1232431",0.619452091842538,4364,0.639452384797263,4957,-0.0200002929547245,-593
"2918","2232431",0.55622891933435,7387,0.58307790015644,8014,-0.0268489808220901,-627
"2919","3232431",0.513114710520846,9618,0.55428406695666,9666,-0.0411693564358141,-48
"2920","4232431",0.471640379820306,11631,0.51187369183485,11941,-0.0402333120145437,-310
"2921","1332431",0.591472621565762,5610,0.612401817463965,6367,-0.0209291958982027,-757
"2922","2332431",0.528249449057573,8828,0.556027332823142,9573,-0.0277778837655683,-745
"2923","3332431",0.48513524024407,10990,0.527233499623362,11133,-0.0420982593792923,-143
"2924","4332431",0.44366090954353,12810,0.484823124501552,13148,-0.041162214958022,-338
"2925","1432431",0.552536123580766,7564,0.571772313495859,8671,-0.0192361899150929,-1107
"2926","2432431",0.489312951072577,10780,0.515397828855036,11754,-0.0260848777824586,-974
"2927","3432431",0.446198742259074,12708,0.486603995655257,13069,-0.0404052533961826,-361
"2928","4432431",0.404724411558534,14174,0.444193620533446,14598,-0.0394692089749121,-424
"2929","1142431",0.624376304980705,4164,0.654358169615885,4221,-0.02998186463518,-57
"2930","2142431",0.561153132472516,7113,0.597983684975062,7182,-0.0368305525025456,-69
"2931","3142431",0.518038923659013,9349,0.569189851775282,8822,-0.0511509281162696,527
"2932","4142431",0.476564592958473,11397,0.526779476653472,11155,-0.0502148836949993,242
"2933","1242431",0.570418527387709,6669,0.599053890670179,7114,-0.02863536328247,-445
"2934","2242431",0.50719535487952,9892,0.542679406029356,10308,-0.0354840511498355,-416
"2935","3242431",0.464081146066017,11953,0.513885572829576,11838,-0.0498044267635596,115
"2936","4242431",0.422606815365477,13593,0.471475197707766,13706,-0.0488683823422892,-113
"2937","1342431",0.542439057110933,8098,0.572003323336881,8659,-0.0295642662259482,-561
"2938","2342431",0.479215884602744,11259,0.515628838696058,11744,-0.0364129540933138,-485
"2939","3342431",0.43610167578924,13095,0.486835005496278,13059,-0.0507333297070378,36
"2940","4342431",0.394627345088701,14459,0.444424630374468,14588,-0.0497972852857673,-129
"2941","1442431",0.503502559125937,10091,0.531373819368775,10922,-0.0278712602428384,-831
"2942","2442431",0.440279386617748,12933,0.474999334727952,13552,-0.0347199481102041,-619
"2943","3442431",0.397165177804245,14381,0.446205501528173,14536,-0.049040323723928,-155
"2944","4442431",0.355690847103705,15339,0.403795126406362,15525,-0.0481042793026575,-186
"2945","1113431",0.745838486894569,844,0.768294477459166,796,-0.0224559905645972,48
"2946","2113431",0.68261531438638,2149,0.711919992818343,2015,-0.0293046784319628,134
"2947","3113431",0.639501105572876,3584,0.683126159618563,3007,-0.0436250540456868,577
"2948","4113431",0.598026774872336,5322,0.640715784496753,4885,-0.0426890096244164,437
"2949","1213431",0.691880709301573,1906,0.71299019851346,1984,-0.021109489211887,-78
"2950","2213431",0.628657536793384,3978,0.656615713872636,4127,-0.0279581770792526,-149
"2951","3213431",0.58554332797988,5917,0.627821880672857,5518,-0.0422785526929766,399
"2952","4213431",0.54406899727934,8015,0.585411505551046,7864,-0.0413425082717064,151
"2953","1313431",0.663901239024796,2700,0.685939631180162,2895,-0.0220383921553653,-195
"2954","2313431",0.600678066516607,5195,0.629565146539338,5431,-0.0288870800227309,-236
"2955","3313431",0.557563857703104,7298,0.600771313339559,7019,-0.0432074556364549,279
"2956","4313431",0.516089527002564,9465,0.558360938217749,9428,-0.0422714112151846,37
"2957","1413431",0.6249647410398,4131,0.645310127212056,4635,-0.0203453861722555,-504
"2958","2413431",0.561741568531612,7074,0.588935642571233,7662,-0.0271940740396212,-588
"2959","3413431",0.518627359718108,9303,0.560141809371453,9323,-0.0415144496533452,-20
"2960","4413431",0.477153029017568,11368,0.517731434249643,11629,-0.0405784052320749,-261
"2961","1123431",0.677859216028149,2292,0.707725165801759,2159,-0.0298659497736105,133
"2962","2123431",0.61463604351996,4571,0.651350681160936,4353,-0.036714637640976,218
"2963","3123431",0.571521834706456,6610,0.622556847961156,5809,-0.0510350132547001,801
"2964","4123431",0.530047504005916,8732,0.580146472839346,8185,-0.0500989688334296,547
"2965","1223431",0.623901438435153,4181,0.652420886856053,4306,-0.0285194484209003,-125
"2966","2223431",0.560678265926964,7136,0.59604640221523,7290,-0.0353681362882659,-154
"2967","3223431",0.51756405711346,9377,0.56725256901545,8926,-0.0496885119019899,451
"2968","4223431",0.47608972641292,11418,0.52484219389364,11256,-0.0487524674807196,162
"2969","1323431",0.595921968158376,5426,0.625370319522755,5649,-0.0294483513643785,-223
"2970","2323431",0.532698795650188,8586,0.568995834881932,8833,-0.0362970392317441,-247
"2971","3323431",0.489584586836684,10764,0.540202001682152,10465,-0.0506174148454681,299
"2972","4323431",0.448110256136144,12632,0.497791626560342,12588,-0.0496813704241978,44
"2973","1423431",0.55698547017338,7344,0.584740815554649,7905,-0.0277553453812687,-561
"2974","2423431",0.493762297665192,10556,0.528366330913826,11085,-0.0346040332486344,-529
"2975","3423431",0.450648088851688,12520,0.499572497714046,12520,-0.0489244088623584,0
"2976","4423431",0.409173758151148,14026,0.457162122592236,14174,-0.047988364441088,-148
"2977","1133431",0.634526693863049,3760,0.66926007335373,3552,-0.0347333794906811,208
"2978","2133431",0.57130352135486,6622,0.612885588712907,6339,-0.0415820673580467,283
"2979","3133431",0.528189312541357,8835,0.584091755513127,7944,-0.0559024429717707,891
"2980","4133431",0.486714981840817,10919,0.541681380391317,10377,-0.0549663985505005,542
"2981","1233431",0.580568916270053,6171,0.613955794408024,6272,-0.0333868781379711,-101
"2982","2233431",0.517345743761864,9394,0.557581309767201,9474,-0.0402355660053367,-80
"2983","3233431",0.47423153494836,11512,0.528787476567421,11064,-0.0545559416190607,448
"2984","4233431",0.432757204247821,13240,0.486377101445611,13078,-0.0536198971977903,162
"2985","1333431",0.552589445993277,7560,0.586905227074726,7785,-0.0343157810814494,-225
"2986","2333431",0.489366273485088,10777,0.530530742433903,10969,-0.041164468948815,-192
"2987","3333431",0.446252064671584,12704,0.501736909234123,12411,-0.055484844562539,293
"2988","4333431",0.404777733971045,14171,0.459326534112313,14112,-0.0545488001412684,59
"2989","1433431",0.513652948008281,9584,0.54627572310662,10095,-0.0326227750983396,-511
"2990","2433431",0.450429775500092,12525,0.489901238465797,12939,-0.0394714629657053,-414
"2991","3433431",0.407315566686588,14089,0.461107405266018,14047,-0.0537918385794292,42
"2992","4433431",0.365841235986049,15151,0.418697030144207,15224,-0.0528557941581586,-73
"2993","1143431",0.585493129408219,5925,0.628861579226646,5461,-0.0433684498184267,464
"2994","2143431",0.52226995690003,9135,0.572487094585823,8624,-0.0502171376857923,511
"2995","3143431",0.479155748086527,11266,0.543693261386043,10256,-0.0645375132995163,1010
"2996","4143431",0.437681417385987,13031,0.501282886264233,12431,-0.0636014688782458,600
"2997","1243431",0.531535351815223,8646,0.57355730028094,8571,-0.0420219484657165,75
"2998","2243431",0.468312179307035,11766,0.517182815640117,11657,-0.0488706363330821,109
"2999","3243431",0.425197970493531,13504,0.488388982440337,13006,-0.0631910119468061,498
"3000","4243431",0.383723639792991,14740,0.445978607318527,14543,-0.0622549675255357,197
"3001","1343431",0.503555881538447,10089,0.546506732947642,10085,-0.0429508514091947,4
"3002","2343431",0.440332709030258,12931,0.490132248306819,12928,-0.0497995392765603,3
"3003","3343431",0.397218500216755,14377,0.461338415107039,14040,-0.0641199148902842,337
"3004","4343431",0.355744169516215,15336,0.418928039985229,15219,-0.0631838704690139,117
"3005","1443431",0.464619383553451,11926,0.505877228979536,12208,-0.0412578454260849,-282
"3006","2443431",0.401396211045262,14266,0.449502744338713,14437,-0.0481065332934505,-171
"3007","3443431",0.358282002231759,15287,0.420708911138933,15186,-0.0624269089071744,101
"3008","4443431",0.316807671531219,15879,0.378298536017123,15884,-0.0614908644859041,-5
"3009","1114431",0.693631414923999,1856,0.72364386408551,1711,-0.0300124491615111,145
"3010","2114431",0.63040824241581,3900,0.667269379444687,3637,-0.0368611370288767,263
"3011","3114431",0.587294033602306,5816,0.638475546244907,5019,-0.0511815126426007,797
"3012","4114431",0.545819702901767,7919,0.596065171123097,7288,-0.0502454682213304,631
"3013","1214431",0.639673637331003,3572,0.668339585139804,3604,-0.028665947808801,-32
"3014","2214431",0.576450464822814,6362,0.61196510049898,6399,-0.0355146356761666,-37
"3015","3214431",0.53333625600931,8550,0.583171267299201,8003,-0.0498350112898907,547
"3016","4214431",0.49186192530877,10652,0.540760892177391,10435,-0.0488989668686203,217
"3017","1314431",0.611694167054227,4712,0.641289017806506,4857,-0.0295948507522793,-145
"3018","2314431",0.548470994546038,7764,0.584914533165683,7890,-0.0364435386196449,-126
"3019","3314431",0.505356785732534,9985,0.556120699965903,9565,-0.0507639142333689,420
"3020","4314431",0.463882455031994,11962,0.513710324844093,11843,-0.0498278698120985,119
"3021","1414431",0.57275766906923,6543,0.6006595138384,7025,-0.0279018447691695,-482
"3022","2414431",0.509534496561042,9775,0.544285029197577,10221,-0.0347505326365352,-446
"3023","3414431",0.466420287747538,11840,0.515491195997797,11748,-0.0490709082502592,92
"3024","4414431",0.424945957046998,13516,0.473080820875987,13642,-0.0481348638289888,-126
"3025","1124431",0.625652144057579,4091,0.663074552428103,3837,-0.0374224083705244,254
"3026","2124431",0.56242897154939,7041,0.60670006778728,6663,-0.0442710962378899,378
"3027","3124431",0.519314762735887,9266,0.5779062345875,8326,-0.058591471851614,940
"3028","4124431",0.477840432035347,11330,0.53549585946569,10711,-0.0576554274303436,619
"3029","1224431",0.571694366464583,6597,0.607770273482397,6617,-0.0360759070178143,-20
"3030","2224431",0.508471193956394,9826,0.551395788841574,9823,-0.0429245948851799,3
"3031","3224431",0.46535698514289,11884,0.522601955641794,11364,-0.0572449704989039,520
"3032","4224431",0.42388265444235,13550,0.480191580519984,13327,-0.0563089260776335,223
"3033","1324431",0.543714896187807,8027,0.580719706149099,8149,-0.0370048099612925,-122
"3034","2324431",0.480491723679618,11199,0.524345221508276,11281,-0.0438534978286581,-82
"3035","3324431",0.437377514866114,13041,0.495551388308496,12690,-0.0581738734423821,351
"3036","4324431",0.395903184165574,14418,0.453141013186686,14307,-0.0572378290211116,111
"3037","1424431",0.504778398202811,10015,0.540090202180993,10469,-0.0353118039781827,-454
"3038","2424431",0.441555225694622,12881,0.48371571754017,13194,-0.0421604918455484,-313
"3039","3424431",0.398441016881118,14337,0.454921884340391,14252,-0.0564808674592723,85
"3040","4424431",0.356966686180578,15312,0.41251150921858,15353,-0.0555448230380018,-41
"3041","1134431",0.582319621892479,6078,0.624609459980074,5689,-0.0422898380875951,389
"3042","2134431",0.51909644938429,9280,0.568234975339251,8876,-0.0491385259549607,404
"3043","3134431",0.475982240570787,11427,0.539441142139472,10505,-0.0634589015686847,922
"3044","4134431",0.434507909870247,13167,0.497030767017661,12618,-0.0625228571474143,549
"3045","1234431",0.528361844299483,8820,0.569305181034368,8815,-0.040943336734885,5
"3046","2234431",0.465138671791294,11901,0.512930696393545,11882,-0.0477920246022506,19
"3047","3234431",0.422024462977791,13611,0.484136863193765,13176,-0.0621124002159746,435
"3048","4234431",0.380550132277251,14823,0.441726488071955,14664,-0.0611763557947042,159
"3049","1334431",0.500382374022707,10243,0.54225461370107,10338,-0.0418722396783633,-95
"3050","2334431",0.437159201514518,13051,0.485880129060247,13101,-0.0487209275457289,-50
"3051","3334431",0.394044992701015,14477,0.457086295860467,14178,-0.0630413031594528,299
"3052","4334431",0.352570662000475,15398,0.414675920738657,15309,-0.0621052587381823,89
"3053","1434431",0.461445876037711,12071,0.501625109732964,12418,-0.0401792336952534,-347
"3054","2434431",0.398222703529522,14345,0.445250625092141,14566,-0.047027921562619,-221
"3055","3434431",0.355108494716019,15347,0.416456791892362,15271,-0.0613482971763429,76
"3056","4434431",0.313634164015479,15917,0.374046416770551,15933,-0.0604122527550727,-16
"3057","1144431",0.53328605743765,8558,0.58421096585299,7938,-0.0509249084153406,620
"3058","2144431",0.470062884929461,11690,0.527836481212167,11106,-0.0577735962827062,584
"3059","3144431",0.426948676115957,13443,0.499042648012388,12549,-0.0720939718964302,894
"3060","4144431",0.385474345415417,14697,0.456632272890577,14191,-0.0711579274751597,506
"3061","1244431",0.479328279844654,11252,0.528906686907284,11057,-0.0495784070626305,195
"3062","2244431",0.416105107336465,13811,0.472532202266461,13666,-0.0564270949299961,145
"3063","3244431",0.372990898522961,14986,0.443738369066681,14613,-0.07074747054372,373
"3064","4244431",0.331516567822421,15709,0.401327993944871,15575,-0.0698114261224495,134
"3065","1344431",0.451348809567877,12487,0.501856119573986,12403,-0.0505073100061088,84
"3066","2344431",0.388125637059689,14631,0.445481634933163,14558,-0.0573559978734742,73
"3067","3344431",0.345011428246185,15511,0.416687801733383,15265,-0.0716763734871981,246
"3068","4344431",0.303537097545645,16008,0.374277426611573,15930,-0.0707403290659279,78
"3069","1444431",0.412412311582881,13926,0.46122661560588,14042,-0.0488143040229988,-116
"3070","2444431",0.349189139074693,15450,0.404852130965057,15509,-0.0556629918903644,-59
"3071","3444431",0.306074930261189,15989,0.376058297765278,15912,-0.0699833675040885,77
"3072","4444431",0.264600599560649,16239,0.333647922643467,16230,-0.0690473230828181,9
"3073","1111141",0.880843535717084,44,0.890231439780753,43,-0.00938790406366841,1
"3074","2111141",0.817620363208895,208,0.833856955139929,199,-0.016236591931034,9
"3075","3111141",0.774506154395392,509,0.80506312194015,381,-0.030556967544758,128
"3076","4111141",0.733031823694852,1041,0.76265274681834,897,-0.0296209231234875,144
"3077","1211141",0.826885758124088,172,0.834927160835046,189,-0.00804140271095821,-17
"3078","2211141",0.763662585615899,624,0.778552676194223,657,-0.0148900905783238,-33
"3079","3211141",0.720548376802396,1267,0.749758842994444,1106,-0.0292104661920478,161
"3080","4211141",0.679074046101856,2254,0.707348467872633,2168,-0.0282744217707775,86
"3081","1311141",0.798906287847312,321,0.807876593501749,357,-0.00897030565443646,-36
"3082","2311141",0.735683115339123,1001,0.751502108860925,1072,-0.015818993521802,-71
"3083","3311141",0.69256890652562,1892,0.722708275661146,1734,-0.0301393691355261,158
"3084","4311141",0.65109457582508,3152,0.680297900539335,3123,-0.0292033247142558,29
"3085","1411141",0.759969789862316,670,0.767247089533643,818,-0.00727729967132662,-148
"3086","2411141",0.696746617354127,1784,0.71087260489282,2057,-0.0141259875386923,-273
"3087","3411141",0.653632408540624,3050,0.68207877169304,3048,-0.0284463631524163,2
"3088","4411141",0.612158077840084,4700,0.63966839657123,4939,-0.0275103187311461,-239
"3089","1121141",0.812864264850664,234,0.829662128123346,221,-0.0167978632726816,13
"3090","2121141",0.749641092342475,791,0.773287643482523,723,-0.0236465511400472,68
"3091","3121141",0.706526883528972,1557,0.744493810282743,1219,-0.0379669267537712,338
"3092","4121141",0.665052552828432,2658,0.702083435160933,2356,-0.0370308823325007,302
"3093","1221141",0.758906487257668,680,0.77435784917764,709,-0.0154513619199714,-29
"3094","2221141",0.695683314749479,1805,0.717983364536816,1864,-0.022300049787337,-59
"3095","3221141",0.652569105935976,3097,0.689189531337037,2767,-0.036620425401061,330
"3096","4221141",0.611094775235436,4752,0.646779156215227,4572,-0.0356843809797908,180
"3097","1321141",0.730927016980892,1077,0.747307281844342,1162,-0.0163802648634497,-85
"3098","2321141",0.667703844472703,2581,0.690932797203519,2711,-0.0232289527308153,-130
"3099","3321141",0.6245896356592,4150,0.662138964003739,3873,-0.0375493283445393,277
"3100","4321141",0.58311530495866,6043,0.619728588881929,5957,-0.036613283923269,86
"3101","1421141",0.691990518995896,1903,0.706677777876236,2199,-0.0146872588803398,-296
"3102","2421141",0.628767346487707,3974,0.650303293235413,4409,-0.0215359467477055,-435
"3103","3421141",0.585653137674204,5907,0.621509460035633,5857,-0.0358563223614295,50
"3104","4421141",0.544178806973664,8009,0.579099084913823,8250,-0.0349202779401593,-241
"3105","1131141",0.769531742685565,561,0.791197035675317,500,-0.0216652929897523,61
"3106","2131141",0.706308570177376,1564,0.734822551034494,1424,-0.0285139808571179,140
"3107","3131141",0.663194361363872,2727,0.706028717834714,2217,-0.0428343564708419,510
"3108","4131141",0.621720030663332,4266,0.663618342712904,3813,-0.0418983120495716,453
"3109","1231141",0.715573965092569,1359,0.735892756729611,1402,-0.0203187916370423,-43
"3110","2231141",0.65235079258438,3110,0.679518272088788,3157,-0.0271674795044079,-47
"3111","3231141",0.609236583770876,4839,0.650724438889008,4383,-0.0414878551181319,456
"3112","4231141",0.567762253070336,6811,0.608314063767198,6588,-0.0405518106968614,223
"3113","1331141",0.687594494815792,2007,0.708842189396313,2119,-0.0212476945805206,-112
"3114","2331141",0.624371322307604,4165,0.65246770475549,4303,-0.0280963824478861,-138
"3115","3331141",0.5812571134941,6135,0.62367387155571,5746,-0.0424167580616102,389
"3116","4331141",0.53978278279356,8241,0.5812634964339,8119,-0.0414807136403397,122
"3117","1431141",0.648657996830796,3238,0.668212685428207,3612,-0.0195546885974107,-374
"3118","2431141",0.585434824322608,5930,0.611838200787384,6406,-0.0264033764647764,-476
"3119","3431141",0.542320615509104,8105,0.583044367587604,8017,-0.0407237520785004,88
"3120","4431141",0.500846284808564,10221,0.540633992465794,10444,-0.0397877076572299,-223
"3121","1141141",0.720498178230735,1268,0.750798541548233,1087,-0.0303003633174979,181
"3122","2141141",0.657275005722546,2915,0.69442405690741,2594,-0.0371490511848634,321
"3123","3141141",0.614160796909043,4604,0.66563022370763,3712,-0.0514694267985875,892
"3124","4141141",0.572686466208503,6546,0.62321984858582,5770,-0.050533382377317,776
"3125","1241141",0.666540400637739,2613,0.695494262602527,2556,-0.0289538619647877,57
"3126","2241141",0.60331722812955,5076,0.639119777961703,4977,-0.0358025498321533,99
"3127","3241141",0.560203019316047,7166,0.610325944761924,6467,-0.0501229254458773,699
"3128","4241141",0.518728688615507,9295,0.567915569640114,8891,-0.049186881024607,404
"3129","1341141",0.638560930360963,3615,0.668443695269229,3595,-0.0298827649082659,20
"3130","2341141",0.575337757852774,6411,0.612069210628406,6387,-0.0367314527756315,24
"3131","3341141",0.532223549039271,8609,0.583275377428626,7995,-0.0510518283893555,614
"3132","4341141",0.490749218338731,10696,0.540865002306816,10430,-0.0501157839680852,266
"3133","1441141",0.599624432375967,5247,0.627814191301123,5519,-0.0281897589251561,-272
"3134","2441141",0.536401259867778,8405,0.5714397066603,8699,-0.0350384467925218,-294
"3135","3441141",0.493287051054275,10581,0.54264587346052,10309,-0.0493588224062458,272
"3136","4441141",0.451812720353735,12468,0.50023549833871,12483,-0.0484227779849755,-15
"3137","1112141",0.847758623955395,102,0.851912458252101,117,-0.00415383429670524,-15
"3138","2112141",0.784535451447206,414,0.795537973611277,461,-0.0110025221640708,-47
"3139","3112141",0.741421242633703,903,0.766744140411498,828,-0.0253228977777948,75
"3140","4112141",0.699946911933163,1694,0.724333765289688,1690,-0.0243868533565244,4
"3141","1212141",0.793800846362399,352,0.796608179306394,447,-0.00280733294399504,-95
"3142","2212141",0.73057767385421,1088,0.740233694665571,1315,-0.00965602081136063,-227
"3143","3212141",0.687463465040707,2013,0.711439861465792,2032,-0.0239763964250846,-19
"3144","4212141",0.645989134340167,3332,0.669029486343981,3564,-0.0230403520038144,-232
"3145","1312141",0.765821376085623,597,0.769557611973096,778,-0.00373623588747329,-181
"3146","2312141",0.702598203577434,1642,0.713183127332273,1979,-0.0105849237548389,-337
"3147","3312141",0.659483994763931,2830,0.684389294132494,2951,-0.0249052993685629,-121
"3148","4312141",0.618009664063391,4424,0.641978919010683,4816,-0.0239692549472926,-392
"3149","1412141",0.726884878100627,1142,0.728928108004991,1564,-0.00204322990436345,-422
"3150","2412141",0.663661705592438,2712,0.672553623364167,3419,-0.00889191777172915,-707
"3151","3412141",0.620547496778935,4311,0.643759790164388,4717,-0.0232122933854532,-406
"3152","4412141",0.579073166078395,6252,0.601349415042578,6975,-0.0222762489641829,-723
"3153","1122141",0.779779353088975,454,0.791343146594694,499,-0.0115637935057185,-45
"3154","2122141",0.716556180580787,1335,0.73496866195387,1420,-0.018412481373084,-85
"3155","3122141",0.673441971767283,2403,0.706174828754091,2211,-0.0327328569868081,192
"3156","4122141",0.631967641066743,3845,0.663764453632281,3806,-0.0317968125655376,39
"3157","1222141",0.725821575495979,1165,0.736038867648988,1399,-0.0102172921530083,-234
"3158","2222141",0.66259840298779,2745,0.679664383008164,3155,-0.0170659800203738,-410
"3159","3222141",0.619484194174287,4362,0.650870549808385,4374,-0.0313863556340979,-12
"3160","4222141",0.578009863473747,6295,0.608460174686575,6585,-0.0304503112128276,-290
"3161","1322141",0.697842105219203,1746,0.70898830031569,2114,-0.0111461950964865,-368
"3162","2322141",0.634618932711014,3755,0.652613815674866,4298,-0.0179948829638521,-543
"3163","3322141",0.591504723897511,5606,0.623819982475087,5735,-0.0323152585775761,-129
"3164","4322141",0.550030393196971,7703,0.581409607353277,8111,-0.0313792141563058,-408
"3165","1422141",0.658905607234207,2853,0.668358796347584,3603,-0.00945318911337667,-750
"3166","2422141",0.595682434726018,5441,0.611984311706761,6397,-0.0163018769807424,-956
"3167","3422141",0.552568225912515,7562,0.583190478506981,8002,-0.0306222525944664,-440
"3168","4422141",0.511093895211975,9716,0.540780103385171,10434,-0.0296862081731961,-718
"3169","1132141",0.736446830923876,988,0.752878054146665,1041,-0.0164312232227891,-53
"3170","2132141",0.673223658415687,2413,0.696503569505842,2524,-0.0232799110901547,-111
"3171","3132141",0.630109449602184,3911,0.667709736306062,3621,-0.0376002867038787,290
"3172","4132141",0.588635118901643,5750,0.625299361184252,5653,-0.0366642422826085,97
"3173","1232141",0.68248905333088,2157,0.697573775200959,2484,-0.0150847218700791,-327
"3174","2232141",0.619265880822691,4375,0.641199290560135,4864,-0.0219334097374447,-489
"3175","3232141",0.576151672009187,6379,0.612405457360356,6366,-0.0362537853511687,13
"3176","4232141",0.534677341308647,8479,0.569995082238546,8774,-0.0353177409298983,-295
"3177","1332141",0.654509583054103,3012,0.670523207867661,3486,-0.0160136248135574,-474
"3178","2332141",0.591286410545915,5620,0.614148723226838,6259,-0.022862312680923,-639
"3179","3332141",0.548172201732411,7782,0.585354890027058,7866,-0.037182688294647,-84
"3180","4332141",0.506697871031871,9919,0.542944514905248,10288,-0.0362466438733765,-369
"3181","1432141",0.615573085069107,4519,0.629893703899555,5415,-0.0143206188304476,-896
"3182","2432141",0.552349912560919,7578,0.573519219258732,8573,-0.0211693066978133,-995
"3183","3432141",0.509235703747415,9788,0.544725386058952,10192,-0.0354896823115373,-404
"3184","4432141",0.467761373046875,11786,0.502315010937142,12378,-0.0345536378902668,-592
"3185","1142141",0.687413266469046,2014,0.712479560019581,1993,-0.0250662935505347,21
"3186","2142141",0.624190093960857,4173,0.656105075378758,4140,-0.0319149814179003,33
"3187","3142141",0.581075885147354,6143,0.627311242178978,5543,-0.0462353570316243,600
"3188","4142141",0.539601554446814,8249,0.584900867057168,7891,-0.0452993126103538,358
"3189","1242141",0.63345548887605,3796,0.657175281073875,4097,-0.0237197921978245,-301
"3190","2242141",0.570232316367861,6680,0.600800796433051,7016,-0.0305684800651901,-336
"3191","3242141",0.527118107554358,8897,0.572006963233272,8657,-0.0448888556789141,240
"3192","4242141",0.485643776853818,10970,0.529596588111462,11025,-0.0439528112576438,-55
"3193","1342141",0.605476018599274,4988,0.630124713740577,5405,-0.0246486951413027,-417
"3194","2342141",0.542252846091085,8108,0.573750229099753,8558,-0.0314973830086683,-450
"3195","3342141",0.499138637277582,10310,0.544956395899974,10173,-0.0458177586223924,137
"3196","4342141",0.457664306577042,12236,0.502546020778164,12365,-0.044881714201122,-129
"3197","1442141",0.566539520614278,6859,0.589495209772471,7636,-0.0229556891581929,-777
"3198","2442141",0.503316348106089,10101,0.533120725131648,10840,-0.0298043770255586,-739
"3199","3442141",0.460202139292586,12131,0.504326891931868,12280,-0.0441247526392827,-149
"3200","4442141",0.418727808592046,13733,0.461916516810058,14017,-0.0431887082180123,-284
"3201","1113141",0.80887544838291,256,0.826415867862862,238,-0.0175404194799519,18
"3202","2113141",0.745652275874721,850,0.770041383222038,774,-0.0243891073473175,76
"3203","3113141",0.702538067061217,1643,0.741247550022259,1285,-0.0387094829610415,358
"3204","4113141",0.661063736360678,2783,0.698837174900448,2446,-0.037773438539771,337
"3205","1213141",0.754917670789914,722,0.771111588917155,755,-0.0161939181272417,-33
"3206","2213141",0.691694498281725,1919,0.714737104276332,1943,-0.0230426059946073,-24
"3207","3213141",0.648580289468221,3244,0.685943271076553,2893,-0.0373629816083313,351
"3208","4213141",0.607105958767681,4927,0.643532895954742,4732,-0.036426937187061,195
"3209","1313141",0.726938200513138,1141,0.744061021583857,1230,-0.0171228210707199,-89
"3210","2313141",0.663715028004949,2710,0.687686536943034,2822,-0.0239715089380855,-112
"3211","3313141",0.620600819191445,4307,0.658892703743255,4017,-0.0382918845518095,290
"3212","4313141",0.579126488490905,6251,0.616482328621444,6142,-0.0373558401305393,109
"3213","1413141",0.688001702528142,1995,0.703431517615752,2299,-0.0154298150876101,-304
"3214","2413141",0.624778530019953,4141,0.647057032974928,4555,-0.0222785029549758,-414
"3215","3413141",0.581664321206449,6107,0.618263199775149,6034,-0.0365988785686998,73
"3216","4413141",0.540189990505909,8222,0.575852824653339,8435,-0.0356628341474295,-213
"3217","1123141",0.74089617751649,910,0.765846556205455,847,-0.0249503786889651,63
"3218","2123141",0.677673005008301,2299,0.709472071564632,2101,-0.0317990665563307,198
"3219","3123141",0.634558796194797,3759,0.680678238364852,3104,-0.0461194421700547,655
"3220","4123141",0.593084465494258,5549,0.638267863243042,5028,-0.0451833977487842,521
"3221","1223141",0.686938399923494,2026,0.710542277259749,2069,-0.0236038773362549,-43
"3222","2223141",0.623715227415305,4194,0.654167792618925,4232,-0.0304525652036205,-38
"3223","3223141",0.580601018601801,6170,0.625373959419146,5648,-0.0447729408173445,522
"3224","4223141",0.539126687901261,8272,0.582963584297336,8023,-0.0438368963960742,249
"3225","1323141",0.658958929646718,2850,0.683491709926451,2987,-0.0245327802797332,-137
"3226","2323141",0.595735757138529,5438,0.627117225285627,5555,-0.0313814681470987,-117
"3227","3323141",0.552621548325025,7558,0.598323392085848,7155,-0.0457018437608228,403
"3228","4323141",0.511147217624485,9711,0.555913016964038,9583,-0.0447657993395525,128
"3229","1423141",0.620022431661722,4333,0.642862205958345,4772,-0.0228397742966233,-439
"3230","2423141",0.556799259153533,7352,0.586487721317522,7808,-0.029688462163989,-456
"3231","3423141",0.513685050340029,9583,0.557693888117742,9465,-0.044008837777713,118
"3232","4423141",0.472210719639489,11608,0.515283512995932,11760,-0.0430727933564427,-152
"3233","1133141",0.69756365535139,1753,0.727381463757426,1601,-0.0298178084060358,152
"3234","2133141",0.634340482843201,3768,0.671006979116603,3472,-0.0366664962734013,296
"3235","3133141",0.591226274029698,5621,0.642213145916823,4803,-0.0509868718871254,818
"3236","4133141",0.549751943329158,7711,0.599802770795013,7066,-0.0500508274658551,645
"3237","1233141",0.643605877758394,3408,0.67207718481172,3434,-0.0284713070533258,-26
"3238","2233141",0.580382705250205,6184,0.615702700170896,6178,-0.0353199949206914,6
"3239","3233141",0.537268496436702,8357,0.586908866971117,7784,-0.0496403705344154,573
"3240","4233141",0.495794165736162,10459,0.544498491849307,10207,-0.0487043261131448,252
"3241","1333141",0.615626407481618,4517,0.645026617478422,4653,-0.029400209996804,-136
"3242","2333141",0.552403234973429,7575,0.588652132837599,7677,-0.0362488978641696,-102
"3243","3333141",0.509289026159925,9786,0.559858299637819,9346,-0.0505692734778936,440
"3244","4333141",0.467814695459386,11785,0.517447924516009,11643,-0.0496332290566231,142
"3245","1433141",0.576689909496622,6348,0.604397113510316,6812,-0.0277072040136942,-464
"3246","2433141",0.513466736988433,9596,0.548022628869493,10008,-0.0345558918810599,-412
"3247","3433141",0.47035252817493,11674,0.519228795669713,11546,-0.0488762674947839,128
"3248","4433141",0.42887819747439,13380,0.476818420547903,13479,-0.0479402230735134,-99
"3249","1143141",0.64853009089656,3245,0.686982969630342,2854,-0.0384528787337813,391
"3250","2143141",0.585306918388372,5938,0.630608484989519,5375,-0.0453015666011469,563
"3251","3143141",0.542192709574868,8112,0.601814651789739,6943,-0.0596219422148709,1169
"3252","4143141",0.500718378874328,10225,0.559404276667929,9366,-0.0586858977936005,859
"3253","1243141",0.594572313303565,5490,0.631678690684636,5333,-0.0371063773810711,157
"3254","2243141",0.531349140795376,8664,0.575304206043812,8471,-0.0439550652484367,193
"3255","3243141",0.488234931981872,10844,0.546510372844033,10084,-0.0582754408621607,760
"3256","4243141",0.446760601281332,12692,0.504099997722223,12295,-0.0573393964408904,397
"3257","1343141",0.566592843026788,6858,0.604628123351338,6797,-0.0380352803245494,61
"3258","2343141",0.5033696705186,10099,0.548253638710514,9996,-0.044883968191915,103
"3259","3343141",0.460255461705096,12126,0.519459805510735,11530,-0.0592043438056389,596
"3260","4343141",0.418781131004556,13732,0.477049430388925,13469,-0.0582682993843687,263
"3261","1443141",0.527656345041792,8860,0.563998619383232,9108,-0.0363422743414396,-248
"3262","2443141",0.464433172533604,11935,0.507624134742409,12135,-0.0431909622088052,-200
"3263","3443141",0.4213189637201,13637,0.478830301542629,13381,-0.0575113378225292,256
"3264","4443141",0.37984463301956,14844,0.436419926420819,14805,-0.0565752934012589,39
"3265","1114141",0.75666837641234,705,0.781765254489206,616,-0.0250968780768657,89
"3266","2114141",0.693445203904151,1865,0.725390769848382,1662,-0.0319455659442313,203
"3267","3114141",0.650330995090648,3180,0.696596936648603,2522,-0.0462659415579553,658
"3268","4114141",0.608856664390108,4854,0.654186561526793,4231,-0.045329897136685,623
"3269","1214141",0.702710598819344,1637,0.7264609755435,1627,-0.0237503767241557,10
"3270","2214141",0.639487426311155,3587,0.670086490902676,3505,-0.0305990645915213,82
"3271","3214141",0.596373217497651,5403,0.641292657702897,4856,-0.0449194402052453,547
"3272","4214141",0.554898886797112,7454,0.598882282581086,7119,-0.0439833957839748,335
"3273","1314141",0.674731128542568,2374,0.699410408210202,2427,-0.0246792796676339,-53
"3274","2314141",0.611507956034379,4729,0.643035923569378,4757,-0.0315279675349995,-28
"3275","3314141",0.568393747220875,6773,0.614242090369599,6256,-0.0458483431487235,517
"3276","4314141",0.526919416520335,8910,0.571831715247789,8667,-0.0449122987274531,243
"3277","1414141",0.635794630557572,3720,0.658780904242096,4022,-0.0229862736845241,-302
"3278","2414141",0.572571458049383,6559,0.602406419601273,6909,-0.0298349615518898,-350
"3279","3414141",0.529457249235879,8762,0.573612586401493,8566,-0.0441553371656138,196
"3280","4414141",0.487982918535339,10857,0.531202211279683,10930,-0.0432192927443434,-73
"3281","1124141",0.68868910554592,1981,0.721195942831799,1776,-0.0325068372858789,205
"3282","2124141",0.625465933037731,4108,0.664821458190976,3757,-0.0393555251532445,351
"3283","3124141",0.582351724224228,6074,0.636027624991196,5123,-0.0536759007669685,951
"3284","4124141",0.540877393523688,8185,0.593617249869386,7428,-0.0527398563456982,757
"3285","1224141",0.634731327952924,3749,0.665891663886093,3701,-0.0311603359331689,48
"3286","2224141",0.571508155444735,6611,0.60951717924527,6523,-0.0380090238005345,88
"3287","3224141",0.528393946631232,8818,0.58072334604549,8148,-0.0523293994142585,670
"3288","4224141",0.486919615930692,10910,0.53831297092368,10563,-0.0513933549929881,347
"3289","1324141",0.606751857676148,4942,0.638841096552795,4997,-0.0320892388766472,-55
"3290","2324141",0.543528685167959,8039,0.582466611911972,8054,-0.0389379267440128,-15
"3291","3324141",0.500414476354455,10240,0.553672778712192,9705,-0.0532583023577368,535
"3292","4324141",0.458940145653915,12194,0.511262403590382,11974,-0.0523222579364663,220
"3293","1424141",0.567815359691152,6810,0.598211592584689,7166,-0.0303962328935373,-356
"3294","2424141",0.504592187182963,10029,0.541837107943866,10367,-0.037244920760903,-338
"3295","3424141",0.461477978369459,12068,0.513043274744086,11875,-0.051565296374627,193
"3296","4424141",0.420003647668919,13693,0.470632899622276,13737,-0.0506292519533566,-44
"3297","1134141",0.64535658338082,3356,0.68273085038377,3016,-0.0373742670029498,340
"3298","2134141",0.582133410872631,6093,0.626356365742947,5598,-0.0442229548703154,495
"3299","3134141",0.539019202059128,8278,0.597562532543167,7206,-0.0585433304840394,1072
"3300","4134141",0.497544871358588,10389,0.555152157421357,9617,-0.0576072860627689,772
"3301","1234141",0.591398805787824,5612,0.627426571438064,5538,-0.0360277656502396,74
"3302","2234141",0.528175633279635,8836,0.571052086797241,8725,-0.0428764535176052,111
"3303","3234141",0.485061424466132,10993,0.542258253597461,10337,-0.0571968291313292,656
"3304","4234141",0.443587093765592,12813,0.499847878475651,12505,-0.0562607847100589,308
"3305","1334141",0.563419335511048,6994,0.600376004104766,7041,-0.0369566685937178,-47
"3306","2334141",0.500196163002859,10260,0.544001519463943,10236,-0.0438053564610834,24
"3307","3334141",0.457081954189356,12258,0.515207686264163,11766,-0.0581257320748075,492
"3308","4334141",0.415607623488816,13830,0.472797311142353,13658,-0.0571896876535371,172
"3309","1434141",0.524482837526052,9020,0.55974650013666,9355,-0.035263662610608,-335
"3310","2434141",0.461259665017863,12087,0.503372015495837,12329,-0.0421123504779737,-242
"3311","3434141",0.41814545620436,13747,0.474578182296058,13573,-0.0564327260916977,174
"3312","4434141",0.37667112550382,14915,0.432167807174247,14926,-0.0554966816704274,-11
"3313","1144141",0.596323018925991,5406,0.642332356256686,4798,-0.0460093373306951,608
"3314","2144141",0.533099846417802,8572,0.585957871615863,7838,-0.0528580251980607,734
"3315","3144141",0.489985637604299,10747,0.557164038416083,9504,-0.0671784008117848,1243
"3316","4144141",0.448511306903759,12617,0.514753663294273,11793,-0.0662423563905144,824
"3317","1244141",0.542365241332995,8102,0.58702807731098,7772,-0.0446628359779851,330
"3318","2244141",0.479142068824806,11267,0.530653592670157,10959,-0.0515115238453507,308
"3319","3244141",0.436027860011302,13099,0.501859759470377,12402,-0.0658318994590747,697
"3320","4244141",0.394553529310762,14463,0.459449384348567,14103,-0.0648958550378043,360
"3321","1344141",0.514385771056219,9543,0.559977509977682,9336,-0.0455917389214634,207
"3322","2344141",0.45116259854803,12500,0.503603025336859,12316,-0.0524404267888289,184
"3323","3344141",0.408048389734526,14060,0.474809192137079,13561,-0.0667608024025529,499
"3324","4344141",0.366574059033986,15135,0.432398817015269,14919,-0.0658247579812826,216
"3325","1444141",0.475449273071223,11447,0.519348006009576,11539,-0.0438987329383535,-92
"3326","2444141",0.412226100563034,13934,0.462973521368753,13979,-0.0507474208057192,-45
"3327","3444141",0.36911189174953,15069,0.434179688168973,14863,-0.0650677964194433,206
"3328","4444141",0.32763756104899,15766,0.391769313047163,15706,-0.0641317519981729,60
"3329","1111241",0.834994701568874,142,0.844896593125971,145,-0.00990189155709664,-3
"3330","2111241",0.771771529060685,530,0.788522108485147,539,-0.0167505794244622,-9
"3331","3111241",0.728657320247182,1111,0.759728275285368,937,-0.0310709550381862,174
"3332","4111241",0.687182989546642,2021,0.717317900163558,1880,-0.0301349106169158,141
"3333","1211241",0.781036923975878,442,0.789592314180265,522,-0.00855539020438645,-80
"3334","2211241",0.717813751467689,1311,0.733217829539441,1461,-0.015404078071752,-150
"3335","3211241",0.674699542654186,2376,0.704423996339662,2265,-0.029724453685476,111
"3336","4211241",0.633225211953646,3802,0.662013621217851,3880,-0.0287884092642058,-78
"3337","1311241",0.753057453699102,745,0.762541746846967,899,-0.0094842931478647,-154
"3338","2311241",0.689834281190913,1950,0.706167262206143,2213,-0.0163329810152303,-263
"3339","3311241",0.64672007237741,3310,0.677373429006364,3233,-0.0306533566289543,77
"3340","4311241",0.60524574167687,4998,0.634963053884554,5182,-0.029717312207684,-184
"3341","1411241",0.714120955714106,1383,0.721912242878861,1754,-0.00779128716475486,-371
"3342","2411241",0.650897783205917,3158,0.665537758238038,3719,-0.0146399750321206,-561
"3343","3411241",0.607783574392414,4900,0.636743925038258,5088,-0.0289603506458446,-188
"3344","4411241",0.566309243691874,6873,0.594333549916448,7384,-0.0280243062245743,-511
"3345","1121241",0.767015430702454,582,0.784327281468564,585,-0.0173118507661099,-3
"3346","2121241",0.703792258194265,1616,0.727952796827741,1589,-0.0241605386334754,27
"3347","3121241",0.660678049380762,2794,0.699158963627961,2435,-0.0384809142471995,359
"3348","4121241",0.619203718680222,4378,0.656748588506151,4115,-0.037544869825929,263
"3349","1221241",0.713057653109458,1405,0.729023002522858,1557,-0.0159653494133997,-152
"3350","2221241",0.649834480601269,3197,0.672648517882035,3412,-0.0228140372807653,-215
"3351","3221241",0.606720271787766,4944,0.643854684682255,4710,-0.0371344128944893,234
"3352","4221241",0.565245941087226,6924,0.601444309560445,6966,-0.036198368473219,-42
"3353","1321241",0.685078182832682,2077,0.70197243518956,2360,-0.0168942523568779,-283
"3354","2321241",0.621855010324493,4263,0.645597950548737,4626,-0.0237429402242435,-363
"3355","3321241",0.57874080151099,6266,0.616804117348957,6121,-0.0380633158379675,145
"3356","4321241",0.53726647081045,8358,0.574393742227147,8527,-0.0371272714166972,-169
"3357","1421241",0.646141684847686,3327,0.661342931221454,3920,-0.0152012463737681,-593
"3358","2421241",0.582918512339497,6049,0.604968446580631,6776,-0.0220499342411338,-727
"3359","3421241",0.539804303525994,8239,0.576174613380851,8417,-0.0363703098548578,-178
"3360","4421241",0.498329972825454,10344,0.533764238259041,10808,-0.0354342654335875,-464
"3361","1131241",0.723682908537355,1198,0.745862189020535,1190,-0.0221792804831805,8
"3362","2131241",0.660459736029166,2802,0.689487704379712,2760,-0.0290279683505461,42
"3363","3131241",0.617345527215662,4454,0.660693871179932,3943,-0.0433483439642701,511
"3364","4131241",0.575871196515122,6390,0.618283496058122,6031,-0.0424122995429999,359
"3365","1231241",0.669725130944358,2511,0.690557910074829,2727,-0.0208327791304705,-216
"3366","2231241",0.60650195843617,4953,0.634183425434006,5225,-0.0276814669978361,-272
"3367","3231241",0.563387749622666,6995,0.605389592234226,6744,-0.0420018426115601,251
"3368","4231241",0.521913418922126,9152,0.562979217112416,9161,-0.0410657981902897,-9
"3369","1331241",0.641745660667582,3495,0.663507342741531,3815,-0.0217616820739488,-320
"3370","2331241",0.578522488159393,6273,0.607132858100708,6644,-0.0286103699413144,-371
"3371","3331241",0.53540827934589,8446,0.578339024900928,8299,-0.0429307455550384,147
"3372","4331241",0.49393394864535,10547,0.535928649779118,10688,-0.041994701133768,-141
"3373","1431241",0.602809162682586,5097,0.622877838773425,5789,-0.020068676090839,-692
"3374","2431241",0.539585990174397,8250,0.566503354132602,8966,-0.0269173639582047,-716
"3375","3431241",0.496471781360894,10433,0.537709520932823,10595,-0.0412377395719286,-162
"3376","4431241",0.454997450660354,12342,0.495299145811012,12704,-0.0403016951506582,-362
"3377","1141241",0.674649344082525,2379,0.705463694893451,2236,-0.0308143508109261,143
"3378","2141241",0.611426171574336,4734,0.649089210252628,4453,-0.0376630386782917,281
"3379","3141241",0.568311962760833,6782,0.620295377052848,5927,-0.0519834142920157,855
"3380","4141241",0.526837632060293,8912,0.577885001931038,8327,-0.0510473698707452,585
"3381","1241241",0.620691566489529,4301,0.650159415947745,4414,-0.0294678494582159,-113
"3382","2241241",0.55746839398134,7309,0.593784931306922,7419,-0.0363165373255815,-110
"3383","3241241",0.514354185167837,9546,0.564991098107142,9041,-0.0506369129393055,505
"3384","4241241",0.472879854467297,11570,0.522580722985332,11365,-0.0497008685180352,205
"3385","1341241",0.592712096212753,5558,0.623108848614447,5775,-0.0303967524016941,-217
"3386","2341241",0.529488923704564,8760,0.566734363973624,8958,-0.0372454402690597,-198
"3387","3341241",0.48637471489106,10935,0.537940530773844,10584,-0.0515658158827838,351
"3388","4341241",0.44490038419052,12760,0.495530155652034,12691,-0.0506297714615134,69
"3389","1441241",0.553775598227757,7509,0.582479344646341,8053,-0.0287037464185843,-544
"3390","2441241",0.490552425719568,10705,0.526104860005518,11197,-0.0355524342859501,-492
"3391","3441241",0.447438216906064,12658,0.497311026805738,12610,-0.0498728098996741,48
"3392","4441241",0.405963886205524,14134,0.454900651683928,14253,-0.0489367654784037,-119
"3393","1112241",0.801909789807185,300,0.806577611597319,366,-0.00466782179013348,-66
"3394","2112241",0.738686617298996,945,0.750203126956495,1100,-0.0115165096574991,-155
"3395","3112241",0.695572408485493,1808,0.721409293756716,1773,-0.0258368852712231,35
"3396","4112241",0.654098077784953,3030,0.678998918634906,3174,-0.0249008408499526,-144
"3397","1212241",0.747952012214189,815,0.751273332651612,1077,-0.00332132043742328,-262
"3398","2212241",0.684728839706,2084,0.694898848010789,2584,-0.0101700083047889,-500
"3399","3212241",0.641614630892497,3502,0.66610501481101,3691,-0.0244903839185129,-189
"3400","4212241",0.600140300191957,5228,0.623694639689199,5742,-0.0235543394972426,-514
"3401","1312241",0.719972541937413,1272,0.724222765318315,1693,-0.00425022338090153,-421
"3402","2312241",0.656749369429224,2930,0.667848280677491,3619,-0.0110989112482671,-689
"3403","3312241",0.613635160615721,4631,0.639054447477712,4986,-0.0254192868619911,-355
"3404","4312241",0.572160829915181,6582,0.596644072355901,7257,-0.0244832424407209,-675
"3405","1412241",0.681036043952417,2197,0.683593261350209,2983,-0.00255721739779169,-786
"3406","2412241",0.617812871444228,4432,0.627218776709386,5549,-0.00940590526515739,-1117
"3407","3412241",0.574698662630725,6449,0.598424943509606,7149,-0.0237262808788814,-700
"3408","4412241",0.533224331930185,8563,0.556014568387796,9575,-0.0227902364576111,-1012
"3409","1122241",0.733930518940765,1027,0.746008299939912,1187,-0.0120777809991467,-160
"3410","2122241",0.670707346432576,2483,0.689633815299089,2756,-0.0189264688665123,-273
"3411","3122241",0.627593137619073,4014,0.660839982099309,3939,-0.0332468444802363,75
"3412","4122241",0.586118806918533,5882,0.618429606977499,6023,-0.0323108000589658,-141
"3413","1222241",0.679972741347769,2229,0.690704020994206,2719,-0.0107312796464365,-490
"3414","2222241",0.61674956883958,4468,0.634329536353382,5220,-0.0175799675138021,-752
"3415","3222241",0.573635360026077,6499,0.605535703153603,6733,-0.0319003431275261,-234
"3416","4222241",0.532161029325537,8614,0.563125328031793,9155,-0.0309642987062558,-541
"3417","1322241",0.651993271070993,3119,0.663653453660908,3811,-0.0116601825899147,-692
"3418","2322241",0.588770098562804,5741,0.607278969020084,6638,-0.0185088704572803,-897
"3419","3322241",0.545655889749301,7926,0.578485135820305,8289,-0.0328292460710043,-363
"3420","4322241",0.504181559048761,10052,0.536074760698495,10680,-0.0318932016497341,-628
"3421","1422241",0.613056773085997,4658,0.623023949692802,5784,-0.00996717660680491,-1126
"3422","2422241",0.549833600577808,7709,0.566649465051979,8961,-0.0168158644741706,-1252
"3423","3422241",0.506719391764305,9916,0.537855631852199,10588,-0.0311362400878946,-672
"3424","4422241",0.465245061063765,11891,0.495445256730389,12699,-0.0302001956666243,-808
"3425","1132241",0.690597996775666,1942,0.707543207491883,2164,-0.0169452107162174,-222
"3426","2132241",0.627374824267477,4025,0.65116872285106,4361,-0.0237938985835829,-336
"3427","3132241",0.584260615453973,5993,0.62237488965128,5813,-0.038114274197307,180
"3428","4132241",0.542786284753433,8080,0.57996451452947,8200,-0.0371782297760367,-120
"3429","1232241",0.63664021918267,3688,0.652238928546177,4314,-0.0155987093635074,-626
"3430","2232241",0.573417046674481,6510,0.595864443905354,7303,-0.022447397230873,-793
"3431","3232241",0.530302837860977,8717,0.567070610705574,8937,-0.036767772844597,-220
"3432","4232241",0.488828507160437,10807,0.524660235583764,11265,-0.0358317284233265,-458
"3433","1332241",0.608660748905893,4868,0.625188361212879,5656,-0.0165276123069856,-788
"3434","2332241",0.545437576397704,7940,0.568813876572056,8843,-0.0233763001743512,-903
"3435","3332241",0.502323367584201,10148,0.540020043372276,10474,-0.0376966757880752,-326
"3436","4332241",0.460849036883661,12104,0.497609668250466,12595,-0.0367606313668048,-491
"3437","1432241",0.569724250920897,6708,0.584558857244773,7916,-0.0148346063238758,-1208
"3438","2432241",0.506501078412708,9926,0.52818437260395,11090,-0.0216832941912415,-1164
"3439","3432241",0.463386869599205,11983,0.49939053940417,12527,-0.0360036698049654,-544
"3440","4432241",0.421912538898665,13618,0.45698016428236,14181,-0.0350676253836951,-563
"3441","1142241",0.641564432320836,3505,0.667144713364799,3643,-0.0255802810439629,-138
"3442","2142241",0.578341259812647,6282,0.610770228723976,6446,-0.0324289689113285,-164
"3443","3142241",0.535227050999144,8454,0.581976395524196,8084,-0.0467493445250525,370
"3444","4142241",0.493752720298604,10557,0.539566020402386,10493,-0.0458133001037821,64
"3445","1242241",0.58760665472784,5798,0.611840434419093,6405,-0.0242337796912527,-607
"3446","2242241",0.524383482219651,9026,0.555465949778269,9605,-0.0310824675586183,-579
"3447","3242241",0.481269273406148,11170,0.52667211657849,11160,-0.0454028431723424,10
"3448","4242241",0.439794942705608,12952,0.48426174145668,13170,-0.044466798751072,-218
"3449","1342241",0.559627184451064,7187,0.584789867085795,7898,-0.025162682634731,-711
"3450","2342241",0.496404011942875,10435,0.528415382444972,11081,-0.0320113705020966,-646
"3451","3342241",0.453289803129371,12415,0.499621549245192,12515,-0.0463317461158206,-100
"3452","4342241",0.411815472428831,13945,0.457211174123382,14169,-0.0453957016945503,-224
"3453","1442241",0.520690686466068,9204,0.544160363117689,10229,-0.0234696766516211,-1025
"3454","2442241",0.457467513957879,12242,0.487785878476866,13027,-0.0303183645189869,-785
"3455","3442241",0.414353305144375,13866,0.458992045277086,14120,-0.0446387401327109,-254
"3456","4442241",0.372878974443835,14991,0.416581670155276,15267,-0.0437026957114405,-276
"3457","1113241",0.7630266142347,627,0.78108102120808,625,-0.0180544069733801,2
"3458","2113241",0.699803441726511,1698,0.724706536567256,1683,-0.0249030948407457,15
"3459","3113241",0.656689232913007,2934,0.695912703367477,2541,-0.0392234704544697,393
"3460","4113241",0.615214902212467,4546,0.653502328245667,4259,-0.0382874260331992,287
"3461","1213241",0.709068836641704,1494,0.725776742262373,1650,-0.0167079056206699,-156
"3462","2213241",0.645845664133515,3334,0.66940225762155,3546,-0.0235565934880355,-212
"3463","3213241",0.602731455320011,5101,0.640608424421771,4890,-0.0378769691017595,211
"3464","4213241",0.561257124619471,7105,0.59819804929996,7168,-0.0369409246804893,-63
"3465","1313241",0.681089366364927,2194,0.698726174929076,2451,-0.0176368085641482,-257
"3466","2313241",0.617866193856738,4427,0.642351690288252,4797,-0.0244854964315138,-370
"3467","3313241",0.574751985043235,6448,0.613557857088473,6294,-0.0388058720452378,154
"3468","4313241",0.533277654342695,8560,0.571147481966662,8718,-0.0378698276239675,-158
"3469","1413241",0.642152868379931,3477,0.65809667096097,4048,-0.0159438025810383,-571
"3470","2413241",0.578929695871742,6260,0.601722186320147,6950,-0.022792490448404,-690
"3471","3413241",0.535815487058239,8429,0.572928353120367,8600,-0.037112866062128,-171
"3472","4413241",0.494341156357699,10528,0.530517977998557,10971,-0.0361768216408577,-443
"3473","1123241",0.69504734336828,1815,0.720511709550673,1795,-0.0254643661823933,20
"3474","2123241",0.631824170860091,3851,0.66413722490985,3792,-0.0323130540497589,59
"3475","3123241",0.588709962046587,5747,0.63534339171007,5158,-0.0466334296634829,589
"3476","4123241",0.547235631346047,7836,0.59293301658826,7457,-0.0456973852422125,379
"3477","1223241",0.641089565775284,3522,0.665207430604967,3737,-0.0241178648296831,-215
"3478","2223241",0.577866393267095,6301,0.608832945964143,6565,-0.0309665526970487,-264
"3479","3223241",0.534752184453591,8475,0.580039112764364,8192,-0.0452869283107727,283
"3480","4223241",0.493277853753051,10582,0.537628737642554,10601,-0.0443508838895024,-19
"3481","1323241",0.613110095498507,4652,0.638156863271669,5034,-0.0250467677731614,-382
"3482","2323241",0.549886922990318,7705,0.581782378630845,8092,-0.031895455640527,-387
"3483","3323241",0.506772714176815,9914,0.552988545431066,9747,-0.046215831254251,167
"3484","4323241",0.465298383476275,11887,0.510578170309256,12006,-0.0452797868329807,-119
"3485","1423241",0.574173597513511,6470,0.597527359303563,7212,-0.0233537617900516,-742
"3486","2423241",0.510950425005323,9723,0.54115287466274,10413,-0.0302024496574173,-690
"3487","3423241",0.467836216191819,11783,0.51235904146296,11914,-0.0445228252711412,-131
"3488","4423241",0.426361885491279,13457,0.46994866634115,13765,-0.0435867808498709,-308
"3489","1133241",0.65171482120318,3128,0.682046617102644,3049,-0.030331795899464,79
"3490","2133241",0.588491648694991,5756,0.625672132461821,5631,-0.0371804837668296,125
"3491","3133241",0.545377439881488,7946,0.596878299262041,7244,-0.0515008593805536,702
"3492","4133241",0.503903109180948,10068,0.554467924140231,9654,-0.0505648149592833,414
"3493","1233241",0.597757043610184,5330,0.626742338156938,5580,-0.028985294546754,-250
"3494","2233241",0.534533871101995,8485,0.570367853516115,8760,-0.0358339824141196,-275
"3495","3233241",0.491419662288491,10667,0.541574020316335,10384,-0.0501543580278436,283
"3496","4233241",0.449945331587952,12547,0.499163645194525,12538,-0.0492183136065731,9
"3497","1333241",0.569777573333408,6704,0.59969177082364,7073,-0.0299141974902323,-369
"3498","2333241",0.506554400825219,9924,0.543317286182817,10270,-0.0367628853575979,-346
"3499","3333241",0.463440192011715,11981,0.514523452983037,11805,-0.0510832609713218,176
"3500","4333241",0.421965861311175,13615,0.472113077861227,13685,-0.0501472165500513,-70
"3501","1433241",0.530841075348412,8690,0.559062266855534,9393,-0.0282211915071224,-703
"3502","2433241",0.467617902840223,11792,0.502687782214711,12360,-0.0350698793744881,-568
"3503","3433241",0.424503694026719,13528,0.473893949014931,13605,-0.0493902549882121,-77
"3504","4433241",0.38302936332618,14757,0.431483573893121,14948,-0.0484542105669416,-191
"3505","1143241",0.60268125674835,5104,0.64164812297556,4837,-0.0389668662272096,267
"3506","2143241",0.539458084240162,8256,0.585273638334737,7871,-0.0458155540945752,385
"3507","3143241",0.496343875426658,10441,0.556479805134957,9543,-0.0601359297082991,898
"3508","4143241",0.454869544726118,12349,0.514069430013147,11826,-0.0591998852870286,523
"3509","1243241",0.548723479155354,7754,0.586343844029854,7816,-0.0376203648744994,-62
"3510","2243241",0.485500306647166,10975,0.52996935938903,11003,-0.0444690527418649,-28
"3511","3243241",0.442386097833662,12856,0.501175526189251,12436,-0.0587894283555889,420
"3512","4243241",0.400911767133122,14282,0.458765151067441,14127,-0.0578533839343187,155
"3513","1343241",0.520744008878578,9201,0.559293276696556,9374,-0.0385492678179776,-173
"3514","2343241",0.457520836370389,12240,0.502918792055733,12352,-0.0453979556853432,-112
"3515","3343241",0.414406627556886,13865,0.474124958855953,13593,-0.0597183312990672,272
"3516","4343241",0.372932296856346,14989,0.431714583734143,14940,-0.0587822868777969,49
"3517","1443241",0.481807510893582,11143,0.51866377272845,11576,-0.0368562618348677,-433
"3518","2443241",0.418584338385393,13737,0.462289288087627,14008,-0.0437049497022334,-271
"3519","3443241",0.37547012957189,14933,0.433495454887847,14880,-0.0580253253159574,53
"3520","4443241",0.33399579887135,15680,0.391085079766037,15717,-0.0570892808946871,-37
"3521","1114241",0.71081954226413,1453,0.736430407834424,1393,-0.0256108655702939,60
"3522","2114241",0.647596369755941,3282,0.6800559231936,3136,-0.0324595534376595,146
"3523","3114241",0.604482160942438,5032,0.651262089993821,4357,-0.0467799290513835,675
"3524","4114241",0.563007830241897,7014,0.608851714872011,6564,-0.0458438846301132,450
"3525","1214241",0.656861764671134,2925,0.681126128888718,3088,-0.0242643642175839,-163
"3526","2214241",0.593638592162945,5525,0.624751644247894,5678,-0.0311130520849495,-153
"3527","3214241",0.550524383349441,7675,0.595957811048115,7296,-0.0454334276986735,379
"3528","4214241",0.509050052648901,9798,0.553547435926305,9712,-0.044497383277403,86
"3529","1314241",0.628882294394357,3967,0.65407556155542,4233,-0.0251932671610622,-266
"3530","2314241",0.565659121886169,6903,0.597701076914596,7194,-0.0320419550284278,-291
"3531","3314241",0.522544913072665,9115,0.568907243714817,8839,-0.0463623306421518,276
"3532","4314241",0.481070582372125,11179,0.526496868593007,11171,-0.0454262862208814,8
"3533","1414241",0.589945796409362,5692,0.613446057587314,6299,-0.0235002611779523,-607
"3534","2414241",0.526722623901173,8922,0.557071572946491,9507,-0.030348949045318,-585
"3535","3414241",0.483608415087669,11069,0.528277739746711,11088,-0.044669324659042,-19
"3536","4414241",0.442134084387129,12862,0.485867364624901,13103,-0.0437332802377716,-241
"3537","1124241",0.64284027139771,3451,0.675861096177017,3296,-0.0330208247793071,155
"3538","2124241",0.579617098889521,6225,0.619486611536194,5968,-0.0398695126466727,257
"3539","3124241",0.536502890076018,8395,0.590692778336414,7566,-0.0541898882603967,829
"3540","4124241",0.495028559375478,10498,0.548282403214604,9993,-0.0532538438391264,505
"3541","1224241",0.588882493804714,5735,0.620556817231311,5913,-0.0316743234265972,-178
"3542","2224241",0.525659321296525,8967,0.564182332590488,9094,-0.0385230112939627,-127
"3543","3224241",0.482545112483021,11113,0.535388499390708,10720,-0.0528433869076867,393
"3544","4224241",0.441070781782481,12899,0.492978124268898,12803,-0.0519073424864163,96
"3545","1324241",0.560903023527938,7122,0.593506249898013,7433,-0.0326032263700754,-311
"3546","2324241",0.497679851019749,10375,0.53713176525719,10629,-0.0394519142374409,-254
"3547","3324241",0.454565642206245,12359,0.50833793205741,12093,-0.0537722898511649,266
"3548","4324241",0.413091311505705,13898,0.4659275569356,13891,-0.0528362454298946,7
"3549","1424241",0.521966525542942,9148,0.552876745929907,9755,-0.0309102203869656,-607
"3550","2424241",0.458743353034753,12202,0.496502261289084,12644,-0.0377589082543312,-442
"3551","3424241",0.415629144221249,13826,0.467708428089304,13832,-0.0520792838680552,-6
"3552","4424241",0.374154813520709,14960,0.425298052967494,15078,-0.0511432394467848,-118
"3553","1134241",0.59950774923261,5255,0.637396003728988,5066,-0.037888254496378,189
"3554","2134241",0.536284576724421,8411,0.581021519088165,8131,-0.0447369423637436,280
"3555","3134241",0.493170367910918,10593,0.552227685888385,9784,-0.0590573179774675,809
"3556","4134241",0.451696037210378,12472,0.509817310766575,12034,-0.0581212735561972,438
"3557","1234241",0.545549971639614,7929,0.582091724783282,8079,-0.0365417531436678,-150
"3558","2234241",0.482326799131425,11122,0.525717240142459,11215,-0.0433904410110335,-93
"3559","3234241",0.439212590317922,12969,0.496923406942679,12622,-0.0577108166247575,347
"3560","4234241",0.397738259617382,14360,0.454513031820869,14267,-0.0567747722034871,93
"3561","1334241",0.517570501362838,9376,0.555041157449984,9624,-0.0374706560871461,-248
"3562","2334241",0.454347328854649,12370,0.498666672809161,12561,-0.0443193439545117,-191
"3563","3334241",0.411233120041146,13957,0.469872839609381,13769,-0.0586397195682357,188
"3564","4334241",0.369758789340606,15054,0.427462464487571,15034,-0.0577036751469653,20
"3565","1434241",0.478634003377842,11291,0.514411653481878,11811,-0.0357776501040363,-520
"3566","2434241",0.415410830869653,13834,0.458037168841055,14152,-0.042626337971402,-318
"3567","3434241",0.37229662205615,15001,0.429243335641276,14995,-0.056946713585126,6
"3568","4434241",0.33082229135561,15718,0.386832960519465,15771,-0.0560106691638557,-53
"3569","1144241",0.550474184777781,7686,0.596997509601904,7238,-0.0465233248241234,448
"3570","2144241",0.487251012269592,10899,0.540623024961081,10445,-0.053372012691489,454
"3571","3144241",0.444136803456088,12798,0.511829191761301,11944,-0.067692388305213,854
"3572","4144241",0.402662472755548,14230,0.469418816639491,13782,-0.0667563438839426,448
"3573","1244241",0.496516407184785,10429,0.541693230656198,10376,-0.0451768234714133,53
"3574","2244241",0.433293234676596,13220,0.485318746015375,13127,-0.0520255113387789,93
"3575","3244241",0.390179025863092,14587,0.456524912815595,14193,-0.0663458869525029,394
"3576","4244241",0.348704695162552,15459,0.414114537693785,15322,-0.0654098425312326,137
"3577","1344241",0.468536936908008,11758,0.5146426633229,11797,-0.0461057264148916,-39
"3578","2344241",0.40531376439982,14158,0.458268178682077,14146,-0.0529544142822572,12
"3579","3344241",0.362199555586316,15222,0.429474345482297,14992,-0.0672747898959812,230
"3580","4344241",0.320725224885776,15838,0.387063970360487,15767,-0.0663387454747109,71
"3581","1444241",0.429600438923012,13357,0.474013159354794,13599,-0.0444127204317817,-242
"3582","2444241",0.366377266414824,15140,0.417638674713971,15247,-0.0512614082991474,-107
"3583","3444241",0.32326305760132,15811,0.388844841514192,15747,-0.0655817839128715,64
"3584","4444241",0.28178872690078,16159,0.346434466392381,16155,-0.0646457394916011,4
"3585","1111341",0.812540722563566,236,0.826846603198296,235,-0.01430588063473,1
"3586","2111341",0.749317550055377,794,0.770472118557473,766,-0.0211545685020956,28
"3587","3111341",0.706203341241874,1567,0.741678285357693,1276,-0.0354749441158196,291
"3588","4111341",0.664729010541334,2667,0.699267910235883,2431,-0.0345388996945494,236
"3589","1211341",0.75858294497057,685,0.77154232425259,746,-0.0129593792820201,-61
"3590","2211341",0.695359772462381,1812,0.715167839611767,1930,-0.0198080671493857,-118
"3591","3211341",0.652245563648878,3114,0.686374006411987,2878,-0.0341284427631097,236
"3592","4211341",0.610771232948338,4761,0.643963631290177,4701,-0.0331923983418392,60
"3593","1311341",0.730603474693794,1086,0.744491756919292,1220,-0.0138882822254983,-134
"3594","2311341",0.667380302185605,2590,0.688117272278469,2807,-0.0207369700928639,-217
"3595","3311341",0.624266093372101,4171,0.659323439078689,3996,-0.0350573457065879,175
"3596","4311341",0.582791762671562,6052,0.616913063956879,6111,-0.0341213012853174,-59
"3597","1411341",0.691666976708798,1920,0.703862252951186,2281,-0.0121952762423885,-361
"3598","2411341",0.628443804200609,3987,0.647487768310363,4531,-0.0190439641097542,-544
"3599","3411341",0.585329595387105,5937,0.618693935110584,6008,-0.0333643397234782,-71
"3600","4411341",0.543855264686566,8024,0.576283559988773,8410,-0.0324282953022077,-386
"3601","1121341",0.744561451697146,860,0.766277291540889,837,-0.0217158398437433,23
"3602","2121341",0.681338279188957,2191,0.709902806900066,2087,-0.0285645277111088,104
"3603","3121341",0.638224070375454,3630,0.681108973700287,3089,-0.0428849033248329,541
"3604","4121341",0.596749739674914,5380,0.638698598578476,5004,-0.0419488589035626,376
"3605","1221341",0.69060367410415,1941,0.710973012595183,2053,-0.0203693384910333,-112
"3606","2221341",0.627380501595961,4024,0.65459852795436,4209,-0.0272180263583989,-185
"3607","3221341",0.584266292782458,5992,0.62580469475458,5623,-0.0415384019721229,369
"3608","4221341",0.542791962081918,8079,0.58339431963277,7987,-0.0406023575508524,92
"3609","1321341",0.662624203827374,2743,0.683922445261885,2971,-0.0212982414345115,-228
"3610","2321341",0.599401031319185,5261,0.627547960621062,5534,-0.0281469293018771,-273
"3611","3321341",0.556286822505681,7384,0.598754127421283,7128,-0.0424673049156011,256
"3612","4321341",0.514812491805142,9523,0.556343752299472,9552,-0.0415312604943306,-29
"3613","1421341",0.623687705842378,4196,0.64329294129378,4747,-0.0196052354514017,-551
"3614","2421341",0.560464533334189,7153,0.586918456652956,7782,-0.0264539233187674,-629
"3615","3421341",0.517350324520685,9393,0.558124623453177,9438,-0.0407742989324914,-45
"3616","4421341",0.475875993820146,11434,0.515714248331366,11736,-0.0398382545112209,-302
"3617","1131341",0.701228929532046,1670,0.72781219909286,1592,-0.0265832695608141,78
"3618","2131341",0.638005757023858,3636,0.671437714452037,3458,-0.0334319574281797,178
"3619","3131341",0.594891548210354,5474,0.642643881252258,4783,-0.0477523330419037,691
"3620","4131341",0.553417217509814,7522,0.600233506130447,7047,-0.0468162886206333,475
"3621","1231341",0.64727115193905,3293,0.672507920147154,3422,-0.0252367682081039,-129
"3622","2231341",0.584047979430862,6000,0.616133435506331,6164,-0.0320854560754695,-164
"3623","3231341",0.540933770617358,8180,0.587339602306552,7753,-0.0464058316891935,427
"3624","4231341",0.499459439916818,10294,0.544929227184741,10177,-0.0454697872679232,117
"3625","1331341",0.619291681662274,4374,0.645457352813856,4630,-0.0261656711515822,-256
"3626","2331341",0.556068509154085,7396,0.589082868173033,7654,-0.0330143590189478,-258
"3627","3331341",0.512954300340582,9626,0.560289034973254,9311,-0.0473347346326718,315
"3628","4331341",0.471479969640042,11634,0.517878659851443,11620,-0.0463986902114015,14
"3629","1431341",0.580355183677278,6185,0.604827848845751,6784,-0.0244726651684724,-599
"3630","2431341",0.517132011169089,9407,0.548453364204927,9982,-0.031321353035838,-575
"3631","3431341",0.474017802355586,11526,0.519659531005148,11516,-0.045641728649562,10
"3632","4431341",0.432543471655046,13246,0.477249155883338,13460,-0.0447056842282917,-214
"3633","1141341",0.652195365077217,3115,0.687413704965776,2836,-0.0352183398885595,279
"3634","2141341",0.588972192569028,5732,0.631039220324953,5358,-0.0420670277559251,374
"3635","3141341",0.545857983755525,7914,0.602245387125174,6920,-0.0563874033696491,994
"3636","4141341",0.504383653054985,10037,0.559835012003363,9348,-0.0554513589483788,689
"3637","1241341",0.598237587484221,5312,0.63210942602007,5309,-0.0338718385358495,3
"3638","2241341",0.535014414976032,8463,0.575734941379247,8445,-0.0407205264032151,18
"3639","3241341",0.491900206162528,10650,0.546941108179468,10059,-0.0550409020169391,591
"3640","4241341",0.450425875461989,12526,0.504530733057657,12269,-0.0541048575956686,257
"3641","1341341",0.570258117207445,6679,0.605058858686772,6765,-0.0348007414793278,-86
"3642","2341341",0.507034944699256,9901,0.548684374045949,9967,-0.0416494293466934,-66
"3643","3341341",0.463920735885752,11959,0.51989054084617,11501,-0.0559698049604173,458
"3644","4341341",0.422446405185212,13597,0.477480165724359,13446,-0.0550337605391468,151
"3645","1441341",0.531321619222449,8665,0.564429354718667,9076,-0.0331077354962179,-411
"3646","2441341",0.46809844671426,11774,0.508054870077843,12111,-0.0399564233635836,-337
"3647","3441341",0.424984237900756,13514,0.479261036878064,13364,-0.0542767989773076,150
"3648","4441341",0.383509907200216,14746,0.436850661756254,14794,-0.0533407545560371,-48
"3649","1112341",0.779455810801877,459,0.788527621669644,538,-0.00907181086776687,-79
"3650","2112341",0.716232638293688,1342,0.732153137028821,1489,-0.0159204987351325,-147
"3651","3112341",0.673118429480185,2414,0.703359303829041,2303,-0.0302408743488565,111
"3652","4112341",0.631644098779645,3854,0.660948928707231,3934,-0.0293048299275862,-80
"3653","1212341",0.725498033208881,1172,0.733223342723938,1459,-0.0077253095150569,-287
"3654","2212341",0.662274860700692,2754,0.676848858083115,3259,-0.0145739973824225,-505
"3655","3212341",0.619160651887189,4379,0.648055024883335,4500,-0.0288943729961465,-121
"3656","4212341",0.577686321186649,6309,0.605644649761525,6726,-0.027958328574876,-417
"3657","1312341",0.697518562932105,1757,0.70617277539064,2212,-0.00865421245853515,-455
"3658","2312341",0.634295390423916,3771,0.649798290749817,4426,-0.0155029003259007,-655
"3659","3312341",0.591181181610412,5624,0.621004457550037,5888,-0.0298232759396247,-264
"3660","4312341",0.549706850909873,7713,0.578594082428227,8283,-0.0288872315183543,-570
"3661","1412341",0.658582064947109,2870,0.665543271422534,3718,-0.00696120647542531,-848
"3662","2412341",0.59535889243892,5458,0.609168786781711,6543,-0.013809894342791,-1085
"3663","3412341",0.552244683625416,7585,0.580374953581931,8166,-0.028130269956515,-581
"3664","4412341",0.510770352924877,9731,0.537964578460121,10581,-0.0271942255352445,-850
"3665","1122341",0.711476539935457,1438,0.727958310012237,1588,-0.0164817700767801,-150
"3666","2122341",0.648253367427268,3257,0.671583825371414,3453,-0.0233304579441457,-196
"3667","3122341",0.605139158613765,5003,0.642789992171635,4774,-0.0376508335578697,229
"3668","4122341",0.563664827913225,6974,0.600379617049824,7039,-0.0367147891365994,-65
"3669","1222341",0.657518762342461,2904,0.672654031066531,3410,-0.0151352687240701,-506
"3670","2222341",0.594295589834272,5501,0.616279546425708,6157,-0.0219839565914357,-656
"3671","3222341",0.551181381020769,7645,0.587485713225928,7741,-0.0363043322051597,-96
"3672","4222341",0.509707050320229,9767,0.545075338104118,10166,-0.0353682877838892,-399
"3673","1322341",0.629539292065685,3934,0.645603463733233,4625,-0.0160641716675484,-691
"3674","2322341",0.566316119557496,6872,0.58922897909241,7648,-0.022912859534914,-776
"3675","3322341",0.523201910743992,9078,0.56043514589263,9300,-0.037233235148638,-222
"3676","4322341",0.481727580043453,11147,0.51802477077082,11613,-0.0362971907273674,-466
"3677","1422341",0.590602794080689,5657,0.604973959765127,6774,-0.0143711656844385,-1117
"3678","2422341",0.5273796215725,8882,0.548599475124304,9975,-0.0212198535518042,-1093
"3679","3422341",0.484265412758997,11030,0.519805641924525,11509,-0.0355402291655282,-479
"3680","4422341",0.442791082058457,12840,0.477395266802714,13455,-0.0346041847442577,-615
"3681","1132341",0.668144017770357,2571,0.689493217564208,2759,-0.021349199793851,-188
"3682","2132341",0.604920845262169,5010,0.633118732923385,5262,-0.0281978876612166,-252
"3683","3132341",0.561806636448665,7070,0.604324899723606,6815,-0.0425182632749406,255
"3684","4132341",0.520332305748125,9222,0.561914524601795,9222,-0.0415822188536701,0
"3685","1232341",0.614186240177361,4601,0.634188938618502,5224,-0.0200026984411408,-623
"3686","2232341",0.550963067669173,7657,0.577814453977679,8337,-0.0268513863085064,-680
"3687","3232341",0.507848858855669,9864,0.5490206207779,9948,-0.0411717619222304,-84
"3688","4232341",0.466374528155129,11844,0.506610245656089,12179,-0.0402357175009601,-335
"3689","1332341",0.586206769900585,5878,0.607138371285204,6642,-0.020931601384619,-764
"3690","2332341",0.522983597392396,9094,0.550763886644381,9856,-0.0277802892519846,-762
"3691","3332341",0.479869388578893,11225,0.521970053444602,11401,-0.0421006648657086,-176
"3692","4332341",0.438395057878353,13000,0.479559678322791,13351,-0.0411646204444383,-351
"3693","1432341",0.547270271915589,7832,0.566508867317098,8965,-0.0192385954015092,-1133
"3694","2432341",0.4840470994074,11049,0.510134382676275,12023,-0.0260872832688748,-974
"3695","3432341",0.440932890593897,12909,0.481340549476496,13281,-0.0404076588825988,-372
"3696","4432341",0.399458559893357,14311,0.438930174354686,14738,-0.0394716144613286,-427
"3697","1142341",0.619110453315528,4381,0.649094723437124,4452,-0.0299842701215963,-71
"3698","2142341",0.555887280807339,7403,0.592720238796301,7469,-0.0368329579889619,-66
"3699","3142341",0.512773071993836,9639,0.563926405596522,9111,-0.0511533336026859,528
"3700","4142341",0.471298741293296,11638,0.521516030474711,11420,-0.0502172891814156,218
"3701","1242341",0.565152675722532,6928,0.593790444491418,7418,-0.0286377687688864,-490
"3702","2242341",0.501929503214343,10170,0.537415959850595,10618,-0.0354864566362519,-448
"3703","3242341",0.45881529440084,12197,0.508622126650815,12083,-0.0498068322499759,114
"3704","4242341",0.4173409637003,13775,0.466211751529005,13877,-0.0488707878287054,-102
"3705","1342341",0.537173205445756,8364,0.56673987715812,8957,-0.0295666717123646,-593
"3706","2342341",0.473950032937567,11529,0.510365392517297,12015,-0.0364153595797301,-486
"3707","3342341",0.430835824124063,13310,0.481571559317517,13275,-0.0507357351934541,35
"3708","4342341",0.389361493423523,14603,0.439161184195707,14730,-0.0497996907721837,-127
"3709","1442341",0.49823670746076,10353,0.526110373190014,11196,-0.0278736657292547,-843
"3710","2442341",0.435013534952571,13149,0.469735888549191,13774,-0.0347223535966204,-625
"3711","3442341",0.391899326139067,14546,0.440942055349412,14688,-0.0490427292103444,-142
"3712","4442341",0.350424995438527,15434,0.398531680227601,15609,-0.048106684789074,-175
"3713","1113341",0.740572635229392,915,0.763031031280405,892,-0.0224583960510135,23
"3714","2113341",0.677349462721203,2307,0.706656546639582,2200,-0.0293070839183791,107
"3715","3113341",0.634235253907699,3773,0.677862713439802,3213,-0.0436274595321031,560
"3716","4113341",0.592760923207159,5556,0.635452338317992,5151,-0.0426914151108326,405
"3717","1213341",0.686614857636396,2035,0.707726752334699,2158,-0.0211118946983033,-123
"3718","2213341",0.623391685128207,4207,0.651352267693876,4352,-0.0279605825656689,-145
"3719","3213341",0.580277476314703,6193,0.622558434494096,5808,-0.0422809581793929,385
"3720","4213341",0.538803145614163,8289,0.580148059372286,8184,-0.0413449137581227,105
"3721","1313341",0.658635387359619,2863,0.680676185001401,3105,-0.0220407976417816,-242
"3722","2313341",0.59541221485143,5452,0.624301700360578,5705,-0.0288894855091472,-253
"3723","3313341",0.552298006037927,7581,0.595507867160798,7317,-0.0432098611228712,264
"3724","4313341",0.510823675337387,9728,0.553097492038988,9740,-0.0422738167016009,-12
"3725","1413341",0.619698889374623,4349,0.640046681033295,4914,-0.0203477916586717,-565
"3726","2413341",0.556475716866434,7371,0.583672196392472,7969,-0.0271964795260374,-598
"3727","3413341",0.513361508052931,9605,0.554878363192692,9632,-0.0415168551397614,-27
"3728","4413341",0.471887177352391,11623,0.512467988070882,11907,-0.0405808107184911,-284
"3729","1123341",0.672593364362972,2427,0.702461719622998,2340,-0.0298683552600267,87
"3730","2123341",0.609370191854783,4831,0.646087234982175,4605,-0.0367170431273923,226
"3731","3123341",0.566255983041279,6880,0.617293401782396,6089,-0.0510374187411163,791
"3732","4123341",0.524781652340739,9009,0.574883026660585,8498,-0.0501013743198458,511
"3733","1223341",0.618635586769976,4395,0.647157440677292,4551,-0.0285218539073165,-156
"3734","2223341",0.555412414261787,7433,0.590782956036469,7562,-0.0353705417746821,-129
"3735","3223341",0.512298205448283,9659,0.561989122836689,9216,-0.0496909173884061,443
"3736","4223341",0.470823874747743,11657,0.519578747714879,11525,-0.0487548729671358,132
"3737","1323341",0.590656116493199,5648,0.620106873343994,5935,-0.0294507568507948,-287
"3738","2323341",0.52743294398501,8873,0.563732388703171,9120,-0.0362994447181604,-247
"3739","3323341",0.484318735171507,11024,0.534938555503391,10740,-0.0506198203318843,284
"3740","4323341",0.442844404470967,12834,0.492528180381581,12826,-0.0496837759106141,8
"3741","1423341",0.551719618508203,7613,0.579477369375888,8228,-0.027757750867685,-615
"3742","2423341",0.488496446000015,10829,0.523102884735065,11345,-0.0346064387350506,-516
"3743","3423341",0.445382237186511,12743,0.494309051535286,12746,-0.0489268143487746,-3
"3744","4423341",0.403907906485971,14198,0.451898676413475,14351,-0.0479907699275043,-153
"3745","1133341",0.629260842197872,3950,0.663996627174969,3799,-0.0347357849770974,151
"3746","2133341",0.566037669689683,6885,0.607622142534146,6625,-0.041584472844463,260
"3747","3133341",0.52292346087618,9095,0.578828309334367,8271,-0.055904848458187,824
"3748","4133341",0.48144913017564,11159,0.536417934212556,10663,-0.0549688040369167,496
"3749","1233341",0.575303064604876,6414,0.608692348229263,6573,-0.0333892836243874,-159
"3750","2233341",0.512079892096687,9668,0.55231786358844,9780,-0.040237971491753,-112
"3751","3233341",0.468965683283183,11742,0.52352403038866,11320,-0.054558347105477,422
"3752","4233341",0.427491352582644,13413,0.48111365526685,13290,-0.0536223026842065,123
"3753","1333341",0.5473235943281,7826,0.581641780895965,8096,-0.0343181865678657,-270
"3754","2333341",0.484100421819911,11045,0.525267296255142,11231,-0.0411668744352312,-186
"3755","3333341",0.440986213006407,12906,0.496473463055363,12646,-0.0554872500489552,260
"3756","4333341",0.399511882305867,14308,0.454063087933552,14284,-0.0545512056276847,24
"3757","1433341",0.508387096343104,9832,0.54101227692786,10422,-0.0326251805847558,-590
"3758","2433341",0.445163923834915,12751,0.484637792287036,13155,-0.0394738684521215,-404
"3759","3433341",0.402049715021411,14249,0.455843959087257,14219,-0.0537942440658455,30
"3760","4433341",0.360575384320871,15249,0.413433583965446,15341,-0.0528581996445751,-92
"3761","1143341",0.580227277743042,6195,0.623598133047885,5751,-0.043370855304843,444
"3762","2143341",0.517004105234854,9410,0.567223648407062,8928,-0.0502195431722086,482
"3763","3143341",0.47388989642135,11531,0.538429815207283,10558,-0.0645399187859325,973
"3764","4143341",0.43241556572081,13250,0.496019440085472,12671,-0.063603874364662,579
"3765","1243341",0.526269500150046,8946,0.568293854102179,8873,-0.0420243539521328,73
"3766","2243341",0.463046327641858,11999,0.511919369461356,11937,-0.0488730418194983,62
"3767","3243341",0.419932118828354,13698,0.483125536261576,13215,-0.0631934174332223,483
"3768","4243341",0.378457788127814,14873,0.440715161139766,14694,-0.0622573730119521,179
"3769","1343341",0.49829002987327,10347,0.541243286768881,10408,-0.042953256895611,-61
"3770","2343341",0.435066857365081,13145,0.484868802128058,13145,-0.0498019447629766,0
"3771","3343341",0.391952648551578,14541,0.456074968928278,14208,-0.0641223203767006,333
"3772","4343341",0.350478317851038,15431,0.413664593806468,15334,-0.0631862759554304,97
"3773","1443341",0.459353531888274,12173,0.500613782800775,12465,-0.0412602509125011,-292
"3774","2443341",0.396130359380085,14414,0.444239298159952,14597,-0.0481089387798668,-183
"3775","3443341",0.353016150566582,15391,0.415445464960173,15294,-0.0624293143935909,97
"3776","4443341",0.311541819866042,15942,0.373035089838362,15947,-0.0614932699723206,-5
"3777","1114341",0.688365563258822,1989,0.718380417906749,1850,-0.0300148546479275,139
"3778","2114341",0.625142390750633,4122,0.662005933265926,3882,-0.0368635425152931,240
"3779","3114341",0.582028181937129,6097,0.633212100066146,5258,-0.0511839181290171,839
"3780","4114341",0.54055385123659,8207,0.590801724944336,7561,-0.0502478737077466,646
"3781","1214341",0.634407785665826,3766,0.663076138961043,3836,-0.0286683532952173,-70
"3782","2214341",0.571184613157637,6630,0.60670165432022,6662,-0.0355170411625829,-32
"3783","3214341",0.528070404344133,8845,0.57790782112044,8325,-0.0498374167763069,520
"3784","4214341",0.486596073643593,10926,0.53549744599863,10710,-0.0489013723550366,216
"3785","1314341",0.60642831538905,4957,0.636025571627745,5124,-0.0295972562386956,-167
"3786","2314341",0.543205142880861,8062,0.579651086986922,8216,-0.0364459441060612,-154
"3787","3314341",0.500090934067357,10264,0.550857253787142,9853,-0.0507663197197852,411
"3788","4314341",0.458616603366817,12209,0.508446878665332,12089,-0.0498302752985149,120
"3789","1414341",0.567491817404054,6821,0.595396067659639,7325,-0.0279042502555857,-504
"3790","2414341",0.504268644895865,10047,0.539021583018816,10520,-0.0347529381229514,-473
"3791","3414341",0.461154436082361,12090,0.510227749819037,12021,-0.0490733137366754,69
"3792","4414341",0.419680105381821,13708,0.467817374697226,13829,-0.0481372693154051,-121
"3793","1124341",0.620386292392402,4324,0.657811106249342,4063,-0.0374248138569407,261
"3794","2124341",0.557163119884213,7336,0.601436621608519,6967,-0.0442735017243063,369
"3795","3124341",0.514048911070709,9566,0.57264278840874,8613,-0.0585938773380303,953
"3796","4124341",0.47257458037017,11590,0.530232413286929,10994,-0.0576578329167598,596
"3797","1224341",0.566428514799406,6864,0.602506827303636,6900,-0.0360783125042305,-36
"3798","2224341",0.503205342291217,10107,0.546132342662813,10106,-0.0429270003715961,1
"3799","3224341",0.460091133477713,12138,0.517338509463034,11646,-0.0572473759853201,492
"3800","4224341",0.418616802777173,13736,0.474928134341223,13556,-0.0563113315640498,180
"3801","1324341",0.53844904452263,8304,0.575456259970338,8462,-0.0370072154477088,-158
"3802","2324341",0.475225872014441,11458,0.519081775329515,11551,-0.0438559033150743,-93
"3803","3324341",0.432111663200937,13262,0.490287942129736,12918,-0.0581762789287983,344
"3804","4324341",0.390637332500397,14573,0.447877567007925,14487,-0.0572402345075281,86
"3805","1424341",0.499512546537634,10290,0.534826756002233,10747,-0.0353142094645989,-457
"3806","2424341",0.436289374029445,13087,0.478452271361409,13397,-0.0421628973319646,-310
"3807","3424341",0.393175165215941,14499,0.44965843816163,14429,-0.0564832729456886,70
"3808","4424341",0.351700834515401,15413,0.40724806303982,15462,-0.0555472285244183,-49
"3809","1134341",0.577053770227302,6338,0.619346013801314,5978,-0.0422922435740114,360
"3810","2134341",0.513830597719113,9575,0.56297152916049,9162,-0.049140931441377,413
"3811","3134341",0.47071638890561,11661,0.534177695960711,10782,-0.063461307055101,879
"3812","4134341",0.42924205820507,13370,0.4917673208389,12857,-0.0625252626338307,513
"3813","1234341",0.523095992634306,9087,0.564041734855607,9104,-0.0409457422213014,-17
"3814","2234341",0.459872820126117,12146,0.507667250214784,12133,-0.047794430088667,13
"3815","3234341",0.416758611312614,13791,0.478873417015005,13379,-0.062114805702391,412
"3816","4234341",0.375284280612074,14936,0.436463041893194,14802,-0.0611787612811205,134
"3817","1334341",0.49511652235753,10491,0.536991167522309,10638,-0.0418746451647796,-147
"3818","2334341",0.431893349849341,13273,0.480616682881486,13315,-0.0487233330321452,-42
"3819","3334341",0.388779141035837,14614,0.451822849681707,14355,-0.0630437086458692,259
"3820","4334341",0.347304810335298,15474,0.409412474559896,15417,-0.0621076642245988,57
"3821","1434341",0.456180024372534,12300,0.496361663554204,12655,-0.0401816391816698,-355
"3822","2434341",0.392956851864345,14505,0.43998717891338,14714,-0.0470303270490355,-209
"3823","3434341",0.349842643050842,15441,0.411193345713601,15378,-0.0613507026627594,63
"3824","4434341",0.308368312350302,15970,0.368782970591791,15984,-0.0604146582414891,-14
"3825","1144341",0.528020205772473,8848,0.57894751967423,8264,-0.050927313901757,584
"3826","2144341",0.464797033264284,11919,0.522573035033406,11366,-0.0577760017691225,553
"3827","3144341",0.42168282445078,13629,0.493779201833627,12767,-0.0720963773828465,862
"3828","4144341",0.38020849375024,14835,0.451368826711816,14369,-0.0711603329615761,466
"3829","1244341",0.474062428179477,11521,0.523643240728523,11314,-0.0495808125490467,207
"3830","2244341",0.410839255671288,13970,0.4672687560877,13843,-0.0564295004164123,127
"3831","3244341",0.367725046857784,15106,0.438474922887921,14749,-0.0707498760301364,357
"3832","4244341",0.326250716157244,15774,0.39606454776611,15640,-0.069813831608866,134
"3833","1344341",0.4460829579027,12715,0.496592673395225,12640,-0.050509715492525,75
"3834","2344341",0.382859785394512,14765,0.440218188754402,14708,-0.0573584033598906,57
"3835","3344341",0.339745576581008,15603,0.411424355554623,15374,-0.0716787789736146,229
"3836","4344341",0.298271245880468,16054,0.369013980432812,15979,-0.0707427345523443,75
"3837","1444341",0.407146459917704,14098,0.45596316942712,14214,-0.0488167095094151,-116
"3838","2444341",0.343923287409515,15530,0.399588684786296,15592,-0.0556653973767809,-62
"3839","3444341",0.300809078596012,16034,0.370794851586517,15967,-0.069985772990505,67
"3840","4444341",0.259334747895472,16260,0.328384476464707,16248,-0.0690497285692346,12
"3841","1111441",0.782748705551419,428,0.792721463361181,485,-0.00997275780976226,-57
"3842","2111441",0.71952553304323,1282,0.736346978720358,1394,-0.0168214456771278,-112
"3843","3111441",0.676411324229726,2332,0.707553145520578,2163,-0.0311418212908519,169
"3844","4111441",0.634936993529186,3742,0.665142770398768,3742,-0.0302057768695814,0
"3845","1211441",0.728790927958423,1108,0.737417184415475,1363,-0.00862625645705206,-255
"3846","2211441",0.665567755450234,2646,0.681042699774651,3091,-0.0154749443244176,-445
"3847","3211441",0.62245354663673,4246,0.652248866574872,4313,-0.0297953199381417,-67
"3848","4211441",0.58097921593619,6148,0.609838491453062,6495,-0.0288592755168714,-347
"3849","1311441",0.700811457681646,1677,0.710366617082177,2073,-0.00955515940053031,-396
"3850","2311441",0.637588285173458,3655,0.653992132441353,4235,-0.0164038472678959,-580
"3851","3311441",0.594474076359954,5494,0.625198299241574,5655,-0.0307242228816199,-161
"3852","4311441",0.552999745659414,7543,0.582787924119764,8031,-0.0297881784603496,-488
"3853","1411441",0.66187495969665,2761,0.669737113114071,3522,-0.00786215341742047,-761
"3854","2411441",0.598651787188462,5294,0.613362628473248,6302,-0.0147108412847862,-1008
"3855","3411441",0.555537578374958,7424,0.584568795273468,7915,-0.0290312168985102,-491
"3856","4411441",0.514063247674418,9564,0.542158420151658,10342,-0.0280951724772399,-778
"3857","1121441",0.714769434684999,1373,0.732152151703774,1490,-0.0173827170187755,-117
"3858","2121441",0.65154626217681,3139,0.675777667062951,3298,-0.0242314048861411,-159
"3859","3121441",0.608432053363306,4876,0.646983833863171,4559,-0.0385517804998651,317
"3860","4121441",0.566957722662766,6846,0.604573458741361,6801,-0.0376157360785946,45
"3861","1221441",0.660811657092003,2790,0.676847872758068,3260,-0.0160362156660653,-470
"3862","2221441",0.597588484583814,5347,0.620473388117245,5920,-0.0228849035334309,-573
"3863","3221441",0.55447427577031,7477,0.591679554917465,7517,-0.0372052791471549,-40
"3864","4221441",0.51299994506977,9624,0.549269179795655,9936,-0.0362692347258846,-312
"3865","1321441",0.632832186815226,3814,0.64979730542477,4427,-0.0169651186095435,-613
"3866","2321441",0.569609014307038,6714,0.593422820783947,7437,-0.0238138064769091,-723
"3867","3321441",0.526494805493534,8932,0.564628987584167,9063,-0.0381341820906331,-131
"3868","4321441",0.485020474792994,10996,0.522218612462357,11390,-0.0371981376693628,-394
"3869","1421441",0.59389568883023,5514,0.609167801456664,6544,-0.0152721126264337,-1030
"3870","2421441",0.530672516322042,8700,0.552793316815841,9760,-0.0221208004937994,-1060
"3871","3421441",0.487558307508538,10878,0.523999483616062,11296,-0.0364411761075235,-418
"3872","4421441",0.446083976807998,12714,0.481589108494251,13272,-0.0355051316862531,-558
"3873","1131441",0.671436912519899,2462,0.693687059255745,2617,-0.0222501467358461,-155
"3874","2131441",0.60821374001171,4885,0.637312574614922,5069,-0.0290988346032117,-184
"3875","3131441",0.565099531198207,6932,0.608518741415143,6583,-0.0434192102169357,349
"3876","4131441",0.523625200497667,9058,0.566108366293332,8984,-0.0424831657956655,74
"3877","1231441",0.617479134926903,4443,0.638382780310039,5023,-0.0209036453831362,-580
"3878","2231441",0.554255962418714,7490,0.582008295669216,8083,-0.0277523332505017,-593
"3879","3231441",0.51114175360521,9712,0.553214462469436,9733,-0.0420727088642258,-21
"3880","4231441",0.469667422904671,11707,0.510804087347626,11993,-0.0411366644429553,-286
"3881","1331441",0.589499664650127,5710,0.611332212976741,6424,-0.0218325483266144,-714
"3882","2331441",0.526276492141938,8945,0.554957728335918,9627,-0.02868123619398,-682
"3883","3331441",0.483162283328434,11089,0.526163895136138,11191,-0.043001611807704,-102
"3884","4331441",0.441687952627894,12876,0.483753520014328,13190,-0.0420655673864336,-314
"3885","1431441",0.550563166665131,7672,0.570702709008635,8741,-0.0201395423435046,-1069
"3886","2431441",0.487339994156942,10893,0.514328224367812,11814,-0.0269882302108702,-921
"3887","3431441",0.444225785343438,12791,0.485534391168033,13118,-0.0413086058245942,-327
"3888","4431441",0.402751454642898,14225,0.443124016046222,14632,-0.0403725614033238,-407
"3889","1141441",0.62240334806507,4248,0.653288565128661,4271,-0.0308852170635917,-23
"3890","2141441",0.559180175556881,7216,0.596914080487838,7243,-0.0377339049309573,-27
"3891","3141441",0.516065966743377,9466,0.568120247288058,8880,-0.0520542805446813,586
"3892","4141441",0.474591636042837,11490,0.525709872166248,11216,-0.0511182361234109,274
"3893","1241441",0.568445570472073,6769,0.597984286182955,7181,-0.0295387157108815,-412
"3894","2241441",0.505222397963885,9995,0.541609801542132,10382,-0.0363874035782471,-387
"3895","3241441",0.462108189150381,12044,0.512815968342352,11886,-0.0507077791919712,158
"3896","4241441",0.420633858449841,13664,0.470405593220542,13746,-0.0497717347707008,-82
"3897","1341441",0.540466100195297,8211,0.570933718849657,8728,-0.0304676186543598,-517
"3898","2341441",0.477242927687108,11361,0.514559234208834,11803,-0.0373163065217254,-442
"3899","3341441",0.434128718873605,13181,0.485765401009054,13106,-0.0516366821354494,75
"3900","4341441",0.392654388173065,14517,0.443355025887244,14623,-0.050700637714179,-106
"3901","1441441",0.501529602210301,10195,0.530304214881551,10987,-0.0287746126712499,-792
"3902","2441441",0.438306429702112,13002,0.473929730240728,13604,-0.0356233005386157,-602
"3903","3441441",0.395192220888609,14441,0.445135897040949,14568,-0.0499436761523397,-127
"3904","4441441",0.353717890188069,15369,0.402725521919138,15551,-0.0490076317310693,-182
"3905","1112441",0.74966379378973,790,0.754402481832529,1019,-0.00473868804279909,-229
"3906","2112441",0.686440621281541,2048,0.698027997191705,2480,-0.0115873759101647,-432
"3907","3112441",0.643326412468037,3424,0.669234163991926,3553,-0.0259077515238887,-129
"3908","4112441",0.601852081767497,5138,0.626823788870116,5573,-0.0249717071026182,-435
"3909","1212441",0.695706016196734,1804,0.699098202886823,2439,-0.00339218669008889,-635
"3910","2212441",0.632482843688545,3830,0.642723718245999,4780,-0.0102408745574545,-950
"3911","3212441",0.589368634875041,5718,0.61392988504622,6273,-0.0245612501711785,-555
"3912","4212441",0.547894304174501,7796,0.57151950992441,8690,-0.0236252057499082,-894
"3913","1312441",0.667726545919958,2580,0.672047635553525,3437,-0.00432108963356714,-857
"3914","2312441",0.604503373411769,5030,0.615673150912701,6181,-0.0111697775009327,-1151
"3915","3312441",0.561389164598265,7094,0.586879317712922,7787,-0.0254901531146567,-693
"3916","4312441",0.519914833897725,9238,0.544468942591112,10210,-0.0245541086933865,-972
"3917","1412441",0.628790047934962,3973,0.631418131585419,5340,-0.0026280836504573,-1367
"3918","2412441",0.565566875426773,6912,0.575043646944596,8486,-0.009476771517823,-1574
"3919","3412441",0.522452666613269,9123,0.546249813744816,10097,-0.023797147131547,-974
"3920","4412441",0.480978335912729,11185,0.503839438623006,12307,-0.0228611027102767,-1122
"3921","1122441",0.68168452292331,2180,0.693833170175122,2613,-0.0121486472518123,-433
"3922","2122441",0.618461350415121,4410,0.637458685534299,5064,-0.0189973351191779,-654
"3923","3122441",0.575347141601617,6410,0.608664852334519,6574,-0.0333177107329019,-164
"3924","4122441",0.533872810901078,8516,0.566254477212709,8977,-0.0323816663116314,-461
"3925","1222441",0.627726745330314,4007,0.638528891229416,5017,-0.0108021458991021,-1010
"3926","2222441",0.564503572822125,6954,0.582154406588593,8078,-0.0176508337664677,-1124
"3927","3222441",0.521389364008621,9179,0.553360573388813,9726,-0.0319712093801917,-547
"3928","4222441",0.479915033308081,11222,0.510950198267003,11987,-0.0310351649589214,-765
"3929","1322441",0.599747275053538,5242,0.611478323896118,6419,-0.0117310488425804,-1177
"3930","2322441",0.536524102545349,8392,0.555103839255295,9621,-0.018579736709946,-1229
"3931","3322441",0.493409893731845,10571,0.526310006055515,11183,-0.03290011232367,-612
"3932","4322441",0.451935563031305,12461,0.483899630933705,13185,-0.0319640679023996,-724
"3933","1422441",0.560810777068542,7130,0.570848819928012,8734,-0.0100380428594705,-1604
"3934","2422441",0.497587604560353,10388,0.514474335287189,11810,-0.0168867307268363,-1422
"3935","3422441",0.454473395746849,12364,0.485680502087409,13113,-0.0312071063405603,-749
"3936","4422441",0.412999065046309,13905,0.443270126965599,14629,-0.0302710619192899,-724
"3937","1132441",0.63835200075821,3625,0.655368077727093,4172,-0.017016076968883,-547
"3938","2132441",0.575128828250021,6430,0.59899359308627,7116,-0.0238647648362486,-686
"3939","3132441",0.532014619436518,8623,0.57019975988649,8768,-0.0381851404499726,-145
"3940","4132441",0.490540288735978,10706,0.52778938476468,11109,-0.0372490960287022,-403
"3941","1232441",0.584394223165214,5983,0.600063798781387,7054,-0.015669575616173,-1071
"3942","2232441",0.521171050657025,9189,0.543689314140564,10257,-0.0225182634835386,-1068
"3943","3232441",0.478056841843522,11317,0.514895480940784,11782,-0.0368386390972625,-465
"3944","4232441",0.436582511142982,13074,0.472485105818974,13668,-0.0359025946759922,-594
"3945","1332441",0.556414752888438,7379,0.573013231448089,8595,-0.0165984785596512,-1216
"3946","2332441",0.493191580380249,10590,0.516638746807266,11682,-0.0234471664270168,-1092
"3947","3332441",0.450077371566745,12542,0.487844913607486,13025,-0.0377675420407408,-483
"3948","4332441",0.408603040866206,14041,0.445434538485676,14559,-0.0368314976194704,-518
"3949","1432441",0.517478254903442,9381,0.532383727479983,10873,-0.0149054725765414,-1492
"3950","2432441",0.454255082395253,12376,0.47600924283916,13509,-0.021754160443907,-1133
"3951","3432441",0.41114087358175,13959,0.447215409639381,14508,-0.0360745360576311,-549
"3952","4432441",0.36966654288121,15057,0.40480503451757,15510,-0.0351384916363606,-453
"3953","1142441",0.58931843630338,5720,0.614969583600009,6213,-0.0256511472966285,-493
"3954","2142441",0.526095263795192,8956,0.558595098959186,9418,-0.0324998351639941,-462
"3955","3142441",0.482981054981688,11096,0.529801265759406,11011,-0.0468202107777181,85
"3956","4142441",0.441506724281148,12882,0.487390890637596,13037,-0.0458841663564477,-155
"3957","1242441",0.535360658710385,8448,0.559665304654303,9357,-0.0243046459439183,-909
"3958","2242441",0.472137486202196,11613,0.50329082001348,12335,-0.031153333811284,-722
"3959","3242441",0.429023277388692,13376,0.4744969868137,13577,-0.045473709425008,-201
"3960","4242441",0.387548946688152,14646,0.43208661169189,14929,-0.0445376650037376,-283
"3961","1342441",0.507381188433608,9882,0.532614737321005,10869,-0.0252335488873966,-987
"3962","2342441",0.444158015925419,12795,0.476240252680182,13502,-0.0320822367547622,-707
"3963","3342441",0.401043807111916,14278,0.447446419480402,14503,-0.0464026123684863,-225
"3964","4342441",0.359569476411376,15266,0.405036044358592,15503,-0.0454665679472158,-237
"3965","1442441",0.468444690448612,11761,0.491985233352899,12851,-0.0235405429042868,-1090
"3966","2442441",0.405221517940423,14163,0.435610748712076,14829,-0.0303892307716525,-666
"3967","3442441",0.36210730912692,15224,0.406816915512296,15468,-0.0447096063853765,-244
"3968","4442441",0.32063297842638,15841,0.364406540390486,16026,-0.043773561964106,-185
"3969","1113441",0.710780618217244,1454,0.72890589144329,1565,-0.0181252732260457,-111
"3970","2113441",0.647557445709055,3285,0.672531406802466,3421,-0.0249739610934113,-136
"3971","3113441",0.604443236895552,5034,0.643737573602687,4719,-0.0392943367071353,315
"3972","4113441",0.562968906195012,7015,0.601327198480877,6977,-0.0383582922858648,38
"3973","1213441",0.656822840624248,2927,0.673601612497584,3369,-0.0167787718733355,-442
"3974","2213441",0.593599668116059,5528,0.61722712785676,6096,-0.0236274597407011,-568
"3975","3213441",0.550485459302556,7681,0.588433294656981,7690,-0.0379478353544251,-9
"3976","4213441",0.509011128602016,9800,0.54602291953517,10112,-0.0370117909331549,-312
"3977","1313441",0.628843370347472,3972,0.646551045164286,4582,-0.0177076748168138,-610
"3978","2313441",0.565620197839283,6908,0.590176560523462,7592,-0.0245563626841794,-684
"3979","3313441",0.52250598902578,9118,0.561382727323683,9246,-0.0388767382979034,-128
"3980","4313441",0.48103165832524,11182,0.518972352201873,11556,-0.0379406938766331,-374
"3981","1413441",0.589906872362476,5693,0.60592154119618,6706,-0.016014668833704,-1013
"3982","2413441",0.526683699854287,8925,0.549547056555357,9918,-0.0228633567010696,-993
"3983","3413441",0.483569491040784,11071,0.520753223355577,11458,-0.0371837323147936,-387
"3984","4413441",0.442095160340243,12864,0.478342848233767,13405,-0.0362476878935233,-541
"3985","1123441",0.642801347350824,3453,0.668336579785883,3605,-0.025535232435059,-152
"3986","2123441",0.579578174842635,6229,0.61196209514506,6400,-0.0323839203024245,-171
"3987","3123441",0.536463966029132,8401,0.58316826194528,8004,-0.0467042959161486,397
"3988","4123441",0.494989635328592,10500,0.54075788682347,10436,-0.045768251494878,64
"3989","1223441",0.588843569757828,5737,0.613032300840177,6329,-0.0241887310823488,-592
"3990","2223441",0.525620397249639,8972,0.556657816199354,9535,-0.0310374189497143,-563
"3991","3223441",0.482506188436136,11118,0.527863982999574,11103,-0.0453577945634383,15
"3992","4223441",0.441031857735596,12903,0.485453607877764,13124,-0.044421750142168,-221
"3993","1323441",0.560864099481052,7125,0.585981733506879,7837,-0.025117634025827,-712
"3994","2323441",0.497640926972863,10380,0.529607248866056,11024,-0.0319663218931925,-644
"3995","3323441",0.45452671815936,12361,0.500813415666276,12452,-0.0462866975069166,-91
"3996","4323441",0.41305238745882,13899,0.458403040544466,14142,-0.0453506530856463,-243
"3997","1423441",0.521927601496056,9151,0.545352229538773,10155,-0.0234246280427172,-1004
"3998","2423441",0.458704428987867,12206,0.48897774489795,12983,-0.0302733159100828,-777
"3999","3423441",0.415590220174364,13831,0.46018391169817,14077,-0.0445936915238068,-246
"4000","4423441",0.374115889473824,14961,0.41777353657636,15245,-0.0436576471025365,-284
"4001","1133441",0.599468825185725,5256,0.629871487337854,5417,-0.0304026621521296,-161
"4002","2133441",0.536245652677536,8414,0.573497002697031,8575,-0.0372513500194952,-161
"4003","3133441",0.493131443864032,10595,0.544703169497251,10194,-0.0515717256332192,401
"4004","4133441",0.451657113163492,12473,0.502292794375441,12379,-0.0506356812119489,94
"4005","1233441",0.545511047592728,7934,0.574567208392148,8516,-0.0290561607994196,-582
"4006","2233441",0.482287875084539,11126,0.518192723751325,11606,-0.0359048486667852,-480
"4007","3233441",0.439173666271036,12971,0.489398890551545,12959,-0.0502252242805092,12
"4008","4233441",0.397699335570496,14362,0.446988515429735,14516,-0.0492891798592387,-154
"4009","1333441",0.517531577315952,9380,0.54751664105885,10032,-0.0299850637428979,-652
"4010","2333441",0.454308404807763,12373,0.491142156418027,12882,-0.0368337516102634,-509
"4011","3333441",0.41119419599426,13958,0.462348323218247,14003,-0.0511541272239874,-45
"4012","4333441",0.36971986529372,15055,0.419937948096437,15202,-0.0502180828027169,-147
"4013","1433441",0.478595079330956,11292,0.506887137090744,12170,-0.028292057759788,-878
"4014","2433441",0.415371906822767,13836,0.450512652449921,14400,-0.0351407456271537,-564
"4015","3433441",0.372257698009264,15002,0.421718819250142,15155,-0.0494611212408776,-153
"4016","4433441",0.330783367308724,15720,0.379308444128331,15876,-0.0485250768196071,-156
"4017","1143441",0.550435260730895,7687,0.58947299321077,7637,-0.0390377324798752,50
"4018","2143441",0.487212088222706,10902,0.533098508569947,10843,-0.0458864203472407,59
"4019","3143441",0.444097879409203,12801,0.504304675370167,12282,-0.0602067959609647,519
"4020","4143441",0.402623548708663,14231,0.461894300248357,14018,-0.0592707515396942,213
"4021","1243441",0.496477483137899,10432,0.534168714265064,10784,-0.0376912311271649,-352
"4022","2243441",0.43325431062971,13224,0.477794229624241,13430,-0.0445399189945305,-206
"4023","3243441",0.390140101816207,14590,0.449000396424461,14447,-0.0588602946082545,143
"4024","4243441",0.348665771115667,15462,0.406590021302651,15473,-0.0579242501869842,-11
"4025","1343441",0.468498012861123,11760,0.507118146931766,12159,-0.0386201340706432,-399
"4026","2343441",0.405274840352934,14161,0.450743662290943,14389,-0.0454688219380088,-228
"4027","3343441",0.36216063153943,15223,0.421949829091163,15147,-0.0597891975517327,76
"4028","4343441",0.32068630083889,15839,0.379539453969353,15871,-0.0588531531304624,-32
"4029","1443441",0.429561514876127,13358,0.46648864296366,13869,-0.0369271280875333,-511
"4030","2443441",0.366338342367938,15142,0.410114158322837,15402,-0.043775815954899,-260
"4031","3443441",0.323224133554434,15812,0.381320325123057,15842,-0.058096191568623,-30
"4032","4443441",0.281749802853894,16160,0.338909950001247,16201,-0.0571601471473526,-41
"4033","1114441",0.658573546246674,2873,0.684255278069634,2960,-0.0256817318229595,-87
"4034","2114441",0.595350373738486,5460,0.627880793428811,5514,-0.0325304196903251,-54
"4035","3114441",0.552236164924982,7587,0.599086960229031,7113,-0.0468507953040491,474
"4036","4114441",0.510761834224442,9733,0.556676585107221,9534,-0.0459147508827789,199
"4037","1214441",0.604615768653678,5023,0.628950999123928,5456,-0.0243352304702495,-433
"4038","2214441",0.541392596145489,8156,0.572576514483104,8617,-0.0311839183376151,-461
"4039","3214441",0.498278387331986,10349,0.543782681283325,10248,-0.0455042939513391,101
"4040","4214441",0.456804056631446,12269,0.501372306161515,12426,-0.0445682495300687,-157
"4041","1314441",0.576636298376902,6350,0.60190043179063,6937,-0.0252641334137278,-587
"4042","2314441",0.513413125868713,9601,0.545525947149807,10138,-0.0321128212810934,-537
"4043","3314441",0.47029891705521,11676,0.516732113950027,11680,-0.0464331968948173,-4
"4044","4314441",0.42882458635467,13381,0.474321738828217,13583,-0.045497152473547,-202
"4045","1414441",0.537699800391906,8343,0.561270927822524,9251,-0.023571127430618,-908
"4046","2414441",0.474476627883717,11502,0.504896443181701,12250,-0.0304198152979836,-748
"4047","3414441",0.431362419070214,13290,0.476102609981921,13508,-0.0447401909117076,-218
"4048","4414441",0.389888088369674,14592,0.433692234860111,14876,-0.0438041464904372,-284
"4049","1124441",0.590594275380254,5660,0.623685966412227,5744,-0.0330916910319727,-84
"4050","2124441",0.527371102872066,8883,0.567311481771404,8922,-0.0399403788993383,-39
"4051","3124441",0.484256894058562,11032,0.538517648571624,10551,-0.0542607545130624,481
"4052","4124441",0.442782563358022,12841,0.496107273449814,12665,-0.053324710091792,176
"4053","1224441",0.536636497787258,8384,0.568381687466521,8865,-0.0317451896792628,-481
"4054","2224441",0.473413325279069,11550,0.512007202825698,11932,-0.0385938775466283,-382
"4055","3224441",0.430299116465566,13332,0.483213369625918,13210,-0.0529142531603523,122
"4056","4224441",0.388824785765026,14613,0.440802994504108,14690,-0.0519782087390819,-77
"4057","1324441",0.508657027510482,9815,0.541331120133223,10400,-0.032674092622741,-585
"4058","2324441",0.445433855002293,12736,0.4849566354924,13140,-0.0395227804901065,-404
"4059","3324441",0.40231964618879,14236,0.45616280229262,14202,-0.0538431561038306,34
"4060","4324441",0.36084531548825,15241,0.41375242717081,15330,-0.0529071116825601,-89
"4061","1424441",0.469720529525486,11705,0.500701616165117,12459,-0.0309810866396311,-754
"4062","2424441",0.406497357017297,14118,0.444327131524294,14592,-0.0378297745069968,-474
"4063","3424441",0.363383148203794,15197,0.415533298324515,15289,-0.0521501501207208,-92
"4064","4424441",0.321908817503254,15824,0.373122923202704,15943,-0.0512141056994503,-119
"4065","1134441",0.547261753215155,7834,0.585220873964198,7876,-0.0379591207490436,-42
"4066","2134441",0.484038580706966,11052,0.528846389323375,11060,-0.0448078086164092,-8
"4067","3134441",0.440924371893462,12911,0.500052556123596,12497,-0.0591281842301332,414
"4068","4134441",0.399450041192922,14312,0.457642181001785,14160,-0.0581921398088628,152
"4069","1234441",0.493303975622159,10579,0.529916595018492,11007,-0.0366126193963335,-428
"4070","2234441",0.43008080311397,13341,0.473542110377669,13622,-0.0434613072636991,-281
"4071","3234441",0.386966594300466,14658,0.444748277177889,14579,-0.0577816828774231,79
"4072","4234441",0.345492263599926,15501,0.402337902056079,15559,-0.0568456384561526,-58
"4073","1334441",0.465324505345382,11886,0.502866027685194,12354,-0.0375415223398117,-468
"4074","2334441",0.402101332837194,14247,0.446491543044371,14529,-0.0443902102071773,-282
"4075","3334441",0.35898712402369,15275,0.417697709844591,15246,-0.0587105858209013,29
"4076","4334441",0.31751279332315,15868,0.375287334722781,15920,-0.0577745413996308,-52
"4077","1434441",0.426388007360386,13456,0.462236523717088,14009,-0.0358485163567019,-553
"4078","2434441",0.363164834852198,15203,0.405862039076265,15487,-0.0426972042240675,-284
"4079","3434441",0.320050626038694,15843,0.377068205876486,15899,-0.0570175798377915,-56
"4080","4434441",0.278576295338154,16174,0.334657830754675,16226,-0.0560815354165212,-52
"4081","1144441",0.498228188760325,10356,0.544822379837114,10184,-0.046594191076789,172
"4082","2144441",0.435005016252136,13150,0.488447895196291,13001,-0.0534428789441546,149
"4083","3144441",0.391890807438633,14547,0.459654061996511,14096,-0.0677632545578786,451
"4084","4144441",0.350416476738093,15435,0.417243686874701,15255,-0.0668272101366082,180
"4085","1244441",0.444270411167329,12788,0.489518100891408,12955,-0.0452476897240789,-167
"4086","2244441",0.38104723865914,14810,0.433143616250585,14888,-0.0520963775914445,-78
"4087","3244441",0.337933029845637,15632,0.404349783050805,15514,-0.0664167532051685,118
"4088","4244441",0.296458699145097,16063,0.361939407928995,16052,-0.065480708783898,11
"4089","1344441",0.416290940890553,13805,0.46246753355811,13999,-0.0461765926675572,-194
"4090","2344441",0.353067768382364,15389,0.406093048917287,15483,-0.0530252805349227,-94
"4091","3344441",0.309953559568861,15957,0.377299215717507,15895,-0.0673456561486467,62
"4092","4344441",0.268479228868321,16226,0.334888840595697,16223,-0.0664096117273764,3
"4093","1444441",0.377354442905557,14901,0.421838029590004,15151,-0.0444835866844473,-250
"4094","2444441",0.314131270397368,15913,0.365463544949181,16013,-0.0513322745518129,-100
"4095","3444441",0.271017061583865,16217,0.336669711749402,16214,-0.065652650165537,3
"4096","4444441",0.229542730883325,16333,0.294259336627591,16339,-0.0647166057442666,-6
"4097","1111112",0.955911469306919,3,0.95848251452197,3,-0.00257104521505092,0
"4098","2111112",0.89268829679873,30,0.902108029881146,26,-0.0094197330824165,4
"4099","3111112",0.849574087985226,96,0.873314196681367,68,-0.0237401086961405,28
"4100","4111112",0.808099757284687,260,0.830903821559557,212,-0.0228040642748701,48
"4101","1211112",0.901953691713923,20,0.903178235576264,24,-0.00122454386234083,-4
"4102","2211112",0.838730519205734,127,0.84680375093544,137,-0.00807323172970642,-10
"4103","3211112",0.79561631039223,334,0.818009917735661,283,-0.0223936073434304,51
"4104","4211112",0.75414197969169,730,0.77559954261385,688,-0.0214575629221601,42
"4105","1311112",0.873974221437147,53,0.876127668242966,62,-0.00215344680581908,-9
"4106","2311112",0.810751048928958,246,0.819753183602142,272,-0.00900213467318467,-26
"4107","3311112",0.767636840115454,578,0.790959350402363,501,-0.0233225102869087,77
"4108","4311112",0.726162509414914,1157,0.748548975280553,1133,-0.0223864658656383,24
"4109","1411112",0.83503772345215,141,0.83549816427486,186,-0.00046044082270924,-45
"4110","2411112",0.771814550943962,529,0.779123679634037,649,-0.00730912869007494,-120
"4111","3411112",0.728700342130458,1109,0.750329846434257,1097,-0.021629504303799,12
"4112","4411112",0.687226011429918,2020,0.707919471312447,2149,-0.0206934598825286,-129
"4113","1121112",0.887932198440499,34,0.897913202864563,32,-0.00998100442406413,2
"4114","2121112",0.82470902593231,181,0.84153871822374,161,-0.0168296922914297,20
"4115","3121112",0.781594817118807,437,0.81274488502396,315,-0.0311500679051537,122
"4116","4121112",0.740120486418267,924,0.77033450990215,769,-0.0302140234838834,155
"4117","1221112",0.833974420847503,144,0.842608923918857,156,-0.00863450307135405,-12
"4118","2221112",0.770751248339314,542,0.786234439278033,566,-0.0154831909387196,-24
"4119","3221112",0.72763703952581,1123,0.757440606078254,972,-0.0298035665524436,151
"4120","4221112",0.68616270882527,2052,0.715030230956444,1936,-0.0288675221311733,116
"4121","1321112",0.805994950570727,271,0.815558356585559,299,-0.0095634060148323,-28
"4122","2321112",0.742771778062538,887,0.759183871944736,945,-0.0164120938821979,-58
"4123","3321112",0.699657569249034,1702,0.730390038744956,1517,-0.0307324694959219,185
"4124","4321112",0.658183238548494,2884,0.687979663623146,2810,-0.0297964250746515,74
"4125","1421112",0.767058452585731,581,0.774928852617453,697,-0.00787040003172246,-116
"4126","2421112",0.703835280077542,1615,0.71855436797663,1840,-0.0147190878990882,-225
"4127","3421112",0.660721071264038,2791,0.68976053477685,2751,-0.0290394635128122,40
"4128","4421112",0.619246740563498,4377,0.64735015965504,4541,-0.0281034190915418,-164
"4129","1131112",0.844599676275399,114,0.859448110416534,98,-0.0148484341411349,16
"4130","2131112",0.78137650376721,439,0.803073625775711,399,-0.0216971220085005,40
"4131","3131112",0.738262294953707,956,0.774279792575931,711,-0.0360174976222245,245
"4132","4131112",0.696787964253167,1783,0.731869417454121,1498,-0.0350814532009541,285
"4133","1231112",0.790641898682403,372,0.804143831470828,392,-0.0135019327884248,-20
"4134","2231112",0.727418726174214,1127,0.747769346830005,1152,-0.0203506206557904,-25
"4135","3231112",0.684304517360711,2098,0.718975513630225,1828,-0.0346709962695144,270
"4136","4231112",0.642830186660171,3452,0.676565138508415,3270,-0.033734951848244,182
"4137","1331112",0.762662428405627,632,0.77709326413753,675,-0.0144308357319031,-43
"4138","2331112",0.699439255897438,1708,0.720718779496707,1787,-0.0212795235992687,-79
"4139","3331112",0.656325047083935,2945,0.691924946296927,2673,-0.0355998992129927,272
"4140","4331112",0.614850716383395,4561,0.649514571175117,4433,-0.0346638547917223,128
"4141","1431112",0.723725930420631,1197,0.736463760169424,1390,-0.0127378297487932,-193
"4142","2431112",0.660502757912442,2800,0.680089275528601,3133,-0.0195865176161589,-333
"4143","3431112",0.617388549098939,4451,0.651295442328822,4355,-0.0339068932298829,96
"4144","4431112",0.575914218398399,6388,0.608885067207011,6558,-0.0329708488086126,-170
"4145","1141112",0.79556611182057,338,0.81904961628945,278,-0.0234835044688804,60
"4146","2141112",0.732342939312381,1054,0.762675131648627,896,-0.030332192336246,158
"4147","3141112",0.689228730498877,1962,0.733881298448847,1438,-0.04465256794997,524
"4148","4141112",0.647754399798337,3272,0.691470923327037,2693,-0.0437165235286996,579
"4149","1241112",0.741608334227574,898,0.763745337343744,877,-0.0221370031161703,21
"4150","2241112",0.678385161719385,2277,0.70737085270292,2167,-0.0289856909835359,110
"4151","3241112",0.635270952905881,3733,0.678577019503141,3184,-0.0433060665972599,549
"4152","4241112",0.593796622205341,5517,0.636166644381331,5116,-0.0423700221759895,401
"4153","1341112",0.713628863950797,1395,0.736694770010446,1383,-0.0230659060596485,12
"4154","2341112",0.650405691442609,3176,0.680320285369623,3121,-0.0299145939270141,55
"4155","3341112",0.607291482629105,4919,0.651526452169843,4339,-0.0442349695407381,580
"4156","4341112",0.565817151928565,6896,0.609116077048033,6548,-0.0432989251194678,348
"4157","1441112",0.674692365965801,2378,0.69606526604234,2536,-0.0213729000765387,-158
"4158","2441112",0.611469193457613,4731,0.639690781401517,4937,-0.0282215879439044,-206
"4159","3441112",0.568354984644109,6776,0.610896948201737,6443,-0.0425419635576284,333
"4160","4441112",0.526880653943569,8911,0.568486573079927,8862,-0.041605919136358,49
"4161","1112112",0.92282655754523,12,0.920163532993318,13,0.00266302455191225,-1
"4162","2112112",0.859603385037041,76,0.863789048352494,87,-0.00418566331545334,-11
"4163","3112112",0.816489176223538,214,0.834995215152715,188,-0.0185060389291773,26
"4164","4112112",0.775014845522998,499,0.792584840030905,486,-0.017569994507907,13
"4165","1212112",0.868868779952234,60,0.864859254047611,85,0.00400952590462234,-25
"4166","2212112",0.805645607444045,275,0.808484769406788,355,-0.00283916196274325,-80
"4167","3212112",0.762531398630541,633,0.779690936207009,640,-0.0171595375764673,-7
"4168","4212112",0.721057067930001,1251,0.737280561085198,1368,-0.0162234931551969,-117
"4169","1312112",0.840889309675458,122,0.837808686714314,174,0.00308062296114409,-52
"4170","2312112",0.777666137167269,474,0.78143420207349,618,-0.0037680649062215,-144
"4171","3312112",0.734551928353765,1018,0.752640368873711,1047,-0.0180884405199455,-29
"4172","4312112",0.693077597653225,1872,0.7102299937519,2076,-0.0171523960986751,-204
"4173","1412112",0.801952811690462,299,0.797179182746208,441,0.00477362894425393,-142
"4174","2412112",0.738729639182273,944,0.740804698105385,1297,-0.00207505892311177,-353
"4175","3412112",0.695615430368769,1807,0.712010864905605,2011,-0.0163954345368358,-204
"4176","4412112",0.654141099668229,3029,0.669600489783795,3533,-0.0154593901155654,-504
"4177","1122112",0.85484728667881,85,0.859594221335911,96,-0.00474693465710097,-11
"4178","2122112",0.791624114170621,366,0.803219736695088,398,-0.0115956225244666,-32
"4179","3122112",0.748509905357118,807,0.774425903495308,705,-0.0259159981381906,102
"4180","4122112",0.707035574656578,1543,0.732015528373498,1495,-0.0249799537169202,48
"4181","1222112",0.800889509085814,303,0.804289942390205,390,-0.00340043330439088,-87
"4182","2222112",0.737666336577625,963,0.747915457749381,1151,-0.0102491211717565,-188
"4183","3222112",0.694552127764121,1826,0.719121624549602,1825,-0.0245694967854805,1
"4184","4222112",0.653077797063581,3071,0.676711249427792,3266,-0.0236334523642101,-195
"4185","1322112",0.772910038809038,520,0.777239375056907,674,-0.00432933624786913,-154
"4186","2322112",0.709686866300849,1482,0.720864890416083,1784,-0.0111780241152347,-302
"4187","3322112",0.666572657487345,2611,0.692071057216304,2667,-0.0254983997289587,-56
"4188","4322112",0.625098326786805,4124,0.649660682094494,4431,-0.0245623553076884,-307
"4189","1422112",0.733973540824042,1024,0.736609871088801,1384,-0.00263633026475929,-360
"4190","2422112",0.670750368315853,2480,0.680235386447978,3126,-0.00948501813212499,-646
"4191","3422112",0.627636159502349,4009,0.651441553248198,4343,-0.023805393745849,-334
"4192","4422112",0.586161828801809,5879,0.609031178126388,6550,-0.0228693493245786,-671
"4193","1132112",0.81151476451371,241,0.821129128887882,264,-0.00961436437417174,-23
"4194","2132112",0.748291592005521,810,0.764754644247059,859,-0.0164630522415373,-49
"4195","3132112",0.705177383192018,1587,0.735960811047279,1401,-0.0307834278552613,186
"4196","4132112",0.663703052491478,2711,0.693550435925469,2622,-0.029847383433991,89
"4197","1232112",0.757556986920714,690,0.765824849942176,848,-0.00826786302146165,-158
"4198","2232112",0.694333814412525,1835,0.709450365301353,2103,-0.0151165508888272,-268
"4199","3232112",0.651219605599022,3149,0.680656532101573,3106,-0.0294369265025513,43
"4200","4232112",0.609745274898482,4810,0.638246156979763,5029,-0.0285008820812809,-219
"4201","1332112",0.729577516643938,1099,0.738774282608878,1337,-0.0091967659649399,-238
"4202","2332112",0.666354344135749,2621,0.682399797968055,3028,-0.0160454538323055,-407
"4203","3332112",0.623240135322246,4215,0.653605964768275,4252,-0.0303658294460295,-37
"4204","4332112",0.581765804621706,6103,0.611195589646465,6428,-0.0294297850247591,-325
"4205","1432112",0.690641018658942,1939,0.698144778640772,2476,-0.00750375998183006,-537
"4206","2432112",0.627417846150753,4022,0.641770293999949,4828,-0.0143524478491958,-806
"4207","3432112",0.58430363733725,5990,0.612976460800169,6333,-0.0286728234629198,-343
"4208","4432112",0.54282930663671,8077,0.570566085678359,8748,-0.0277367790416494,-671
"4209","1142112",0.762481200058881,636,0.780730634760798,632,-0.0182494347019172,4
"4210","2142112",0.699258027550692,1712,0.724356150119975,1689,-0.0250981225692828,23
"4211","3142112",0.656143818737188,2946,0.695562316920195,2554,-0.0394184981830068,392
"4212","4142112",0.614669488036648,4568,0.653151941798385,4275,-0.0384824537617364,293
"4213","1242112",0.708523422465885,1507,0.725426355815092,1661,-0.0169029333492071,-154
"4214","2242112",0.645300249957696,3359,0.669051871174268,3563,-0.0237516212165727,-204
"4215","3242112",0.602186041144192,5124,0.640258037974489,4901,-0.0380719968302967,223
"4216","4242112",0.560711710443652,7134,0.597847662852679,7191,-0.0371359524090263,-57
"4217","1342112",0.680543952189108,2212,0.698375788481794,2464,-0.0178318362926854,-252
"4218","2342112",0.61732077968092,4455,0.64200130384097,4813,-0.024680524160051,-358
"4219","3342112",0.574206570867416,6467,0.613207470641191,6311,-0.039000899773775,156
"4220","4342112",0.532732240166876,8585,0.570797095519381,8736,-0.0380648553525046,-151
"4221","1442112",0.641607454204112,3504,0.657746284513688,4066,-0.0161388303095755,-562
"4222","2442112",0.578384281695924,6280,0.601371799872865,6972,-0.0229875181769412,-692
"4223","3442112",0.53527007288242,8450,0.572577966673085,8616,-0.0373078937906652,-166
"4224","4442112",0.49379574218188,10555,0.530167591551275,10996,-0.0363718493693949,-441
"4225","1113112",0.883943381972744,38,0.894666942604079,36,-0.0107235606313344,2
"4226","2113112",0.820720209464555,193,0.838292457963255,173,-0.0175722484987,20
"4227","3113112",0.777606000651052,475,0.809498624763476,341,-0.031892624112424,134
"4228","4113112",0.736131669950512,992,0.767088249641666,822,-0.0309565796911535,170
"4229","1213112",0.829985604379748,159,0.839362663658372,166,-0.0093770592786242,-7
"4230","2213112",0.766762431871559,584,0.782988179017549,598,-0.0162257471459898,-14
"4231","3213112",0.723648223058056,1200,0.75419434581777,1021,-0.0305461227597138,179
"4232","4213112",0.682173892357516,2162,0.711783970695959,2020,-0.0296100783384435,142
"4233","1313112",0.802006134102972,298,0.812312096325075,319,-0.0103059622221024,-21
"4234","2313112",0.738782961594783,942,0.755937611684251,993,-0.017154650089468,-51
"4235","3313112",0.69566875278128,1806,0.727143778484472,1605,-0.031475025703192,201
"4236","4313112",0.65419442208074,3024,0.684733403362661,2937,-0.0305389812819218,87
"4237","1413112",0.763069636117976,626,0.771682592356969,743,-0.00861295623899261,-117
"4238","2413112",0.699846463609787,1696,0.715308107716146,1924,-0.0154616441063583,-228
"4239","3413112",0.656732254796284,2931,0.686514274516366,2871,-0.0297820197200823,60
"4240","4413112",0.615257924095744,4544,0.644103899394556,4693,-0.0288459752988121,-149
"4241","1123112",0.815964111106324,216,0.834097630946672,197,-0.0181335198403476,19
"4242","2123112",0.752740938598135,749,0.777723146305849,669,-0.0249822077077132,80
"4243","3123112",0.709626729784632,1484,0.748929313106069,1125,-0.0393025833214372,359
"4244","4123112",0.668152399084092,2570,0.706518937984259,2207,-0.0383665389001667,363
"4245","1223112",0.762006333513328,639,0.778793352000966,655,-0.0167870184876374,-16
"4246","2223112",0.698783161005139,1718,0.722418867360142,1741,-0.023635706355003,-23
"4247","3223112",0.655668952191636,2959,0.693625034160363,2618,-0.037956081968727,341
"4248","4223112",0.614194621491096,4600,0.651214659038553,4360,-0.0370200375474568,240
"4249","1323112",0.734026863236552,1023,0.751742784667668,1069,-0.0177159214311157,-46
"4250","2323112",0.670803690728363,2479,0.695368300026844,2564,-0.0245646092984813,-85
"4251","3323112",0.62768948191486,4008,0.666574466827065,3663,-0.0388849849122053,345
"4252","4323112",0.58621515121432,5875,0.624164091705255,5713,-0.037948940490935,162
"4253","1423112",0.695090365251556,1814,0.711113280699562,2046,-0.0160229154480058,-232
"4254","2423112",0.631867192743367,3849,0.654738796058739,4199,-0.0228716033153715,-350
"4255","3423112",0.588752983929864,5742,0.625944962858959,5617,-0.0371919789290955,125
"4256","4423112",0.547278653229324,7831,0.583534587737149,7978,-0.0362559345078253,-147
"4257","1133112",0.772631588941225,524,0.795632538498643,460,-0.0230009495574183,64
"4258","2133112",0.709408416433036,1489,0.73925805385782,1331,-0.0298496374247839,158
"4259","3133112",0.666294207619532,2623,0.71046422065804,2070,-0.0441700130385079,553
"4260","4133112",0.624819876918992,4140,0.66805384553623,3613,-0.0432339686172376,527
"4261","1233112",0.718673811348228,1292,0.740328259552937,1310,-0.0216544482047083,-18
"4262","2233112",0.65545063884004,2971,0.683953774912114,2969,-0.0285031360720739,2
"4263","3233112",0.612336430026536,4690,0.655159941712334,4180,-0.0428235116857979,510
"4264","4233112",0.570862099325996,6642,0.612749566590524,6344,-0.0418874672645274,298
"4265","1333112",0.690694341071452,1936,0.713277692219639,1976,-0.0225833511481865,-40
"4266","2333112",0.627471168563263,4020,0.656903207578816,4106,-0.0294320390155521,-86
"4267","3333112",0.58435695974976,5986,0.628109374379036,5495,-0.0437524146292761,491
"4268","4333112",0.54288262904922,8075,0.585698999257226,7848,-0.0428163702080057,227
"4269","1433112",0.651757843086456,3126,0.672648188251533,3413,-0.0208903451650767,-287
"4270","2433112",0.588534670578267,5753,0.61627370361071,6158,-0.0277390330324424,-405
"4271","3433112",0.545420461764764,7942,0.58747987041093,7742,-0.0420594086461664,200
"4272","4433112",0.503946131064224,10065,0.54506949528912,10167,-0.0411233642248959,-102
"4273","1143112",0.723598024486395,1204,0.755234044371559,1004,-0.0316360198851638,200
"4274","2143112",0.660374851978206,2805,0.698859559730736,2444,-0.0384847077525294,361
"4275","3143112",0.617260643164703,4456,0.670065726530956,3506,-0.0528050833662534,950
"4276","4143112",0.575786312464163,6391,0.627655351409146,5527,-0.051869038944983,864
"4277","1243112",0.669640246893399,2519,0.699929765425853,2411,-0.0302895185324537,108
"4278","2243112",0.60641707438521,4959,0.64355528078503,4729,-0.0371382063998192,230
"4279","3243112",0.563302865571707,6998,0.61476144758525,6222,-0.0514585820135433,776
"4280","4243112",0.521828534871167,9154,0.57235107246344,8631,-0.050522537592273,523
"4281","1343112",0.641660776616623,3500,0.672879198092555,3399,-0.0312184214759319,101
"4282","2343112",0.578437604108434,6279,0.616504713451732,6140,-0.0380671093432975,139
"4283","3343112",0.535323395294931,8449,0.587710880251952,7723,-0.0523874849570215,726
"4284","4343112",0.49384906459439,10552,0.545300505130142,10156,-0.0514514405357512,396
"4285","1443112",0.602724278631627,5103,0.632249694124449,5302,-0.0295254154928221,-199
"4286","2443112",0.539501106123438,8253,0.575875209483626,8433,-0.0363741033601878,-180
"4287","3443112",0.496386897309935,10437,0.547081376283846,10051,-0.0506944789739118,386
"4288","4443112",0.454912566609395,12347,0.504671001162036,12262,-0.0497584345526415,85
"4289","1114112",0.831736310002175,153,0.850016329230423,125,-0.0182800192282483,28
"4290","2114112",0.768513137493986,568,0.7936418445896,472,-0.0251287070956139,96
"4291","3114112",0.725398928680482,1174,0.76484801138982,857,-0.0394490827093379,317
"4292","4114112",0.683924597979942,2104,0.72243763626801,1740,-0.0385130382880675,364
"4293","1214112",0.777778532409178,471,0.794712050284717,465,-0.0169335178755382,6
"4294","2214112",0.71455535990099,1377,0.738337565643893,1344,-0.0237822057429038,33
"4295","3214112",0.671441151087486,2461,0.709543732444114,2097,-0.0381025813566278,364
"4296","4214112",0.629966820386946,3916,0.667133357322303,3645,-0.0371665369353574,271
"4297","1314112",0.749799062132402,785,0.767661482951419,804,-0.0178624208190165,-19
"4298","2314112",0.686575889624213,2039,0.711286998310595,2037,-0.024711108686382,2
"4299","3314112",0.64346168081071,3419,0.682493165110816,3023,-0.0390314843001061,396
"4300","4314112",0.60198735011017,5135,0.640082789989006,4911,-0.0380954398788357,224
"4301","1414112",0.710862564147406,1450,0.727031978983313,1613,-0.0161694148359066,-163
"4302","2414112",0.647639391639217,3279,0.67065749434249,3483,-0.0230181027032723,-204
"4303","3414112",0.604525182825714,5029,0.64186366114271,4821,-0.0373384783169963,208
"4304","4414112",0.563050852125174,7012,0.5994532860209,7086,-0.036402433895726,-74
"4305","1124112",0.763757039135755,620,0.789447017573016,525,-0.0256899784372615,95
"4306","2124112",0.700533866627566,1681,0.733072532932193,1464,-0.0325386663046271,217
"4307","3124112",0.657419657814062,2910,0.704278699732413,2268,-0.0468590419183511,642
"4308","4124112",0.615945327113522,4500,0.661868324610603,3892,-0.0459229974970807,608
"4309","1224112",0.709799261542758,1474,0.73414273862731,1434,-0.0243434770845514,40
"4310","2224112",0.64657608903457,3312,0.677768253986487,3216,-0.031192164951917,96
"4311","3224112",0.603461880221066,5066,0.648974420786707,4458,-0.045512540565641,608
"4312","4224112",0.561987549520526,7063,0.606564045664897,6670,-0.0445764961443706,393
"4313","1324112",0.681819791265982,2171,0.707092171294012,2180,-0.0252723800280297,-9
"4314","2324112",0.618596618757793,4399,0.650717686653189,4385,-0.0321210678953953,14
"4315","3324112",0.57548240994429,6400,0.621923853453409,5831,-0.0464414435091193,569
"4316","4324112",0.53400807924375,8509,0.579513478331599,8223,-0.0455053990878489,286
"4317","1424112",0.642883293280986,3446,0.666462667325906,3670,-0.0235793740449198,-224
"4318","2424112",0.579660120772797,6221,0.610088182685083,6479,-0.0304280619122855,-258
"4319","3424112",0.536545911959294,8389,0.581294349485303,8116,-0.0447484375260095,273
"4320","4424112",0.495071581258754,10495,0.538883974363493,10526,-0.0438123931047392,-31
"4321","1134112",0.720424516970655,1270,0.750981925124987,1082,-0.0305574081543323,188
"4322","2134112",0.657201344462466,2917,0.694607440484164,2588,-0.0374060960216979,329
"4323","3134112",0.614087135648963,4610,0.665813607284384,3703,-0.0517264716354219,907
"4324","4134112",0.572612804948423,6555,0.623403232162574,5761,-0.0507904272141515,794
"4325","1234112",0.666466739377659,2616,0.695677646179281,2552,-0.0292109068016222,64
"4326","2234112",0.60324356686947,5078,0.639303161538458,4965,-0.0360595946689878,113
"4327","3234112",0.560129358055966,7169,0.610509328338678,6456,-0.0503799702827118,713
"4328","4234112",0.518655027355426,9299,0.568098953216868,8881,-0.0494439258614414,418
"4329","1334112",0.638487269100883,3619,0.668627078845983,3586,-0.0301398097451004,33
"4330","2334112",0.575264096592694,6417,0.61225259420516,6375,-0.036988497612466,42
"4331","3334112",0.53214988777919,8617,0.58345876100538,7980,-0.05130887322619,637
"4332","4334112",0.49067555707865,10701,0.54104838588357,10418,-0.0503728288049197,283
"4333","1434112",0.599550771115887,5252,0.627997574877877,5503,-0.0284468037619906,-251
"4334","2434112",0.536327598607698,8408,0.571623090237054,8682,-0.0352954916293563,-274
"4335","3434112",0.493213389794194,10587,0.542829257037275,10296,-0.0496158672430803,291
"4336","4434112",0.451739059093654,12470,0.500418881915464,12471,-0.04867982282181,-1
"4337","1144112",0.671390952515825,2466,0.710583430997903,2065,-0.0391924784820777,401
"4338","2144112",0.608167780007636,4886,0.65420894635708,4229,-0.0460411663494433,657
"4339","3144112",0.565053571194133,6934,0.6254151131573,5644,-0.0603615419631673,1290
"4340","4144112",0.523579240493593,9059,0.58300473803549,8019,-0.059425497541897,1040
"4341","1244112",0.617433174922829,4447,0.655279152052197,4174,-0.0378459771293677,273
"4342","2244112",0.55421000241464,7493,0.598904667411374,7118,-0.0446946649967332,375
"4343","3244112",0.511095793601137,9715,0.570110834211594,8771,-0.0590150406104573,944
"4344","4244112",0.469621462900597,11709,0.527700459089784,11112,-0.0580789961891869,597
"4345","1344112",0.589453704646053,5713,0.628228584718899,5489,-0.0387748800728459,224
"4346","2344112",0.526230532137864,8949,0.571854100078076,8665,-0.0456235679402115,284
"4347","3344112",0.483116323324361,11090,0.543060266878296,10282,-0.0599439435539355,808
"4348","4344112",0.441641992623821,12878,0.500649891756486,12463,-0.0590078991326652,415
"4349","1444112",0.550517206661057,7678,0.587599080750793,7731,-0.0370818740897361,-53
"4350","2444112",0.487294034152868,10896,0.53122459610997,10927,-0.0439305619571018,-31
"4351","3444112",0.444179825339365,12793,0.50243076291019,12371,-0.0582509375708258,422
"4352","4444112",0.402705494638825,14227,0.46002038778838,14082,-0.0573148931495555,145
"4353","1111212",0.910062635158709,18,0.913147667867188,17,-0.00308503270847915,1
"4354","2111212",0.84683946265052,106,0.856773183226365,102,-0.00993372057584474,4
"4355","3111212",0.803725253837016,289,0.827979350026585,225,-0.0242540961895688,64
"4356","4111212",0.762250923136476,637,0.785568974904775,573,-0.0233180517682984,64
"4357","1211212",0.856104857565713,82,0.857843388921482,99,-0.00173853135576907,-17
"4358","2211212",0.792881685057524,355,0.801468904280658,410,-0.00858721922313466,-55
"4359","3211212",0.74976747624402,786,0.772675071080879,730,-0.0229075948368587,56
"4360","4211212",0.70829314554348,1512,0.730264695959069,1522,-0.0219715504155883,-10
"4361","1311212",0.828125387288936,167,0.830792821588184,213,-0.00266743429924732,-46
"4362","2311212",0.764902214780747,612,0.77441833694736,707,-0.00951612216661291,-95
"4363","3311212",0.721788005967244,1238,0.745624503747581,1195,-0.0238364977803369,43
"4364","4311212",0.680313675266704,2219,0.703214128625771,2308,-0.0229004533590665,-89
"4365","1411212",0.78918888930394,385,0.790163317620078,515,-0.000974428316137477,-130
"4366","2411212",0.725965716795752,1160,0.733788832979255,1441,-0.00782311618350318,-281
"4367","3411212",0.682851507982248,2138,0.704994999779475,2250,-0.0221434917972272,-112
"4368","4411212",0.641377177281708,3512,0.662584624657665,3855,-0.0212074473759568,-343
"4369","1121212",0.842083364292289,121,0.852578356209781,114,-0.0104949919174924,7
"4370","2121212",0.7788601917841,463,0.796203871568958,451,-0.017343679784858,12
"4371","3121212",0.735745982970596,999,0.767410038369178,811,-0.031664055398582,188
"4372","4121212",0.694271652270056,1837,0.724999663247368,1676,-0.0307280109773116,161
"4373","1221212",0.788125586699293,388,0.797274077264075,438,-0.00914849056478229,-50
"4374","2221212",0.724902414191104,1178,0.740899592623252,1293,-0.0159971784321479,-115
"4375","3221212",0.6817882053776,2173,0.712105759423472,2005,-0.0303175540458719,168
"4376","4221212",0.64031387467706,3553,0.669695384301662,3524,-0.0293815096246015,29
"4377","1321212",0.760146116422516,668,0.770223509930777,771,-0.0100773935082605,-103
"4378","2321212",0.696922943914328,1779,0.713849025289954,1968,-0.0169260813756261,-189
"4379","3321212",0.653808735100824,3041,0.685055192090174,2926,-0.0312464569893501,115
"4380","4321212",0.612334404400284,4691,0.642644816968364,4782,-0.0303104125680798,-91
"4381","1421212",0.72120961843752,1250,0.729594005962671,1539,-0.00838438752515069,-289
"4382","2421212",0.657986445929332,2890,0.673219521321848,3386,-0.0152330753925164,-496
"4383","3421212",0.614872237115828,4558,0.644425688122068,4678,-0.0295534510062404,-120
"4384","4421212",0.573397906415288,6512,0.602015313000258,6932,-0.02861740658497,-420
"4385","1131212",0.798750842127189,322,0.814113263761752,306,-0.0153624216345631,16
"4386","2131212",0.735527669619,1006,0.757738779120929,967,-0.0222111095019287,39
"4387","3131212",0.692413460805497,1897,0.72894494592115,1563,-0.0365314851156527,334
"4388","4131212",0.650939130104957,3157,0.686534570799339,2870,-0.0355954406943824,287
"4389","1231212",0.744793064534193,857,0.758808984816046,954,-0.0140159202818531,-97
"4390","2231212",0.681569892026004,2183,0.702434500175223,2342,-0.0208646081492186,-159
"4391","3231212",0.638455683212501,3621,0.673640666975443,3367,-0.0351849837629427,254
"4392","4231212",0.596981352511961,5374,0.631230291853633,5348,-0.0342489393416723,26
"4393","1331212",0.716813594257417,1322,0.731758417482748,1501,-0.0149448232253313,-179
"4394","2331212",0.653590421749228,3053,0.675383932841925,3310,-0.0217935110926969,-257
"4395","3331212",0.610476212935724,4771,0.646590099642145,4580,-0.0361138867064209,191
"4396","4331212",0.569001882235184,6735,0.604179724520335,6816,-0.0351778422851505,-81
"4397","1431212",0.677877096272421,2291,0.691128913514642,2701,-0.0132518172422215,-410
"4398","2431212",0.614653923764232,4570,0.634754428873819,5194,-0.0201005051095872,-624
"4399","3431212",0.571539714950728,6607,0.60596059567404,6703,-0.0344208807233112,-96
"4400","4431212",0.530065384250188,8731,0.563550220552229,9125,-0.0334848363020408,-394
"4401","1141212",0.74971727767236,788,0.773714769634668,718,-0.0239974919623086,70
"4402","2141212",0.686494105164171,2045,0.717340284993845,1878,-0.0308461798296742,167
"4403","3141212",0.643379896350667,3421,0.688546451794065,2792,-0.0451665554433982,629
"4404","4141212",0.601905565650127,5136,0.646136076672255,4601,-0.0442305110221278,535
"4405","1241212",0.695759500079363,1801,0.718410490688962,1846,-0.0226509906095985,-45
"4406","2241212",0.632536327571175,3825,0.662036006048139,3878,-0.0294996784769641,-53
"4407","3241212",0.589422118757671,5715,0.633242172848359,5255,-0.0438200540906881,460
"4408","4241212",0.547947788057131,7795,0.590831797726549,7554,-0.0428840096694177,241
"4409","1341212",0.667780029802587,2579,0.691359923355664,2697,-0.0235798935530768,-118
"4410","2341212",0.604556857294398,5027,0.634985438714841,5180,-0.0304285814204424,-153
"4411","3341212",0.561442648480895,7090,0.606191605515061,6690,-0.0447489570341664,400
"4412","4341212",0.519968317780355,9236,0.563781230393251,9118,-0.043812912612896,118
"4413","1441212",0.628843531817591,3971,0.650730419387558,4382,-0.0218868875699669,-411
"4414","2441212",0.565620359309402,6907,0.594355934746735,7381,-0.0287355754373326,-474
"4415","3441212",0.522506150495899,9117,0.565562101546956,9012,-0.0430559510510566,105
"4416","4441212",0.481031819795359,11181,0.523151726425145,11337,-0.0421199066297863,-156
"4417","1112212",0.87697772339702,48,0.874828686338536,66,0.00214903705848402,-18
"4418","2112212",0.813754550888831,230,0.818454201697712,281,-0.00469965080888157,-51
"4419","3112212",0.770640342075327,548,0.789660368497933,520,-0.0190200264226056,28
"4420","4112212",0.729166011374787,1100,0.747249993376123,1163,-0.0180839820013352,-63
"4421","1212212",0.823019945804024,184,0.81952440739283,275,0.0034955384111941,-91
"4422","2212212",0.759796773295835,672,0.763149922752006,888,-0.00335314945617149,-216
"4423","3212212",0.716682564482331,1330,0.734356089552227,1429,-0.0176735250698955,-99
"4424","4212212",0.675208233781791,2358,0.691945714430416,2671,-0.0167374806486251,-313
"4425","1312212",0.795040475527247,340,0.792473840059532,488,0.00256663546771585,-148
"4426","2312212",0.731817303019059,1064,0.736099355418708,1397,-0.00428205239964974,-333
"4427","3312212",0.688703094205555,1978,0.707305522218929,2173,-0.0186024280133738,-195
"4428","4312212",0.647228763505015,3294,0.664895147097118,3755,-0.0176663835921034,-461
"4429","1412212",0.756103977542251,709,0.751844336091426,1067,0.00425964145082569,-358
"4430","2412212",0.692880805034063,1878,0.695469851450603,2559,-0.00258904641654001,-681
"4431","3412212",0.649766596220559,3201,0.666676018250823,3660,-0.016909422030264,-459
"4432","4412212",0.608292265520019,4881,0.624265643129013,5708,-0.0159733776089936,-827
"4433","1122212",0.8089984525306,253,0.814259374681129,304,-0.0052609221505292,-51
"4434","2122212",0.745775280022411,848,0.757884890040306,962,-0.0121096100178948,-114
"4435","3122212",0.702661071208907,1640,0.729091056840526,1555,-0.0264299856316188,85
"4436","4122212",0.661186740508367,2780,0.686680681718716,2865,-0.0254939412103484,-85
"4437","1222212",0.755040674937604,718,0.758955095735423,949,-0.00391442079781912,-231
"4438","2222212",0.691817502429415,1910,0.7025806110946,2334,-0.0107631086651847,-424
"4439","3222212",0.648703293615911,3235,0.67378677789482,3358,-0.0250834842789087,-123
"4440","4222212",0.607228962915371,4921,0.63137640277301,5341,-0.0241474398576383,-420
"4441","1322212",0.727061204660827,1136,0.731904528402125,1497,-0.00484332374129737,-361
"4442","2322212",0.663838032152639,2704,0.675530043761302,3305,-0.011692011608663,-601
"4443","3322212",0.620723823339135,4298,0.646736210561522,4575,-0.026012387222387,-277
"4444","4322212",0.579249492638595,6243,0.604325835439712,6814,-0.0250763428011166,-571
"4445","1422212",0.688124706675831,1993,0.691275024434019,2698,-0.00315031775818753,-705
"4446","2422212",0.624901534167643,4136,0.634900539793196,5187,-0.00999900562555323,-1051
"4447","3422212",0.581787325354139,6101,0.606106706593416,6696,-0.0243193812392772,-595
"4448","4422212",0.540312994653599,8218,0.563696331471606,9122,-0.0233833368180069,-904
"4449","1132212",0.7656659303655,600,0.7757942822331,684,-0.0101283518676,-84
"4450","2132212",0.702442757857311,1648,0.719419797592277,1819,-0.0169770397349656,-171
"4451","3132212",0.659328549043808,2839,0.690625964392497,2725,-0.0312974153486896,114
"4452","4132212",0.617854218343268,4430,0.648215589270687,4491,-0.0303613709274192,-61
"4453","1232212",0.711708152772504,1428,0.720490003287394,1798,-0.00878185051488989,-370
"4454","2232212",0.648484980264315,3248,0.664115518646571,3793,-0.0156305383822555,-545
"4455","3232212",0.605370771450812,4992,0.635321685446791,5164,-0.0299509139959795,-172
"4456","4232212",0.563896440750272,6968,0.592911310324981,7460,-0.0290148695747091,-492
"4457","1332212",0.683728682495728,2107,0.693439435954096,2628,-0.00971075345836814,-521
"4458","2332212",0.620505509987539,4314,0.637064951313273,5073,-0.0165594413257337,-759
"4459","3332212",0.577391301174035,6320,0.608271118113493,6595,-0.0308798169394577,-275
"4460","4332212",0.535916970473496,8425,0.565860742991683,8996,-0.0299437725181874,-571
"4461","1432212",0.644792184510732,3371,0.65280993198599,4289,-0.0080177474752583,-918
"4462","2432212",0.581569012002543,6115,0.596435447345167,7268,-0.014866435342624,-1153
"4463","3432212",0.53845480318904,8303,0.567641614145387,8908,-0.029186810956348,-605
"4464","4432212",0.4969804724885,10413,0.525231239023577,11235,-0.0282507665350776,-822
"4465","1142212",0.716632365910671,1333,0.735395788106016,1413,-0.0187634221953454,-80
"4466","2142212",0.653409193402482,3066,0.679021303465193,3172,-0.025612110062711,-106
"4467","3142212",0.610294984588978,4785,0.650227470265413,4412,-0.039932485676435,373
"4468","4142212",0.568820653888438,6746,0.607817095143603,6615,-0.0389964412551647,131
"4469","1242212",0.662674588317674,2739,0.68009150916031,3132,-0.0174169208426354,-393
"4470","2242212",0.599451415809486,5258,0.623717024519487,5739,-0.0242656087100009,-481
"4471","3242212",0.556337206995982,7380,0.594923191319707,7347,-0.038585984323725,33
"4472","4242212",0.514862876295442,9521,0.552512816197897,9771,-0.0376499399024546,-250
"4473","1342212",0.634695118040898,3751,0.653040941827012,4280,-0.0183458237861136,-529
"4474","2342212",0.571471945532709,6616,0.596666457186189,7254,-0.0251945116534792,-638
"4475","3342212",0.528357736719206,8821,0.567872623986409,8895,-0.0395148872672032,-74
"4476","4342212",0.486883406018666,10911,0.525462248864599,11225,-0.0385788428459328,-314
"4477","1442212",0.595758620055902,5437,0.612411437858906,6365,-0.0166528178030038,-928
"4478","2442212",0.532535447547713,8598,0.556036953218083,9572,-0.0235015056703695,-974
"4479","3442212",0.48942123873421,10774,0.527243120018303,11132,-0.0378218812840935,-358
"4480","4442212",0.44794690803367,12643,0.484832744896493,13146,-0.0368858368628231,-503
"4481","1113212",0.838094547824534,132,0.849332095949297,129,-0.0112375481247626,3
"4482","2113212",0.774871375316345,503,0.792957611308473,481,-0.0180862359921282,22
"4483","3113212",0.731757166502842,1068,0.764163778108694,866,-0.0324066116058522,202
"4484","4113212",0.690282835802302,1946,0.721753402986884,1761,-0.0314705671845817,185
"4485","1213212",0.784136770231538,417,0.79402781700359,468,-0.00989104677205244,-51
"4486","2213212",0.720913597723349,1255,0.737653332362767,1356,-0.016739734639418,-101
"4487","3213212",0.677799388909846,2295,0.708859499162988,2116,-0.031060110253142,179
"4488","4213212",0.636325058209306,3703,0.666449124041177,3672,-0.0301240658318718,31
"4489","1313212",0.756157299954762,708,0.766977249670293,823,-0.0108199497155307,-115
"4490","2313212",0.692934127446573,1875,0.710602765029469,2063,-0.0176686375828963,-188
"4491","3313212",0.64981991863307,3199,0.68180893182969,3059,-0.0319890131966203,140
"4492","4313212",0.60834558793253,4879,0.63939855670788,4960,-0.03105296877535,-81
"4493","1413212",0.717220801969766,1320,0.726347745702187,1630,-0.00912694373242084,-310
"4494","2413212",0.653997629461577,3034,0.669973261061364,3510,-0.0159756315997865,-476
"4495","3413212",0.610883420648074,4758,0.641179427861584,4865,-0.0302960072135106,-107
"4496","4413212",0.569409089947533,6724,0.598769052739774,7127,-0.0293599627922403,-403
"4497","1123212",0.770115276958114,556,0.78876278429189,537,-0.0186475073337758,19
"4498","2123212",0.706892104449925,1548,0.732388299651067,1483,-0.0254961952011414,65
"4499","3123212",0.663777895636422,2707,0.703594466451287,2290,-0.0398165708148654,417
"4500","4123212",0.622303564935882,4256,0.661184091329477,3926,-0.038880526393595,330
"4501","1223212",0.716157499365118,1343,0.733458505346184,1451,-0.0173010059810657,-108
"4502","2223212",0.652934326856929,3078,0.67708402070536,3244,-0.0241496938484312,-166
"4503","3223212",0.609820118043426,4804,0.648290187505581,4483,-0.0384700694621553,321
"4504","4223212",0.568345787342886,6780,0.605879812383771,6709,-0.037534025040885,71
"4505","1323212",0.688178029088342,1991,0.706407938012886,2209,-0.0182299089245439,-218
"4506","2323212",0.624954856580153,4132,0.650033453372063,4421,-0.0250785967919095,-289
"4507","3323212",0.58184064776665,6099,0.621239620172283,5875,-0.0393989724056335,224
"4508","4323212",0.54036631706611,8216,0.578829245050473,8270,-0.0384629279843632,-54
"4509","1423212",0.649241531103346,3225,0.66577843404478,3706,-0.0165369029414341,-481
"4510","2423212",0.586018358595157,5891,0.609403949403957,6526,-0.0233855908087998,-635
"4511","3423212",0.542904149781654,8073,0.580610116204177,8155,-0.0377059664225238,-82
"4512","4423212",0.501429819081114,10205,0.538199741082367,10567,-0.0367699220012535,-362
"4513","1133212",0.726782754793015,1143,0.750297691843861,1098,-0.0235149370508465,45
"4514","2133212",0.663559582284826,2717,0.693923207203038,2611,-0.0303636249182121,106
"4515","3133212",0.620445373471322,4318,0.665129374003258,3745,-0.0446840005319361,573
"4516","4133212",0.578971042770782,6259,0.622718998881448,5797,-0.0437479561106658,462
"4517","1233212",0.672824977200018,2418,0.694993412898155,2579,-0.0221684356981365,-161
"4518","2233212",0.60960180469183,4819,0.638618928257332,5008,-0.0290171235655021,-189
"4519","3233212",0.566487595878326,6861,0.609825095057552,6499,-0.0433374991792261,362
"4520","4233212",0.525013265177786,9000,0.567414719935742,8915,-0.0424014547579556,85
"4521","1333212",0.644845506923242,3366,0.667942845564857,3616,-0.0230973386416148,-250
"4522","2333212",0.581622334415053,6110,0.611568360924034,6415,-0.0299460265089804,-305
"4523","3333212",0.53850812560155,8299,0.582774527724254,8034,-0.0442664021227044,265
"4524","4333212",0.49703379490101,10409,0.540364152602444,10456,-0.0433303577014339,-47
"4525","1433212",0.605909008938246,4975,0.627313341596751,5542,-0.0214043326585049,-567
"4526","2433212",0.542685836430057,8084,0.570938856955928,8727,-0.0282530205258706,-643
"4527","3433212",0.499571627616554,10284,0.542145023756148,10345,-0.0425733961395947,-61
"4528","4433212",0.458097296916014,12229,0.499734648634338,12509,-0.0416373517183242,-280
"4529","1143212",0.677749190338185,2297,0.709899197716777,2088,-0.0321500073785921,209
"4530","2143212",0.614526017829996,4582,0.653524713075954,4257,-0.0389986952459577,325
"4531","3143212",0.571411809016493,6618,0.624730879876174,5680,-0.0533190708596817,938
"4532","4143212",0.529937478315953,8740,0.582320504754364,8064,-0.0523830264384112,676
"4533","1243212",0.623791412745189,4187,0.654594918771071,4210,-0.0308035060258819,-23
"4534","2243212",0.560568240237,7146,0.598220434130248,7163,-0.0376521938932475,-17
"4535","3243212",0.517454031423497,9383,0.569426600930468,8804,-0.0519725695069715,579
"4536","4243212",0.475979700722956,11428,0.527016225808658,11142,-0.0510365250857012,286
"4537","1343212",0.595811942468413,5434,0.627544351437773,5535,-0.0317324089693601,-101
"4538","2343212",0.532588769960224,8594,0.57116986679695,8716,-0.0385810968367257,-122
"4539","3343212",0.48947456114672,10772,0.54237603359717,10326,-0.0529014724504497,446
"4540","4343212",0.44800023044618,12639,0.49996565847536,12503,-0.0519654280291795,136
"4541","1443212",0.556875444483417,7351,0.586914847469667,7783,-0.0300394029862503,-432
"4542","2443212",0.493652271975228,10564,0.530540362828844,10968,-0.036888090853616,-404
"4543","3443212",0.450538063161724,12522,0.501746529629064,12410,-0.05120846646734,112
"4544","4443212",0.409063732461184,14033,0.459336154507254,14110,-0.0502724220460697,-77
"4545","1114212",0.785887475853964,401,0.804681482575641,384,-0.0187940067216765,17
"4546","2114212",0.722664303345775,1218,0.748306997934818,1139,-0.0256426945890421,79
"4547","3114212",0.679550094532272,2243,0.719513164735038,1817,-0.0399630702027661,426
"4548","4114212",0.638075763831732,3633,0.677102789613228,3243,-0.0390270257814957,390
"4549","1214212",0.731929698260968,1060,0.749377203629935,1116,-0.0174475053689664,-56
"4550","2214212",0.668706525752779,2548,0.693002718989111,2641,-0.024296193236332,-93
"4551","3214212",0.625592316939276,4095,0.664208885789332,3788,-0.038616568850056,307
"4552","4214212",0.584117986238736,5996,0.621798510667522,5840,-0.0376805244287857,156
"4553","1314212",0.703950227984192,1611,0.722326636296637,1743,-0.0183764083124447,-132
"4554","2314212",0.640727055476003,3534,0.665952151655813,3696,-0.0252250961798103,-162
"4555","3314212",0.5976128466625,5346,0.637158318456034,5070,-0.0395454717935343,276
"4556","4314212",0.55613851596196,7392,0.594747943334224,7356,-0.0386094273722639,36
"4557","1414212",0.665013729999196,2660,0.681697132328531,3067,-0.0166834023293349,-407
"4558","2414212",0.601790557491007,5141,0.625322647687708,5651,-0.0235320901967006,-510
"4559","3414212",0.558676348677504,7241,0.596528814487928,7264,-0.0378524658104246,-23
"4560","4414212",0.517202017976964,9402,0.554118439366118,9674,-0.0369164213891542,-272
"4561","1124212",0.717908204987544,1305,0.744112170918234,1227,-0.0262039659306897,78
"4562","2124212",0.654685032479355,2998,0.687737686277411,2818,-0.0330526537980553,180
"4563","3124212",0.611570823665852,4721,0.658943853077631,4015,-0.0473730294117793,706
"4564","4124212",0.570096492965312,6685,0.616533477955821,6138,-0.046436984990509,547
"4565","1224212",0.663950427394548,2697,0.688807891972528,2781,-0.0248574645779797,-84
"4566","2224212",0.600727254886359,5192,0.632433407331705,5291,-0.0317061524453452,-99
"4567","3224212",0.557613046072856,7292,0.603639574131925,6845,-0.0460265280590693,447
"4568","4224212",0.516138715372316,9459,0.561229199010115,9253,-0.0450904836377989,206
"4569","1324212",0.635970957117772,3712,0.66175732463923,3899,-0.0257863675214579,-187
"4570","2324212",0.572747784609583,6544,0.605382839998407,6746,-0.0326350553888235,-202
"4571","3324212",0.52963357579608,8749,0.576589006798627,8394,-0.0469554310025475,355
"4572","4324212",0.48815924509554,10846,0.534178631676817,10781,-0.0460193865812771,65
"4573","1424212",0.597034459132776,5371,0.621127820671124,5880,-0.0240933615383481,-509
"4574","2424212",0.533811286624587,8519,0.564753336030301,9052,-0.0309420494057138,-533
"4575","3424212",0.490697077811084,10699,0.535959502830522,10687,-0.0452624250194378,12
"4576","4424212",0.449222747110544,12585,0.493549127708711,12773,-0.0443263805981674,-188
"4577","1134212",0.674575682822445,2381,0.705647078470205,2228,-0.0310713956477605,153
"4578","2134212",0.611352510314256,4740,0.649272593829382,4444,-0.0379200835151261,296
"4579","3134212",0.568238301500752,6790,0.620478760629602,5919,-0.0522404591288501,871
"4580","4134212",0.526763970800212,8917,0.578068385507792,8315,-0.0513044147075797,602
"4581","1234212",0.620617905229449,4306,0.650342799524499,4406,-0.0297248942950504,-100
"4582","2234212",0.55739473272126,7316,0.593968314883676,7405,-0.036573582162416,-89
"4583","3234212",0.514280523907756,9549,0.565174481683896,9031,-0.05089395777614,518
"4584","4234212",0.472806193207216,11573,0.522764106562086,11359,-0.0499579133548697,214
"4585","1334212",0.592638434952672,5561,0.623292232191201,5766,-0.0306537972385287,-205
"4586","2334212",0.529415262444484,8766,0.566917747550378,8944,-0.0375024851058943,-178
"4587","3334212",0.48630105363098,10939,0.538123914350598,10570,-0.0518228607196183,369
"4588","4334212",0.44482672293044,12763,0.495713539228788,12681,-0.0508868162983479,82
"4589","1434212",0.553701936967676,7512,0.582662728223095,8042,-0.0289607912554188,-530
"4590","2434212",0.490478764459488,10711,0.526288243582272,11184,-0.0358094791227845,-473
"4591","3434212",0.447364555645984,12662,0.497494410382493,12601,-0.0501298547365086,61
"4592","4434212",0.405890224945444,14139,0.455084035260682,14243,-0.0491938103152382,-104
"4593","1144212",0.625542118367615,4100,0.665248584343121,3731,-0.039706465975506,369
"4594","2144212",0.562318945859426,7052,0.608874099702298,6561,-0.0465551538428716,491
"4595","3144212",0.519204737045923,9272,0.580080266502518,8189,-0.0608755294565956,1083
"4596","4144212",0.477730406345383,11337,0.537669891380708,10598,-0.0599394850353252,739
"4597","1244212",0.571584340774619,6600,0.609944305397415,6486,-0.0383599646227959,114
"4598","2244212",0.50836116826643,9835,0.553569820756592,9709,-0.0452086524901615,126
"4599","3244212",0.465246959452927,11890,0.524775987556812,11260,-0.0595290281038855,630
"4600","4244212",0.423772628752387,13552,0.482365612435002,13239,-0.0585929836826151,313
"4601","1344212",0.543604870497843,8032,0.582893738064117,8024,-0.0392888675662741,8
"4602","2344212",0.480381697989654,11204,0.526519253423294,11167,-0.0461375554336397,37
"4603","3344212",0.437267489176151,13046,0.497725420223514,12590,-0.0604579310473637,456
"4604","4344212",0.39579315847561,14419,0.455315045101704,14234,-0.0595218866260934,185
"4605","1444212",0.504668372512847,10021,0.542264234096011,10334,-0.0375958615831643,-313
"4606","2444212",0.441445200004658,12884,0.485889749455188,13100,-0.04444454945053,-216
"4607","3444212",0.398330991191155,14340,0.457095916255409,14177,-0.0587649250642541,163
"4608","4444212",0.356856660490615,15315,0.414685541133598,15307,-0.0578288806429837,8
"4609","1111312",0.887608656153401,35,0.895097677939513,34,-0.00748902178611255,1
"4610","2111312",0.824385483645212,182,0.83872319329869,168,-0.0143377096534781,14
"4611","3111312",0.781271274831708,440,0.80992936009891,336,-0.0286580852672021,104
"4612","4111312",0.739796944131168,927,0.7675189849771,809,-0.0277220408459319,118
"4613","1211312",0.833650878560404,147,0.839793398993807,165,-0.00614252043340258,-18
"4614","2211312",0.770427706052216,550,0.783418914352984,594,-0.0129912083007682,-44
"4615","3211312",0.727313497238712,1131,0.754625081153204,1015,-0.0273115839144922,116
"4616","4211312",0.685839166538172,2059,0.712214706031394,2002,-0.0263755394932217,57
"4617","1311312",0.805671408283628,274,0.812742831660509,316,-0.00707142337688083,-42
"4618","2311312",0.742448235775439,891,0.756368347019686,989,-0.0139201112442464,-98
"4619","3311312",0.699334026961936,1711,0.727574513819906,1596,-0.0282404868579704,115
"4620","4311312",0.657859696261396,2893,0.685164138698096,2921,-0.0273044424366999,-28
"4621","1411312",0.766734910298632,586,0.772113327692403,738,-0.00537841739377098,-152
"4622","2411312",0.703511737790443,1621,0.71573884305158,1912,-0.0122271052611367,-291
"4623","3411312",0.66039752897694,2804,0.686945009851801,2855,-0.0265474808748607,-51
"4624","4411312",0.6189231982764,4387,0.64453463472999,4675,-0.0256114364535902,-288
"4625","1121312",0.819629385286981,198,0.834528366282106,191,-0.0148989809951258,7
"4626","2121312",0.756406212778792,707,0.778153881641283,661,-0.0217476688624914,46
"4627","3121312",0.713292003965288,1402,0.749360048441504,1118,-0.0360680444762154,284
"4628","4121312",0.671817673264748,2450,0.706949673319693,2185,-0.0351320000549451,265
"4629","1221312",0.765671607693984,598,0.7792240873364,645,-0.0135524796424158,-47
"4630","2221312",0.702448435185796,1646,0.722849602695577,1730,-0.0204011675097814,-84
"4631","3221312",0.659334226372292,2838,0.694055769495798,2607,-0.0347215431235054,231
"4632","4221312",0.617859895671752,4428,0.651645394373987,4333,-0.0337854987022349,95
"4633","1321312",0.737692137417208,962,0.752173520003102,1058,-0.014481382585894,-96
"4634","2321312",0.674468964909019,2387,0.695799035362279,2546,-0.0213300704532596,-159
"4635","3321312",0.631354756095516,3868,0.6670052021625,3650,-0.0356504460669836,218
"4636","4321312",0.589880425394976,5694,0.624594827040689,5691,-0.0347144016457132,3
"4637","1421312",0.698755639432212,1721,0.711544016034997,2026,-0.0127883766027842,-305
"4638","2421312",0.635532466924023,3726,0.655169531394173,4177,-0.0196370644701499,-451
"4639","3421312",0.59241825811052,5572,0.626375698194394,5596,-0.0339574400838739,-24
"4640","4421312",0.55094392740998,7659,0.583965323072584,7948,-0.0330213956626034,-289
"4641","1131312",0.776296863121881,486,0.796063273834078,455,-0.0197664107121966,31
"4642","2131312",0.713073690613692,1404,0.739688789193254,1322,-0.0266150985795622,82
"4643","3131312",0.669959481800189,2507,0.710894955993475,2056,-0.0409354741932862,451
"4644","4131312",0.628485151099649,3983,0.668484580871665,3594,-0.0399994297720158,389
"4645","1231312",0.722339085528885,1227,0.740758994888371,1299,-0.0184199093594865,-72
"4646","2231312",0.659115913020696,2843,0.684384510247548,2952,-0.025268597226852,-109
"4647","3231312",0.616001704207193,4499,0.655590677047769,4163,-0.0395889728405761,336
"4648","4231312",0.574527373506653,6456,0.613180301925958,6315,-0.0386529284193058,141
"4649","1331312",0.694359615252109,1834,0.713708427555073,1971,-0.0193488123029647,-137
"4650","2331312",0.63113644274392,3875,0.65733394291425,4089,-0.0261975001703303,-214
"4651","3331312",0.588022233930416,5777,0.628540109714471,5474,-0.0405178757840543,303
"4652","4331312",0.546547903229876,7869,0.58612973459266,7826,-0.039581831362784,43
"4653","1431312",0.655423117267113,2975,0.673078923586968,3392,-0.0176558063198549,-417
"4654","2431312",0.592199944758924,5579,0.616704438946144,6124,-0.0245044941872206,-545
"4655","3431312",0.54908573594542,7744,0.587910605746365,7714,-0.0388248698009446,30
"4656","4431312",0.50761140524488,9873,0.545500230624555,10141,-0.0378888253796743,-268
"4657","1141312",0.727263298667052,1134,0.755664779706994,999,-0.028401481039942,135
"4658","2141312",0.664040126158863,2693,0.69929029506617,2428,-0.0352501689073076,265
"4659","3141312",0.620925917345359,4291,0.670496461866391,3490,-0.0495705445210316,801
"4660","4141312",0.579451586644819,6233,0.62808608674458,5497,-0.0486345000997613,736
"4661","1241312",0.673305521074055,2411,0.700360500761287,2393,-0.027054979687232,18
"4662","2241312",0.610082348565866,4795,0.643986016120464,4696,-0.0339036675545976,99
"4663","3241312",0.566968139752363,6845,0.615192182920685,6203,-0.0482240431683216,642
"4664","4241312",0.525493809051823,8981,0.572781807798874,8604,-0.0472879987470511,377
"4665","1341312",0.645326050797279,3358,0.673309933427989,3381,-0.0279838826307103,-23
"4666","2341312",0.58210287828909,6095,0.616935448787166,6108,-0.0348325704980759,-13
"4667","3341312",0.538988669475587,8279,0.588141615587387,7705,-0.0491529461117999,574
"4668","4341312",0.497514338775047,10391,0.545731240465576,10129,-0.0482169016905294,262
"4669","1441312",0.606389552812283,4962,0.632680429459884,5283,-0.0262908766476004,-321
"4670","2441312",0.543166380304094,8064,0.57630594481906,8406,-0.0331395645149661,-342
"4671","3441312",0.500052171490591,10266,0.547512111619281,10033,-0.0474599401286901,233
"4672","4441312",0.458577840790051,12212,0.505101736497471,12241,-0.0465238957074197,-29
"4673","1112312",0.854523744391712,88,0.856778696410861,101,-0.00225495201914938,-13
"4674","2112312",0.791300571883523,368,0.800404211770038,417,-0.00910363988651497,-49
"4675","3112312",0.748186363070019,811,0.771610378570258,744,-0.023424015500239,67
"4676","4112312",0.706712032369479,1552,0.729200003448448,1552,-0.0224879710789687,0
"4677","1212312",0.800565966798716,308,0.801474417465155,409,-0.000908450666439409,-101
"4678","2212312",0.737342794290527,972,0.745099932824332,1210,-0.007757138533805,-238
"4679","3212312",0.694228585477023,1838,0.716306099624552,1901,-0.022077514147529,-63
"4680","4212312",0.652754254776483,3088,0.673895724502742,3350,-0.0211414697262585,-262
"4681","1312312",0.772586496521939,525,0.774423850131857,706,-0.00183735360991766,-181
"4682","2312312",0.70936332401375,1490,0.718049365491034,1859,-0.00868604147728325,-369
"4683","3312312",0.666249115200247,2624,0.689255532291254,2764,-0.0230064170910073,-140
"4684","4312312",0.624774784499707,4143,0.646845157169444,4568,-0.0220703726697368,-425
"4685","1412312",0.733649998536943,1031,0.733794346163751,1440,-0.000144347626807817,-409
"4686","2412312",0.670426826028754,2492,0.677419861522928,3228,-0.00699303549417352,-736
"4687","3412312",0.627312617215251,4029,0.648626028323149,4466,-0.0213134111078975,-437
"4688","4412312",0.585838286514711,5898,0.606215653201338,6688,-0.020377366686627,-790
"4689","1122312",0.786544473525292,398,0.796209384753454,450,-0.0096649112281626,-52
"4690","2122312",0.723321301017103,1207,0.739834900112631,1319,-0.0165135990955282,-112
"4691","3122312",0.680207092203599,2222,0.711041066912852,2049,-0.0308339747092522,173
"4692","4122312",0.638732761503059,3608,0.668630691791041,3585,-0.0298979302879819,23
"4693","1222312",0.732586695932296,1049,0.740905105807748,1292,-0.00831840987545263,-243
"4694","2222312",0.669363523424107,2530,0.684530621166925,2945,-0.0151670977428182,-415
"4695","3222312",0.626249314610603,4066,0.655736787967145,4158,-0.0294874733565422,-92
"4696","4222312",0.584774983910063,5963,0.613326412845335,6304,-0.0285514289352717,-341
"4697","1322312",0.704607225655519,1598,0.71385453847445,1967,-0.00924731281893088,-369
"4698","2322312",0.64138405314733,3511,0.657480053833627,4083,-0.0160960006862965,-572
"4699","3322312",0.598269844333827,5310,0.628686220633847,5468,-0.0304163763000205,-158
"4700","4322312",0.556795513633287,7353,0.586275845512037,7822,-0.02948033187875,-469
"4701","1422312",0.665670727670523,2635,0.673225034506344,3384,-0.00755430683582103,-749
"4702","2422312",0.602447555162335,5112,0.616850549865521,6117,-0.0144029947031867,-1005
"4703","3422312",0.559333346348831,7207,0.588056716665742,7708,-0.0287233703169107,-501
"4704","4422312",0.517859015648291,9357,0.545646341543931,10132,-0.0277873258956403,-775
"4705","1132312",0.743211951360192,879,0.757744292305426,966,-0.0145323409452335,-87
"4706","2132312",0.679988778852003,2227,0.701369807664602,2373,-0.0213810288125991,-146
"4707","3132312",0.6368745700385,3678,0.672575974464823,3416,-0.0357014044263231,262
"4708","4132312",0.59540023933796,5453,0.630165599343012,5403,-0.0347653600050526,50
"4709","1232312",0.689254173767196,1960,0.702440013359719,2341,-0.0131858395925233,-381
"4710","2232312",0.626031001259007,4071,0.646065528718896,4606,-0.0200345274598889,-535
"4711","3232312",0.582916792445504,6050,0.617271695519117,6091,-0.0343549030736129,-41
"4712","4232312",0.541442461744964,8150,0.574861320397306,8500,-0.0334188586523426,-350
"4713","1332312",0.66127470349042,2779,0.675389446026421,3309,-0.0141147425360015,-530
"4714","2332312",0.598051530982231,5320,0.619014961385598,5992,-0.0209634304033671,-672
"4715","3332312",0.554937322168727,7452,0.590221128185819,7587,-0.0352838060170911,-135
"4716","4332312",0.513462991468187,9597,0.547810753064008,10018,-0.0343477615958209,-421
"4717","1432312",0.622338205505424,4253,0.634759942058316,5193,-0.0124217365528917,-940
"4718","2432312",0.559115032997235,7221,0.578385457417492,8294,-0.0192704244202574,-1073
"4719","3432312",0.516000824183731,9472,0.549591624217713,9913,-0.0335908000339814,-441
"4720","4432312",0.474526493483191,11497,0.507181249095903,12153,-0.0326547556127111,-656
"4721","1142312",0.694178386905363,1841,0.717345798178341,1877,-0.0231674112729788,-36
"4722","2142312",0.630955214397174,3878,0.660971313537518,3930,-0.0300160991403444,-52
"4723","3142312",0.58784100558367,5782,0.632177480337739,5306,-0.0443364747540684,476
"4724","4142312",0.54636667488313,7881,0.589767105215928,7617,-0.0434004303327982,264
"4725","1242312",0.640220609312366,3557,0.662041519232635,3877,-0.0218209099202689,-320
"4726","2242312",0.576997436804177,6340,0.605667034591812,6722,-0.0286695977876344,-382
"4727","3242312",0.533883227990674,8515,0.576873201392032,8379,-0.0429899734013585,136
"4728","4242312",0.492408897290134,10627,0.534462826270222,10765,-0.042053928980088,-138
"4729","1342312",0.61224113903559,4697,0.634990951899337,5179,-0.0227498128637471,-482
"4730","2342312",0.549017966527401,7745,0.578616467258514,8278,-0.0295985007311127,-533
"4731","3342312",0.505903757713898,9952,0.549822634058735,9901,-0.0439188763448367,51
"4732","4342312",0.464429427013358,11936,0.507412258936924,12142,-0.0429828319235662,-206
"4733","1442312",0.573304641050594,6523,0.594361447931231,7380,-0.0210568068806373,-857
"4734","2442312",0.510081468542405,9755,0.537986963290408,10577,-0.027905494748003,-822
"4735","3442312",0.466967259728902,11815,0.509193130090629,12055,-0.042225870361727,-240
"4736","4442312",0.425492929028362,13491,0.466782754968818,13858,-0.0412898259404565,-367
"4737","1113312",0.815640568819226,218,0.831282106021622,207,-0.015641537202396,11
"4738","2113312",0.752417396311037,753,0.774907621380799,700,-0.0224902250697616,53
"4739","3113312",0.709303187497534,1491,0.746113788181019,1183,-0.0368106006834856,308
"4740","4113312",0.667828856796994,2577,0.703703413059209,2289,-0.0358745562622151,288
"4741","1213312",0.76168279122623,647,0.775977827075916,680,-0.0142950358496858,-33
"4742","2213312",0.698459618718041,1730,0.719603342435093,1815,-0.0211437237170514,-85
"4743","3213312",0.655345409904538,2978,0.690809509235313,2714,-0.0354640993307754,264
"4744","4213312",0.613871079203998,4619,0.648399134113503,4479,-0.0345280549095052,140
"4745","1313312",0.733703320949454,1029,0.748927259742618,1126,-0.0152239387931641,-97
"4746","2313312",0.670480148441265,2489,0.692552775101795,2656,-0.0220726266605297,-167
"4747","3313312",0.627365939627762,4026,0.663758941902015,3808,-0.0363930022742537,218
"4748","4313312",0.585891608927221,5895,0.621348566780205,5869,-0.0354569578529834,26
"4749","1413312",0.694766822964458,1818,0.708297755774512,2134,-0.0135309328100542,-316
"4750","2413312",0.631543650456269,3859,0.651923271133689,4325,-0.0203796206774199,-466
"4751","3413312",0.588429441642766,5762,0.62312943793391,5774,-0.034699996291144,-12
"4752","4413312",0.546955110942225,7854,0.580719062812099,8150,-0.0337639518698737,-296
"4753","1123312",0.747661297952806,818,0.770712794364215,761,-0.0230514964114092,57
"4754","2123312",0.684438125444617,2093,0.714338309723392,1955,-0.0299001842787748,138
"4755","3123312",0.641323916631114,3514,0.685544476523613,2908,-0.0442205598924988,606
"4756","4123312",0.599849585930574,5237,0.643134101401802,4755,-0.0432845154712284,482
"4757","1223312",0.69370352035981,1849,0.715408515418509,1921,-0.021704995058699,-72
"4758","2223312",0.630480347851621,3893,0.659034030777686,4011,-0.0285536829260646,-118
"4759","3223312",0.587366139038118,5807,0.630240197577906,5396,-0.0428740585397887,411
"4760","4223312",0.545891808337578,7911,0.587829822456096,7719,-0.0419380141185184,192
"4761","1323312",0.665724050083034,2632,0.688357948085211,2800,-0.0226338980021773,-168
"4762","2323312",0.602500877574845,5110,0.631983463444388,5321,-0.0294825858695429,-211
"4763","3323312",0.559386668761342,7202,0.603189630244608,6869,-0.0438029614832669,333
"4764","4323312",0.517912338060802,9355,0.560779255122798,9280,-0.0428669170619966,75
"4765","1423312",0.626787552098038,4040,0.647728444117105,4516,-0.0209408920190675,-476
"4766","2423312",0.563564379589849,6981,0.591353959476282,7535,-0.0277895798864332,-554
"4767","3423312",0.520450170776346,9212,0.562560126276503,9189,-0.0421099555001572,23
"4768","4423312",0.478975840075806,11277,0.520149751154692,11486,-0.0411739110788869,-209
"4769","1133312",0.704328775787707,1607,0.732247701916186,1487,-0.0279189261284799,120
"4770","2133312",0.641105603279518,3521,0.675873217275363,3293,-0.0347676139958455,228
"4771","3133312",0.597991394466014,5325,0.647079384075584,4553,-0.0490879896095695,772
"4772","4133312",0.556517063765474,7368,0.604669008953773,6794,-0.0481519451882992,574
"4773","1233312",0.65037099819471,3179,0.67694342297048,3251,-0.0265724247757699,-72
"4774","2233312",0.587147825686521,5824,0.620568938329657,5911,-0.0334211126431355,-87
"4775","3233312",0.544033616873018,8017,0.591775105129878,7509,-0.0477414882568595,508
"4776","4233312",0.502559286172478,10135,0.549364730008067,9927,-0.046805443835589,208
"4777","1333312",0.622391527917934,4249,0.649892855637182,4423,-0.0275013277192482,-174
"4778","2333312",0.559168355409745,7217,0.593518370996359,7431,-0.0343500155866138,-214
"4779","3333312",0.516054146596242,9468,0.56472453779658,9055,-0.0486703912003378,413
"4780","4333312",0.474579815895702,11492,0.522314162674769,11381,-0.0477343467790673,111
"4781","1433312",0.583455029932938,6030,0.609263351669077,6534,-0.0258083217361383,-504
"4782","2433312",0.520231857424749,9224,0.552888867028253,9752,-0.032657009603504,-528
"4783","3433312",0.477117648611246,11370,0.524095033828474,11291,-0.046977385217228,79
"4784","4433312",0.435643317910706,13117,0.481684658706664,13267,-0.0460413407959576,-150
"4785","1143312",0.655295211332877,2981,0.691849207789102,2678,-0.0365539964562255,303
"4786","2143312",0.592072038824688,5583,0.635474723148279,5148,-0.0434026843235911,435
"4787","3143312",0.548957830011185,7747,0.6066808899485,6665,-0.0577230599373151,1082
"4788","4143312",0.507483499310645,9876,0.564270514826689,9088,-0.0567870155160446,788
"4789","1243312",0.601337433739881,5173,0.636544928843396,5098,-0.0352074951035153,75
"4790","2243312",0.538114261231692,8327,0.580170444202573,8179,-0.0420561829708809,148
"4791","3243312",0.495000052418189,10499,0.551376611002793,9824,-0.0563765585846049,675
"4792","4243312",0.453525721717648,12407,0.508966235880983,12065,-0.0554405141633347,342
"4793","1343312",0.573357963463105,6516,0.609494361510098,6524,-0.0361363980469935,-8
"4794","2343312",0.510134790954916,9754,0.553119876869275,9737,-0.0429850859143591,17
"4795","3343312",0.467020582141412,11812,0.524326043669496,11283,-0.0573054615280831,529
"4796","4343312",0.425546251440872,13490,0.481915668547685,13256,-0.0563694171068129,234
"4797","1443312",0.534421465478109,8494,0.568864857541992,8840,-0.0344433920638837,-346
"4798","2443312",0.47119829296992,11642,0.512490372901169,11904,-0.0412920799312494,-262
"4799","3443312",0.428084084156416,13399,0.48369653970139,13195,-0.0556124555449735,204
"4800","4443312",0.386609753455876,14665,0.44128616457958,14679,-0.0546764111237031,-14
"4801","1114312",0.763433496848656,625,0.786631492647966,559,-0.02319799579931,66
"4802","2114312",0.700210324340467,1687,0.730257008007143,1523,-0.0300466836666756,164
"4803","3114312",0.657096115526964,2920,0.701463174807364,2368,-0.0443670592803996,552
"4804","4114312",0.615621784826424,4518,0.659052799685553,4008,-0.0434310148591291,510
"4805","1214312",0.70947571925566,1487,0.73132721370226,1506,-0.0218514944465998,-19
"4806","2214312",0.646252546747471,3324,0.674952729061437,3319,-0.0287001823139654,5
"4807","3214312",0.603138337933968,5084,0.646158895861657,4600,-0.0430205579276894,484
"4808","4214312",0.561664007233428,7079,0.603748520739847,6839,-0.0420845135064192,240
"4809","1314312",0.681496248978884,2186,0.704276646368962,2269,-0.0227803973900781,-83
"4810","2314312",0.618273076470695,4417,0.647902161728139,4509,-0.0296290852574437,-92
"4811","3314312",0.575158867657192,6428,0.619108328528359,5987,-0.0439494608711677,441
"4812","4314312",0.533684536956652,8529,0.576697953406549,8389,-0.0430134164498974,140
"4813","1414312",0.642559750993888,3460,0.663647142400856,3812,-0.0210873914069682,-352
"4814","2414312",0.579336578485699,6240,0.607272657760033,6639,-0.0279360792743339,-399
"4815","3414312",0.536222369672196,8416,0.578478824560254,8290,-0.042256454888058,126
"4816","4414312",0.494748038971656,10510,0.536068449438443,10681,-0.0413204104667877,-171
"4817","1124312",0.695454225982236,1811,0.72606218099056,1637,-0.0306079550083233,174
"4818","2124312",0.632231053474047,3836,0.669687696349736,3525,-0.0374566428756888,311
"4819","3124312",0.589116844660544,5730,0.640893863149957,4875,-0.0517770184894129,855
"4820","4124312",0.547642513960004,7805,0.598483488028146,7144,-0.0508409740681424,661
"4821","1224312",0.64149644838924,3509,0.670757902044853,3478,-0.0292614536556131,31
"4822","2224312",0.578273275881051,6287,0.61438341740403,6242,-0.0361101415229786,45
"4823","3224312",0.535159067067548,8457,0.58558958420425,7857,-0.0504305171367027,600
"4824","4224312",0.493684736367008,10561,0.54317920908244,10278,-0.0494944727154324,283
"4825","1324312",0.613516978112464,4636,0.643707334711555,4721,-0.0301903565990913,-85
"4826","2324312",0.550293805604275,7693,0.587332850070732,7754,-0.0370390444664569,-61
"4827","3324312",0.507179596790772,9893,0.558539016870953,9422,-0.0513594200801809,471
"4828","4324312",0.465705266090232,11868,0.516128641749142,11711,-0.0504233756589106,157
"4829","1424312",0.574580480127468,6453,0.60307783074345,6875,-0.0284973506159815,-422
"4830","2424312",0.511357307619279,9699,0.546703346102626,10069,-0.0353460384833472,-370
"4831","3424312",0.468243098805776,11768,0.517909512902847,11617,-0.0496664140970712,151
"4832","4424312",0.426768768105236,13446,0.475499137781037,13528,-0.0487303696758009,-82
"4833","1134312",0.652121703817137,3116,0.687597088542531,2828,-0.0354753847253939,288
"4834","2134312",0.588898531308948,5733,0.631222603901707,5349,-0.0423240725927595,384
"4835","3134312",0.545784322495444,7922,0.602428770701928,6907,-0.0566444482064835,1015
"4836","4134312",0.504309991794904,10042,0.560018395580118,9334,-0.0557084037852132,708
"4837","1234312",0.59816392622414,5316,0.632292809596824,5301,-0.0341288833726839,15
"4838","2234312",0.534940753715952,8466,0.575918324956001,8430,-0.0409775712400495,36
"4839","3234312",0.491826544902448,10653,0.547124491756222,10050,-0.0552979468537735,603
"4840","4234312",0.450352214201908,12529,0.504714116634411,12261,-0.0543619024325031,268
"4841","1334312",0.570184455947364,6681,0.605242242263527,6760,-0.0350577863161622,-79
"4842","2334312",0.506961283439175,9903,0.548867757622703,9959,-0.0419064741835278,-56
"4843","3334312",0.463847074625672,11964,0.520073924422924,11493,-0.0562268497972518,471
"4844","4334312",0.422372743925132,13599,0.477663549301113,13439,-0.0552908053759814,160
"4845","1434312",0.531247957962368,8670,0.564612738295421,9064,-0.0333647803330523,-394
"4846","2434312",0.46802478545418,11776,0.508238253654598,12098,-0.040213468200418,-322
"4847","3434312",0.424910576640676,13517,0.479444420454818,13357,-0.054533843814142,160
"4848","4434312",0.383436245940136,14747,0.437034045333008,14786,-0.0535977993928717,-39
"4849","1144312",0.603088139362307,5089,0.647198594415447,4547,-0.0441104550531395,542
"4850","2144312",0.539864966854118,8236,0.590824109774623,7556,-0.0509591429205051,680
"4851","3144312",0.496750758040615,10418,0.562030276574844,9214,-0.0652795185342291,1204
"4852","4144312",0.455276427340075,12326,0.519619901453033,11520,-0.0643434741129587,806
"4853","1244312",0.549130361769311,7740,0.59189431546974,7506,-0.0427639537004293,234
"4854","2244312",0.485907189261122,10962,0.535519830828917,10706,-0.0496126415677949,256
"4855","3244312",0.442792980447619,12839,0.506725997629138,12176,-0.063933017181519,663
"4856","4244312",0.401318649747079,14270,0.464315622507327,13937,-0.0629969727602486,333
"4857","1344312",0.521150891492535,9193,0.564843748136442,9049,-0.0436928566439075,144
"4858","2344312",0.457927718984346,12232,0.508469263495619,12085,-0.0505415445112731,147
"4859","3344312",0.414813510170843,13853,0.47967543029584,13347,-0.0648619201249972,506
"4860","4344312",0.373339179470302,14977,0.437265055174029,14777,-0.0639258757037269,200
"4861","1444312",0.482214393507539,11129,0.524214244168337,11288,-0.0419998506607977,-159
"4862","2444312",0.41899122099935,13726,0.467839759527513,13825,-0.0488485385281635,-99
"4863","3444312",0.375877012185846,14927,0.439045926327734,14734,-0.0631689141418875,193
"4864","4444312",0.334402681485306,15674,0.396635551205924,15635,-0.0622328697206171,39
"4865","1111412",0.857816639141253,81,0.860972538102398,93,-0.00315589896114477,-12
"4866","2111412",0.794593466633064,345,0.804598053461575,386,-0.0100045868285104,-41
"4867","3111412",0.751479257819561,766,0.775804220261795,683,-0.0243249624422344,83
"4868","4111412",0.710004927119021,1469,0.733393845139985,1456,-0.023388918020964,13
"4869","1211412",0.803858861548257,286,0.805668259156692,376,-0.00180939760843468,-90
"4870","2211412",0.740635689040068,912,0.749293774515868,1120,-0.00865808547580027,-208
"4871","3211412",0.697521480226565,1756,0.720499941316089,1796,-0.0229784610895243,-40
"4872","4211412",0.656047149526025,2948,0.678089566194279,3204,-0.0220424166682539,-256
"4873","1311412",0.775879391271481,492,0.778617691823394,656,-0.00273830055191293,-164
"4874","2311412",0.712656218763292,1414,0.72224320718257,1745,-0.00958698841927852,-331
"4875","3311412",0.669542009949789,2526,0.693449373982791,2626,-0.0239073640330025,-100
"4876","4311412",0.628067679249249,3997,0.651038998860981,4367,-0.0229713196117322,-370
"4877","1411412",0.736942893286485,979,0.737988187855288,1352,-0.00104529456880309,-373
"4878","2411412",0.673719720778296,2394,0.681613703214465,3070,-0.00789398243616879,-676
"4879","3411412",0.630605511964793,3889,0.652819870014685,4288,-0.0222143580498928,-399
"4880","4411412",0.589131181264253,5729,0.610409494892875,6463,-0.0212783136286224,-734
"4881","1121412",0.789837368274833,381,0.800403226444991,418,-0.010565858170158,-37
"4882","2121412",0.726614195766644,1150,0.744028741804168,1231,-0.0174145460375236,-81
"4883","3121412",0.683499986953141,2121,0.715234908604388,1927,-0.0317349216512476,194
"4884","4121412",0.642025656252601,3483,0.672824533482578,3401,-0.0307988772299772,82
"4885","1221412",0.735879590681837,996,0.745098947499285,1211,-0.0092193568174479,-215
"4886","2221412",0.672656418173648,2422,0.688724462858462,2785,-0.0160680446848135,-363
"4887","3221412",0.629542209360145,3933,0.659930629658682,3973,-0.0303884202985375,-40
"4888","4221412",0.588067878659605,5775,0.617520254536872,6074,-0.0294523758772671,-299
"4889","1321412",0.707900120405061,1522,0.718048380165987,1860,-0.0101482597609261,-338
"4890","2321412",0.644676947896872,3375,0.661673895525164,3905,-0.0169969476282917,-530
"4891","3321412",0.601562739083369,5155,0.632880062325384,5273,-0.0313173232420157,-118
"4892","4321412",0.560088408382829,7171,0.590469687203574,7575,-0.0303812788207454,-404
"4893","1421412",0.668963622420065,2544,0.677418876197881,3229,-0.00845525377781631,-685
"4894","2421412",0.605740449911876,4981,0.621044391557058,5884,-0.015303941645182,-903
"4895","3421412",0.562626241098373,7030,0.592250558357279,7488,-0.029624317258906,-458
"4896","4421412",0.521151910397833,9192,0.549840183235468,9899,-0.0286882728376356,-707
"4897","1131412",0.746504846109734,838,0.761938133996962,915,-0.0154332878872288,-77
"4898","2131412",0.683281673601545,2130,0.705563649356139,2233,-0.0222819757545943,-103
"4899","3131412",0.640167464788041,3560,0.67676981615636,3265,-0.0366023513683184,295
"4900","4131412",0.598693134087501,5292,0.634359441034549,5218,-0.035666306947048,74
"4901","1231412",0.692547068516737,1894,0.706633855051256,2202,-0.0140867865345187,-308
"4902","2231412",0.629323896008549,3948,0.650259370410433,4411,-0.0209354744018843,-463
"4903","3231412",0.586209687195045,5876,0.621465537210653,5861,-0.0352558500156083,15
"4904","4231412",0.544735356494505,7981,0.579055162088843,8257,-0.0343198055943379,-276
"4905","1331412",0.664567598239961,2675,0.679583287717958,3156,-0.0150156894779969,-481
"4906","2331412",0.601344425731772,5172,0.623208803077135,5771,-0.0218643773453625,-599
"4907","3331412",0.558230216918269,7267,0.594414969877355,7376,-0.0361847529590865,-109
"4908","4331412",0.516755886217729,9425,0.552004594755545,9794,-0.0352487085378161,-369
"4909","1431412",0.625631100254965,4093,0.638953783749852,4990,-0.0133226834948871,-897
"4910","2431412",0.562407927746776,7043,0.582579299109029,8046,-0.0201713713622528,-1003
"4911","3431412",0.519293718933273,9269,0.55378546590925,9698,-0.0344917469759768,-429
"4912","4431412",0.477819388232733,11334,0.511375090787439,11968,-0.0335557025547064,-634
"4913","1141412",0.697471281654904,1761,0.721539639869878,1768,-0.0240683582149742,-7
"4914","2141412",0.634248109146715,3772,0.665165155229055,3739,-0.0309170460823398,33
"4915","3141412",0.591133900333212,5625,0.636371322029275,5105,-0.0452374216960638,520
"4916","4141412",0.549659569632672,7714,0.593960946907465,7407,-0.0443013772747934,307
"4917","1241412",0.643513504061908,3415,0.666235360924172,3681,-0.0227218568622641,-266
"4918","2241412",0.580290331553719,6190,0.609860876283349,6493,-0.0295705447296297,-303
"4919","3241412",0.537176122740216,8363,0.581067043083569,8127,-0.0438909203433537,236
"4920","4241412",0.495701792039676,10463,0.538656667961759,10539,-0.0429548759220834,-76
"4921","1341412",0.615534033785132,4523,0.639184793590874,4971,-0.0236507598057424,-448
"4922","2341412",0.552310861276943,7580,0.582810308950051,8029,-0.030499447673108,-449
"4923","3341412",0.509196652463439,9789,0.554016475750271,9681,-0.044819823286832,108
"4924","4341412",0.467722321762899,11787,0.511606100628461,11952,-0.0438837788655616,-165
"4925","1441412",0.576597535800136,6357,0.598555289622768,7138,-0.0219577538226325,-781
"4926","2441412",0.513374363291947,9604,0.542180804981945,10340,-0.0288064416899982,-736
"4927","3441412",0.470260154478443,11680,0.513386971782166,11862,-0.0431268173037223,-182
"4928","4441412",0.428785823777903,13384,0.470976596660355,13725,-0.0421907728824518,-341
"4929","1112412",0.824731727379564,180,0.822653556573746,256,0.0020781708058184,-76
"4930","2112412",0.761508554871375,651,0.766279071932923,836,-0.00477051706154719,-185
"4931","3112412",0.718394346057872,1300,0.737485238733143,1361,-0.0190908926752712,-61
"4932","4112412",0.676920015357332,2316,0.695074863611333,2575,-0.0181548482540008,-259
"4933","1212412",0.770773949786568,541,0.76734927762804,813,0.00342467215852849,-272
"4934","2212412",0.707550777278379,1533,0.710974792987216,2052,-0.0034240157088371,-519
"4935","3212412",0.664436568464876,2679,0.682180959787437,3040,-0.0177443913225611,-361
"4936","4212412",0.622962237764336,4219,0.639770584665627,4930,-0.0168083469012907,-711
"4937","1312412",0.742794479509792,886,0.740298710294742,1311,0.00249576921505024,-425
"4938","2312412",0.679571307001603,2242,0.683924225653918,2970,-0.00435291865231535,-728
"4939","3312412",0.6364570981881,3701,0.655130392454139,4183,-0.0186732942660394,-482
"4940","4312412",0.59498276748756,5471,0.612720017332329,6349,-0.017737249844769,-878
"4941","1412412",0.703857981524796,1614,0.699669206326636,2419,0.00418877519816008,-805
"4942","2412412",0.640634809016607,3538,0.643294721685813,4746,-0.00265991266920562,-1208
"4943","3412412",0.597520600203104,5350,0.614500888486033,6235,-0.0169802882829296,-885
"4944","4412412",0.556046269502564,7400,0.572090513364223,8650,-0.0160442438616593,-1250
"4945","1122412",0.756752456513144,700,0.762084244916339,908,-0.00533178840319481,-208
"4946","2122412",0.693529284004955,1860,0.705709760275516,2225,-0.0121804762705604,-365
"4947","3122412",0.650415075191452,3175,0.676915927075736,3252,-0.0265008518842844,-77
"4948","4122412",0.608940744490912,4848,0.634505551953926,5207,-0.025564807463014,-359
"4949","1222412",0.702794678920148,1632,0.706779965970633,2190,-0.00398528705048473,-558
"4950","2222412",0.639571506411959,3575,0.65040548132981,4399,-0.0108339749178503,-824
"4951","3222412",0.596457297598456,5394,0.62161164813003,5849,-0.0251543505315743,-455
"4952","4222412",0.554982966897916,7449,0.57920127300822,8242,-0.024218306110304,-793
"4953","1322412",0.674815208643372,2369,0.679729398637335,3150,-0.00491418999396298,-781
"4954","2322412",0.611592036135183,4719,0.623354913996512,5762,-0.0117628778613286,-1043
"4955","3322412",0.56847782732168,6767,0.594561080796732,7366,-0.0260832534750526,-599
"4956","4322412",0.52700349662114,8903,0.552150705674922,9789,-0.0251472090537822,-886
"4957","1422412",0.635878710658376,3717,0.639099894669229,4979,-0.00322118401085314,-1262
"4958","2422412",0.572655538150187,6549,0.582725410028406,8038,-0.0100698718782188,-1489
"4959","3422412",0.529541329336684,8756,0.553931576828626,9689,-0.0243902474919429,-933
"4960","4422412",0.488066998636144,10854,0.511521201706816,11958,-0.0234542030706725,-1104
"4961","1132412",0.713419934348045,1400,0.72361915246831,1713,-0.0101992181202656,-313
"4962","2132412",0.650196761839856,3187,0.667244667827487,3639,-0.0170479059876312,-452
"4963","3132412",0.607082553026352,4929,0.638450834627707,5021,-0.0313682816013552,-92
"4964","4132412",0.565608222325812,6909,0.596040459505897,7292,-0.0304322371800848,-383
"4965","1232412",0.659462156755048,2832,0.668314873522604,3606,-0.0088527167675555,-774
"4966","2232412",0.59623898424686,5412,0.611940388881781,6401,-0.0157014046349211,-989
"4967","3232412",0.553124775433356,7536,0.583146555682001,8005,-0.0300217802486451,-469
"4968","4232412",0.511650444732816,9687,0.540736180560191,10438,-0.0290857358273747,-751
"4969","1332412",0.631482686478272,3862,0.641264306189306,4858,-0.00978161971103375,-996
"4970","2332412",0.568259513970083,6788,0.584889821548483,7893,-0.0166303075783993,-1105
"4971","3332412",0.52514530515658,8995,0.556095988348703,9566,-0.0309506831921234,-571
"4972","4332412",0.48367097445604,11068,0.513685613226893,11846,-0.030014638770853,-778
"4973","1432412",0.592546188493276,5569,0.6006348022212,7026,-0.00808861372792391,-1457
"4974","2432412",0.529323015985087,8778,0.544260317580377,10223,-0.0149373015952896,-1445
"4975","3432412",0.486208807171584,10948,0.515466484380598,11750,-0.0292576772090136,-802
"4976","4432412",0.444734476471044,12771,0.473056109258787,13644,-0.0283216327877432,-873
"4977","1142412",0.664386369893215,2682,0.683220658341226,3000,-0.018834288448011,-318
"4978","2142412",0.601163197385026,5181,0.626846173700403,5571,-0.0256829763153766,-390
"4979","3142412",0.558048988571523,7272,0.598052340500623,7178,-0.0400033519291007,94
"4980","4142412",0.516574657870983,9433,0.555641965378813,9594,-0.0390673075078303,-161
"4981","1242412",0.610428592300219,4775,0.62791637939552,5510,-0.017487787095301,-735
"4982","2242412",0.54720541979203,7838,0.571541894754697,8689,-0.0243364749626666,-851
"4983","3242412",0.504091210978527,10057,0.542748061554917,10303,-0.0386568505763906,-246
"4984","4242412",0.462616880277987,12014,0.500337686433107,12476,-0.0377208061551202,-462
"4985","1342412",0.582449122023443,6065,0.600865812062222,7009,-0.0184166900387792,-944
"4986","2342412",0.519225949515254,9271,0.544491327421399,10208,-0.0252653779061448,-937
"4987","3342412",0.47611174070175,11417,0.515697494221619,11739,-0.0395857535198688,-322
"4988","4342412",0.434637410001211,13160,0.473287119099809,13633,-0.0386497090985984,-473
"4989","1442412",0.543512624038447,8042,0.560236308094116,9314,-0.0167236840556694,-1272
"4990","2442412",0.480289451530258,11207,0.503861823453293,12306,-0.0235723719230351,-1099
"4991","3442412",0.437175242716755,13050,0.475067990253514,13549,-0.037892747536759,-499
"4992","4442412",0.395700912016215,14424,0.432657615131703,14909,-0.0369567031154886,-485
"4993","1113412",0.785848551807079,402,0.797156966184507,442,-0.0113084143774282,-40
"4994","2113412",0.72262537929889,1220,0.740782481543684,1298,-0.0181571022447938,-78
"4995","3113412",0.679511170485386,2244,0.711988648343904,2012,-0.0324774778585178,232
"4996","4113412",0.638036839784846,3634,0.669578273222094,3536,-0.0315414334372474,98
"4997","1213412",0.731890774214083,1061,0.741852687238801,1273,-0.00996191302471805,-212
"4998","2213412",0.668667601705894,2550,0.685478202597977,2911,-0.0168106008920836,-361
"4999","3213412",0.62555339289239,4099,0.656684369398198,4121,-0.0311309765058077,-22
"5000","4213412",0.58407906219185,5997,0.614273994276388,6254,-0.0301949320845374,-257
"5001","1313412",0.703911303937306,1612,0.714802119905503,1940,-0.0108908159681963,-328
"5002","2313412",0.640688131429118,3536,0.658427635264679,4032,-0.0177395038355619,-496
"5003","3313412",0.597573922615614,5348,0.6296338020649,5427,-0.0320598794492859,-79
"5004","4313412",0.556099591915074,7394,0.58722342694309,7763,-0.0311238350280156,-369
"5005","1413412",0.66497480595231,2662,0.674172615937397,3341,-0.00919780998508646,-679
"5006","2413412",0.601751633444122,5143,0.617798131296574,6059,-0.0160464978524522,-916
"5007","3413412",0.558637424630618,7245,0.589004298096794,7657,-0.0303668734661762,-412
"5008","4413412",0.517163093930078,9406,0.546593922974984,10078,-0.0294308290449059,-672
"5009","1123412",0.717869280940659,1307,0.7365876545271,1386,-0.0187183735864415,-79
"5010","2123412",0.65464610843247,3000,0.680213169886277,3127,-0.025567061453807,-127
"5011","3123412",0.611531899618966,4724,0.651419336686497,4344,-0.0398874370675311,380
"5012","4123412",0.570057568918426,6690,0.609008961564687,6553,-0.0389513926462606,137
"5013","1223412",0.663911503347663,2699,0.681283375581394,3083,-0.0173718722337313,-384
"5014","2223412",0.600688330839474,5194,0.62490889094057,5674,-0.0242205601010969,-480
"5015","3223412",0.55757412202597,7296,0.596115057740791,7283,-0.0385409357148209,13
"5016","4223412",0.51609979132543,9464,0.553704682618981,9704,-0.0376048912935506,-240
"5017","1323412",0.635932033070886,3713,0.654232808248096,4227,-0.0183007751772095,-514
"5018","2323412",0.572708860562698,6545,0.597858323607273,7190,-0.0251494630445751,-645
"5019","3323412",0.529594651749194,8753,0.569064490407493,8828,-0.0394698386582991,-75
"5020","4323412",0.488120321048654,10849,0.526654115285683,11163,-0.0385337942370289,-314
"5021","1423412",0.59699553508589,5373,0.61360330427999,6290,-0.0166077691940997,-917
"5022","2423412",0.533772362577702,8522,0.557228819639167,9498,-0.0234564570614654,-976
"5023","3423412",0.490658153764198,10703,0.528434986439387,11079,-0.0377768326751894,-376
"5024","4423412",0.449183823063658,12590,0.486024611317577,13094,-0.0368407882539191,-504
"5025","1133412",0.674536758775559,2385,0.698122562079071,2479,-0.0235858033035121,-94
"5026","2133412",0.61131358626737,4743,0.641748077438248,4830,-0.0304344911708777,-87
"5027","3133412",0.568199377453867,6792,0.612954244238468,6336,-0.0447548667846017,456
"5028","4133412",0.526725046753327,8921,0.570543869116658,8753,-0.0438188223633315,168
"5029","1233412",0.620578981182563,4310,0.642818283133365,4773,-0.0222393019508021,-463
"5030","2233412",0.557355808674374,7319,0.586443798492542,7810,-0.0290879898181677,-491
"5031","3233412",0.51424159986087,9552,0.557649965292762,9466,-0.0434083654318917,86
"5032","4233412",0.472767269160331,11577,0.515239590170952,11762,-0.0424723210106213,-185
"5033","1333412",0.592599510905787,5563,0.615767715800067,6176,-0.0231682048942804,-613
"5034","2333412",0.529376338397598,8770,0.559393231159244,9367,-0.030016892761646,-597
"5035","3333412",0.486262129584094,10941,0.530599397959464,10964,-0.04433726837537,-23
"5036","4333412",0.444787798883555,12767,0.488189022837654,13013,-0.0434012239540995,-246
"5037","1433412",0.553663012920791,7515,0.575138211831961,8482,-0.0214751989111706,-967
"5038","2433412",0.490439840412602,10717,0.518763727191138,11570,-0.0283238867785363,-853
"5039","3433412",0.447325631599098,12667,0.489969893991359,12935,-0.0426442623922602,-268
"5040","4433412",0.405851300898559,14142,0.447559518869548,14499,-0.0417082179709897,-357
"5041","1143412",0.625503194320729,4105,0.657724067951987,4067,-0.0322208736312577,38
"5042","2143412",0.562280021812541,7054,0.601349583311164,6974,-0.0390695614986233,80
"5043","3143412",0.519165812999037,9273,0.572555750111384,8618,-0.0533899371123473,655
"5044","4143412",0.477691482298497,11339,0.530145374989574,10998,-0.0524538926910768,341
"5045","1243412",0.571545416727733,6606,0.602419789006281,6908,-0.0308743722785475,-302
"5046","2243412",0.508322244219545,9838,0.546045304365458,10110,-0.0377230601459131,-272
"5047","3243412",0.465208035406041,11895,0.517251471165678,11651,-0.0520434357596371,244
"5048","4243412",0.423733704705501,13555,0.474841096043868,13560,-0.0511073913383668,-5
"5049","1343412",0.543565946450957,8035,0.575369221672983,8467,-0.0318032752220258,-432
"5050","2343412",0.480342773942768,11205,0.51899473703216,11555,-0.0386519630893913,-350
"5051","3343412",0.437228565129265,13047,0.49020090383238,12924,-0.0529723387031153,123
"5052","4343412",0.395754234428725,14421,0.44779052871057,14492,-0.052036294281845,-71
"5053","1443412",0.504629448465961,10028,0.534739717704877,10751,-0.0301102692389159,-723
"5054","2443412",0.441406275957772,12886,0.478365233064054,13403,-0.0369589571062816,-517
"5055","3443412",0.398292067144269,14343,0.449571399864274,14433,-0.0512793327200055,-90
"5056","4443412",0.356817736443729,15317,0.407161024742464,15465,-0.0503432882987352,-148
"5057","1114412",0.733641479836509,1032,0.752506352810851,1052,-0.0188648729743421,-20
"5058","2114412",0.67041830732832,2493,0.696131868170028,2533,-0.0257135608417077,-40
"5059","3114412",0.627304098514816,4030,0.667338034970248,3634,-0.0400339364554317,396
"5060","4114412",0.585829767814277,5899,0.624927659848438,5673,-0.0390978920341614,226
"5061","1214412",0.679683702243513,2233,0.697202073865145,2500,-0.0175183716216321,-267
"5062","2214412",0.616460529735324,4480,0.640827589224321,4879,-0.0243670594889976,-399
"5063","3214412",0.57334632092182,6518,0.612033756024542,6390,-0.0386874351027217,128
"5064","4214412",0.53187199022128,8629,0.569623380902732,8797,-0.0377513906814513,-168
"5065","1314412",0.651704231966737,3131,0.670151506531847,3504,-0.0184472745651103,-373
"5066","2314412",0.588481059458548,5759,0.613777021891024,6284,-0.0252959624324759,-525
"5067","3314412",0.545366850645044,7949,0.584983188691244,7886,-0.0396163380461999,63
"5068","4314412",0.503892519944504,10071,0.542572813569434,10317,-0.0386802936249295,-246
"5069","1414412",0.61276773398174,4669,0.629522002563741,5434,-0.0167542685820005,-765
"5070","2414412",0.549544561473552,7719,0.573147517922918,8591,-0.0236029564493662,-872
"5071","3414412",0.506430352660048,9930,0.544353684723138,10219,-0.0379233320630902,-289
"5072","4414412",0.464956021959508,11910,0.501943309601328,12399,-0.0369872876418198,-489
"5073","1124412",0.665662208970089,2638,0.691937041153444,2672,-0.0262748321833554,-34
"5074","2124412",0.6024390364619,5113,0.635562556512621,5141,-0.0331235200507209,-28
"5075","3124412",0.559324827648397,7208,0.606768723312841,6658,-0.047443895664445,550
"5076","4124412",0.517850496947857,9358,0.564358348191031,9082,-0.0465078512431746,276
"5077","1224412",0.611704431377093,4711,0.636632762207738,5093,-0.0249283308306453,-382
"5078","2224412",0.548481258868904,7763,0.580258277566915,8172,-0.0317770186980109,-409
"5079","3224412",0.5053670500554,9983,0.551464444367135,9819,-0.0460973943117349,164
"5080","4224412",0.46389271935486,11961,0.509054069245325,12062,-0.0451613498904645,-101
"5081","1324412",0.583724961100317,6011,0.60958219487444,6518,-0.0258572337741235,-507
"5082","2324412",0.520501788592128,9210,0.553207710233617,9734,-0.0327059216414891,-524
"5083","3324412",0.477387579778624,11351,0.524413877033837,11277,-0.0470262972552131,74
"5084","4324412",0.435913249078084,13104,0.482003501912027,13253,-0.0460902528339427,-149
"5085","1424412",0.544788463115321,7975,0.568952690906334,8836,-0.0241642277910137,-861
"5086","2424412",0.481565290607132,11152,0.512578206265511,11899,-0.0310129156583794,-747
"5087","3424412",0.438451081793628,12995,0.483784373065732,13189,-0.0453332912721033,-194
"5088","4424412",0.396976751093088,14386,0.441373997943921,14675,-0.0443972468508329,-289
"5089","1134412",0.622329686804989,4254,0.653471948705415,4264,-0.0311422619004261,-10
"5090","2134412",0.5591065142968,7222,0.597097464064592,7231,-0.0379909497677917,-9
"5091","3134412",0.515992305483297,9473,0.568303630864813,8872,-0.0523113253815157,601
"5092","4134412",0.474517974782757,11498,0.525893255743002,11208,-0.0513752809602454,290
"5093","1234412",0.568371909211993,6775,0.598167669759709,7172,-0.029795760547716,-397
"5094","2234412",0.505148736703804,9998,0.541793185118886,10370,-0.0366444484150816,-372
"5095","3234412",0.462034527890301,12047,0.512999351919106,11879,-0.0509648240288056,168
"5096","4234412",0.420560197189761,13669,0.470588976797296,13741,-0.0500287796075352,-72
"5097","1334412",0.540392438935217,8214,0.571117102426411,8722,-0.0307246634911943,-508
"5098","2334412",0.477169266427028,11366,0.514742617785588,11795,-0.0375733513585599,-429
"5099","3334412",0.434055057613525,13184,0.485948784585808,13099,-0.0518937269722838,85
"5100","4334412",0.392580726912985,14520,0.443538409463998,14619,-0.0509576825510134,-99
"5101","1434412",0.501455940950221,10201,0.530487598458305,10976,-0.0290316575080845,-775
"5102","2434412",0.438232768442032,13007,0.474113113817482,13595,-0.0358803453754501,-588
"5103","3434412",0.395118559628529,14446,0.445319280617703,14564,-0.050200720989174,-118
"5104","4434412",0.353644228927989,15373,0.402908905495892,15547,-0.0492646765679037,-174
"5105","1144412",0.57329612235016,6524,0.613073454578331,6323,-0.0397773322281716,201
"5106","2144412",0.510072949841971,9756,0.556698969937508,9530,-0.0466260200955372,226
"5107","3144412",0.466958741028467,11817,0.527905136737729,11101,-0.0609463957092612,716
"5108","4144412",0.425484410327927,13492,0.485494761615918,13122,-0.0600103512879908,370
"5109","1244412",0.519338344757164,9262,0.557769175632625,9458,-0.0384308308754615,-196
"5110","2244412",0.456115172248975,12303,0.501394690991802,12425,-0.0452795187428271,-122
"5111","3244412",0.413000963435471,13904,0.472600857792022,13663,-0.059599894356551,241
"5112","4244412",0.371526632734931,15017,0.430190482670212,14973,-0.0586638499352806,44
"5113","1344412",0.491358874480387,10671,0.530718608299327,10956,-0.0393597338189398,-285
"5114","2344412",0.428135701972199,13397,0.474344123658504,13582,-0.0462084216863053,-185
"5115","3344412",0.385021493158695,14705,0.445550290458724,14556,-0.0605287973000292,149
"5116","4344412",0.343547162458155,15533,0.403139915336914,15538,-0.0595927528787589,-5
"5117","1444412",0.452422376495391,12443,0.490089104331221,12930,-0.0376667278358299,-487
"5118","2444412",0.389199203987203,14606,0.433714619690398,14875,-0.0445154157031955,-269
"5119","3444412",0.346084995173699,15490,0.404920786490619,15507,-0.0588357913169196,-17
"5120","4444412",0.304610664473159,15999,0.362510411368808,16048,-0.0578997468956492,-49
"5121","1111122",0.900862699499595,22,0.908693990412342,19,-0.00783129091274637,3
"5122","2111122",0.837639526991406,133,0.852319505771518,116,-0.014679978780112,17
"5123","3111122",0.794525318177903,346,0.823525672571739,251,-0.029000354393836,95
"5124","4111122",0.753050987477363,746,0.781115297449928,624,-0.0280643099725657,122
"5125","1211122",0.846904921906599,104,0.853389711466635,112,-0.0064847895600364,-8
"5126","2211122",0.78368174939841,421,0.797015226825812,443,-0.013333477427402,-22
"5127","3211122",0.740567540584907,916,0.768221393626033,797,-0.027653853041126,119
"5128","4211122",0.699093209884367,1715,0.725811018504222,1648,-0.0267178086198555,67
"5129","1311122",0.818925451629823,203,0.826339144133337,239,-0.00741369250351465,-36
"5130","2311122",0.755702279121634,714,0.769964659492514,775,-0.0142623803708802,-61
"5131","3311122",0.71258807030813,1416,0.741170826292735,1287,-0.0285827559846042,129
"5132","4311122",0.671113739607591,2469,0.698760451170924,2450,-0.0276467115633338,19
"5133","1411122",0.779988953644827,449,0.785709640165232,571,-0.0057206865204048,-122
"5134","2411122",0.716765781136638,1324,0.729335155524408,1549,-0.0125693743877705,-225
"5135","3411122",0.673651572323134,2396,0.700541322324629,2390,-0.0268897500014945,6
"5136","4411122",0.632177241622595,3837,0.658130947202819,4047,-0.025953705580224,-210
"5137","1121122",0.832883428633175,150,0.848124678754935,133,-0.0152412501217596,17
"5138","2121122",0.769660256124986,559,0.791750194114112,497,-0.0220899379891252,62
"5139","3121122",0.726546047311483,1152,0.762956360914332,893,-0.0364103136028492,259
"5140","4121122",0.685071716610943,2078,0.720545985792522,1791,-0.0354742691815789,287
"5141","1221122",0.778925651040179,461,0.792820399809229,483,-0.0138947487690496,-22
"5142","2221122",0.71570247853199,1353,0.736445915168405,1391,-0.0207434366364152,-38
"5143","3221122",0.672588269718487,2428,0.707652081968626,2160,-0.0350638122501392,268
"5144","4221122",0.631113939017947,3876,0.665241706846815,3734,-0.0341277678288687,142
"5145","1321122",0.750946180763403,773,0.765769832475931,849,-0.0148236517125279,-76
"5146","2321122",0.687723008255214,2000,0.709395347835107,2104,-0.0216723395798935,-104
"5147","3321122",0.64460879944171,3376,0.680601514635328,3109,-0.0359927151936175,267
"5148","4321122",0.603134468741171,5085,0.638191139513518,5031,-0.035056670772347,54
"5149","1421122",0.712009682778407,1423,0.725140328507825,1671,-0.013130645729418,-248
"5150","2421122",0.648786510270218,3231,0.668765843867002,3578,-0.0199793335967837,-347
"5151","3421122",0.605672301456714,4983,0.639972010667222,4920,-0.0342997092105077,63
"5152","4421122",0.564197970756175,6962,0.597561635545412,7207,-0.0333636647892372,-245
"5153","1131122",0.789550906468075,384,0.809659586306906,340,-0.0201086798388305,44
"5154","2131122",0.726327733959887,1154,0.753285101666083,1039,-0.0269573677061961,115
"5155","3131122",0.683213525146383,2133,0.724491268466303,1687,-0.0412777433199201,446
"5156","4131122",0.641739194445843,3496,0.682080893344493,3047,-0.0403416988986496,449
"5157","1231122",0.73559312887508,1003,0.7543553073612,1020,-0.0187621784861203,-17
"5158","2231122",0.672369956366891,2434,0.697980822720376,2481,-0.0256108663534859,-47
"5159","3231122",0.629255747553387,3952,0.669186989520597,3556,-0.0399312419672099,396
"5160","4231122",0.587781416852847,5785,0.626776614398787,5579,-0.0389951975459396,206
"5161","1331122",0.707613658598303,1532,0.727304740027902,1602,-0.0196910814295985,-70
"5162","2331122",0.644390486090114,3387,0.670930255387079,3475,-0.0265397692969641,-88
"5163","3331122",0.601276277276611,5178,0.642136422187299,4807,-0.0408601449106881,371
"5164","4331122",0.559801946576071,7182,0.599726047065489,7071,-0.0399241004894179,111
"5165","1431122",0.668677160613307,2549,0.686675236059796,2866,-0.0179980754464887,-317
"5166","2431122",0.605453988105118,4989,0.630300751418973,5393,-0.0248467633138544,-404
"5167","3431122",0.562339779291615,7050,0.601506918219193,6962,-0.0391671389275784,88
"5168","4431122",0.520865448591075,9199,0.559096543097383,9391,-0.0382310945063081,-192
"5169","1141122",0.740517342013246,920,0.769261092179822,782,-0.0287437501665758,138
"5170","2141122",0.677294169505057,2309,0.712886607538999,1986,-0.0355924380339414,323
"5171","3141122",0.634179960691554,3776,0.684092774339219,2965,-0.0499128136476654,811
"5172","4141122",0.592705629991014,5559,0.641682399217409,4835,-0.0489767692263952,724
"5173","1241122",0.68655956442025,2041,0.713956813234116,1965,-0.0273972488138658,76
"5174","2241122",0.623336391912061,4211,0.657582328593292,4076,-0.0342459366812314,135
"5175","3241122",0.580222183098557,6196,0.628788495393513,5464,-0.0485663122949554,732
"5176","4241122",0.538747852398018,8292,0.586378120271703,7814,-0.047630267873685,478
"5177","1341122",0.658580094143474,2872,0.686906245900818,2857,-0.0283261517573441,15
"5178","2341122",0.595356921635285,5459,0.630531761259994,5381,-0.0351748396247097,78
"5179","3341122",0.552242712821781,7586,0.601737928060215,6949,-0.0494952152384337,637
"5180","4341122",0.510768382121241,9732,0.559327552938405,9372,-0.0485591708171632,360
"5181","1441122",0.619643596158478,4353,0.646276741932712,4593,-0.0266331457742343,-240
"5182","2441122",0.556420423650289,7376,0.589902257291889,7606,-0.0334818336416,-230
"5183","3441122",0.513306214836785,9608,0.561108424092109,9260,-0.047802209255324,348
"5184","4441122",0.471831884136245,11625,0.518698048970299,11574,-0.0468661648340535,51
"5185","1112122",0.867777787737906,64,0.87037500888369,75,-0.0025972211457832,-11
"5186","2112122",0.804554615229717,282,0.814000524242866,307,-0.00944590901314879,-25
"5187","3112122",0.761440406416214,652,0.785206691043087,579,-0.0237662846268728,73
"5188","4112122",0.719966075715674,1273,0.742796315921276,1253,-0.0228302402056025,20
"5189","1212122",0.81382001014491,228,0.815070729937983,302,-0.00125071979307323,-74
"5190","2212122",0.750596837636721,780,0.75869624529716,957,-0.00809940766043882,-177
"5191","3212122",0.707482628823218,1536,0.72990241209738,1535,-0.0224197832741628,1
"5192","4212122",0.666008298122678,2626,0.68749203697557,2834,-0.0214837388528923,-208
"5193","1312122",0.785840539868134,403,0.788020162604685,543,-0.00217962273655148,-140
"5194","2312122",0.722617367359945,1221,0.731645677963862,1502,-0.00902831060391707,-281
"5195","3312122",0.679503158546441,2245,0.702851844764083,2325,-0.0233486862176411,-80
"5196","4312122",0.638028827845902,3635,0.660441469642272,3952,-0.0224126417963706,-317
"5197","1412122",0.746904041883138,825,0.74739065863658,1160,-0.000486616753441638,-335
"5198","2412122",0.683680869374949,2109,0.691016173995756,2708,-0.00733530462080734,-599
"5199","3412122",0.640566660561446,3540,0.662222340795977,3871,-0.0216556802345313,-331
"5200","4412122",0.599092329860906,5273,0.619811965674167,5951,-0.0207196358132609,-678
"5201","1122122",0.799798516871486,314,0.809805697226283,338,-0.0100071803547964,-24
"5202","2122122",0.736575344363297,983,0.753431212585459,1036,-0.016855868222162,-53
"5203","3122122",0.693461135549794,1864,0.72463737938568,1684,-0.031176243835886,180
"5204","4122122",0.651986804849254,3120,0.68222700426387,3038,-0.0302401994146158,82
"5205","1222122",0.74584073927849,843,0.754501418280576,1017,-0.00866067900208645,-174
"5206","2222122",0.682617566770301,2148,0.698126933639753,2478,-0.015509366869452,-330
"5207","3222122",0.639503357956798,3583,0.669333100439974,3548,-0.029829742483176,35
"5208","4222122",0.598029027256258,5321,0.626922725318163,5568,-0.0288936980619056,-247
"5209","1322122",0.717861269001714,1308,0.727450850947279,1599,-0.0095895819455647,-291
"5210","2322122",0.654638096493525,3001,0.671076366306455,3468,-0.0164382698129303,-467
"5211","3322122",0.611523887680022,4725,0.642282533106676,4801,-0.0307586454266543,-76
"5212","4322122",0.570049556979482,6691,0.599872157984865,7063,-0.0298226010053838,-372
"5213","1422122",0.678924771016718,2257,0.686821346979173,2860,-0.00789657596245485,-603
"5214","2422122",0.615701598508529,4507,0.63044686233835,5386,-0.0147452638298206,-879
"5215","3422122",0.572587389695026,6556,0.60165302913857,6953,-0.0290656394435446,-397
"5216","4422122",0.531113058994486,8676,0.55924265401676,9382,-0.0281295950222741,-706
"5217","1132122",0.756465994706387,706,0.771340604778254,751,-0.0148746100718673,-45
"5218","2132122",0.693242822198198,1869,0.71496612013743,1938,-0.0217232979392329,-69
"5219","3132122",0.650128613384694,3188,0.686172286937651,2883,-0.0360436735529569,305
"5220","4132122",0.608654282684154,4869,0.643761911815841,4716,-0.0351076291316864,153
"5221","1232122",0.70250821711339,1644,0.716036325832548,1908,-0.0135281087191571,-264
"5222","2232122",0.639285044605202,3595,0.659661841191724,3987,-0.0203767965865227,-392
"5223","3232122",0.596170835791698,5415,0.630868007991945,5368,-0.0346971722002467,47
"5224","4232122",0.554696505091158,7459,0.588457632870135,7689,-0.0337611277789764,-230
"5225","1332122",0.674528746836614,2386,0.68898575849925,2772,-0.0144570116626354,-386
"5226","2332122",0.611305574328425,4744,0.632611273858426,5286,-0.0213056995300009,-542
"5227","3332122",0.568191365514922,6793,0.603817440658647,6834,-0.035626075143725,-41
"5228","4332122",0.526717034814382,8923,0.561407065536837,9244,-0.0346900307224547,-321
"5229","1432122",0.635592248851618,3724,0.648356254531144,4481,-0.0127640056795255,-757
"5230","2432122",0.57236907634343,6567,0.591981769890321,7503,-0.0196126935468912,-936
"5231","3432122",0.529254867529926,8782,0.563187936690541,9151,-0.0339330691606152,-369
"5232","4432122",0.487780536829386,10868,0.520777561568731,11456,-0.032997024739345,-588
"5233","1142122",0.707432430251557,1539,0.73094211065117,1514,-0.0235096803996127,25
"5234","2142122",0.644209257743368,3394,0.674567626010346,3332,-0.0303583682669782,62
"5235","3142122",0.601095048929865,5183,0.645773792810567,4619,-0.0446787438807023,564
"5236","4142122",0.559620718229325,7188,0.603363417688757,6857,-0.043742699459432,331
"5237","1242122",0.653474652658561,3063,0.675637831705464,3304,-0.0221631790469027,-241
"5238","2242122",0.590251480150372,5684,0.61926334706464,5982,-0.0290118669142683,-298
"5239","3242122",0.547137271336869,7846,0.590469513864861,7576,-0.0433322425279923,270
"5240","4242122",0.505662940636329,9970,0.54805913874305,10007,-0.0423961981067218,-37
"5241","1342122",0.625495182381785,4107,0.648587264372166,4469,-0.0230920819903809,-362
"5242","2342122",0.562272009873596,7055,0.592212779731342,7490,-0.0299407698577465,-435
"5243","3342122",0.519157801060092,9275,0.563418946531563,9137,-0.0442611454714705,138
"5244","4342122",0.477683470359552,11340,0.521008571409753,11440,-0.0433251010502,-100
"5245","1442122",0.586558684396789,5849,0.60795776040406,6609,-0.0213990760072711,-760
"5246","2442122",0.5233355118886,9069,0.551583275763237,9812,-0.0282477638746368,-743
"5247","3442122",0.480221303075096,11210,0.522789442563457,11357,-0.0425681394883608,-147
"5248","4442122",0.438746972374556,12984,0.480379067441647,13322,-0.0416320950670904,-338
"5249","1113122",0.828894612165421,163,0.84487841849445,146,-0.0159838063290298,17
"5250","2113122",0.765671439657232,599,0.788503933853627,540,-0.0228324941963954,59
"5251","3113122",0.722557230843728,1222,0.759710100653848,938,-0.0371528698101194,284
"5252","4113122",0.681082900143188,2195,0.717299725532037,1882,-0.036216825388849,313
"5253","1213122",0.774936834572425,500,0.789574139548744,524,-0.0146373049763197,-24
"5254","2213122",0.711713662064236,1427,0.733199654907921,1462,-0.0214859928436852,-35
"5255","3213122",0.668599453250732,2553,0.704405821708141,2266,-0.0358063684574093,287
"5256","4213122",0.627125122550192,4032,0.661995446586331,3885,-0.034870324036139,147
"5257","1313122",0.746957364295648,824,0.762523572215446,900,-0.0155662079197979,-76
"5258","2313122",0.68373419178746,2106,0.706149087574623,2214,-0.0224148957871635,-108
"5259","3313122",0.640619982973956,3539,0.677355254374844,3234,-0.0367352714008875,305
"5260","4313122",0.599145652273416,5270,0.634944879253033,5184,-0.0357992269796172,86
"5261","1413122",0.708020866310652,1518,0.72189406824734,1755,-0.0138732019366881,-237
"5262","2413122",0.644797693802464,3369,0.665519583606517,3720,-0.0207218898040538,-351
"5263","3413122",0.60168348498896,5148,0.636725750406738,5089,-0.0350422654177778,59
"5264","4413122",0.56020915428842,7165,0.594315375284928,7386,-0.0341062209965075,-221
"5265","1123122",0.760915341299001,654,0.784309106837044,587,-0.0233937655380431,67
"5266","2123122",0.697692168790812,1747,0.72793462219622,1590,-0.0302424534054087,157
"5267","3123122",0.654577959977308,3005,0.699140788996441,2436,-0.0445628290191327,569
"5268","4123122",0.613103629276768,4653,0.656730413874631,4118,-0.0436267845978622,535
"5269","1223122",0.706957563706005,1545,0.729004827891337,1560,-0.0220472641853329,-15
"5270","2223122",0.643734391197816,3401,0.672630343250514,3414,-0.0288959520526985,-13
"5271","3223122",0.600620182384312,5199,0.643836510050735,4711,-0.0432163276664225,488
"5272","4223122",0.559145851683772,7219,0.601426134928924,6969,-0.0422802832451522,250
"5273","1323122",0.678978093429228,2255,0.70195426055804,2362,-0.0229761671288111,-107
"5274","2323122",0.61575492092104,4504,0.645579775917216,4627,-0.0298248549961767,-123
"5275","3323122",0.572640712107536,6550,0.616785942717437,6122,-0.0441452306099007,428
"5276","4323122",0.531166381406996,8673,0.574375567595626,8530,-0.0432091861886305,143
"5277","1423122",0.640041595444232,3561,0.661324756589934,3922,-0.0212831611457013,-361
"5278","2423122",0.576818422936044,6344,0.60495027194911,6777,-0.028131849013067,-433
"5279","3423122",0.53370421412254,8526,0.576156438749331,8419,-0.042452224626791,107
"5280","4423122",0.492229883422,10632,0.533746063627521,10811,-0.0415161802055207,-179
"5281","1133122",0.717582819133901,1315,0.745844014389015,1191,-0.0282611952551137,124
"5282","2133122",0.654359646625712,3017,0.689469529748192,2761,-0.0351098831224793,256
"5283","3133122",0.611245437812209,4746,0.660675696548412,3944,-0.0494302587362033,802
"5284","4133122",0.569771107111669,6705,0.618265321426602,6033,-0.0484942143149331,672
"5285","1233122",0.663625041540905,2713,0.690539735443309,2729,-0.0269146939024038,-16
"5286","2233122",0.600401869032716,5209,0.634165250802485,5226,-0.0337633817697693,-17
"5287","3233122",0.557287660219212,7322,0.605371417602706,6750,-0.0480837573834934,572
"5288","4233122",0.515813329518673,9475,0.562961042480896,9164,-0.0471477129622229,311
"5289","1333122",0.635645571264129,3722,0.663489168110011,3817,-0.027843596845882,-95
"5290","2333122",0.57242239875594,6565,0.607114683469187,6646,-0.0346922847132476,-81
"5291","3333122",0.529308189942436,8780,0.578320850269408,8300,-0.0490126603269716,480
"5292","4333122",0.487833859241896,10864,0.535910475147598,10690,-0.0480766159057011,174
"5293","1433122",0.596709073279133,5381,0.622859664141905,5790,-0.0261505908627722,-409
"5294","2433122",0.533485900770944,8541,0.566485179501082,8968,-0.0329992787301379,-427
"5295","3433122",0.49037169195744,10722,0.537691346301302,10596,-0.0473196543438619,126
"5296","4433122",0.4488973612569,12599,0.495280971179492,12706,-0.0463836099225914,-107
"5297","1143122",0.668549254679071,2557,0.705445520261931,2237,-0.0368962655828593,320
"5298","2143122",0.605326082170883,4994,0.649071035621107,4454,-0.0437449534502249,540
"5299","3143122",0.562211873357379,7056,0.620277202421328,5928,-0.0580653290639489,1128
"5300","4143122",0.520737542656839,9202,0.577866827299518,8329,-0.0571292846426784,873
"5301","1243122",0.614591477086075,4576,0.650141241316225,4417,-0.0355497642301491,159
"5302","2243122",0.551368304577887,7629,0.593766756675401,7420,-0.0423984520975147,209
"5303","3243122",0.508254095764383,9843,0.564972923475622,9042,-0.0567188277112387,801
"5304","4243122",0.466779765063843,11822,0.522562548353811,11368,-0.0557827832899684,454
"5305","1343122",0.586612006809299,5845,0.623090673982927,5778,-0.0364786671736274,67
"5306","2343122",0.52338883430111,9067,0.566716189342103,8959,-0.0433273550409929,108
"5307","3343122",0.480274625487607,11208,0.537922356142324,10585,-0.057647730654717,623
"5308","4343122",0.438800294787067,12982,0.495511981020514,12693,-0.0567116862334467,289
"5309","1443122",0.547675508824303,7803,0.582461170014821,8055,-0.0347856611905175,-252
"5310","2443122",0.484452336316114,11016,0.526086685373998,11198,-0.0416343490578832,-182
"5311","3443122",0.441338127502611,12889,0.497292852174218,12611,-0.0559547246716073,278
"5312","4443122",0.399863796802071,14301,0.454882477052408,14255,-0.055018680250337,46
"5313","1114122",0.776687540194851,480,0.800227805120795,422,-0.0235402649259439,58
"5314","2114122",0.713464367686662,1398,0.743853320479971,1237,-0.0303889527933094,161
"5315","3114122",0.670350158873158,2495,0.715059487280192,1934,-0.0447093284070335,561
"5316","4114122",0.628875828172619,3968,0.672649112158382,3411,-0.043773283985763,557
"5317","1214122",0.722729762601855,1215,0.744923526175088,1214,-0.0221937635732337,1
"5318","2214122",0.659506590093666,2829,0.688549041534265,2791,-0.0290424514405992,38
"5319","3214122",0.616392381280162,4484,0.659755208334486,3983,-0.0433628270543233,501
"5320","4214122",0.574918050579622,6441,0.617344833212675,6086,-0.042426782633053,355
"5321","1314122",0.694750292325079,1820,0.71787295884179,1865,-0.0231226665167119,-45
"5322","2314122",0.63152711981689,3861,0.661498474200967,3911,-0.0299713543840775,-50
"5323","3314122",0.588412911003386,5763,0.632704641001188,5282,-0.0442917299978015,481
"5324","4314122",0.546938580302846,7855,0.590294265879377,7583,-0.0433556855765312,272
"5325","1414122",0.655813794340083,2952,0.677243454873685,3240,-0.0214296605336021,-288
"5326","2414122",0.592590621831894,5565,0.620868970232861,5896,-0.0282783484009678,-331
"5327","3414122",0.54947641301839,7722,0.592075137033082,7498,-0.0425987240146918,224
"5328","4414122",0.50800208231785,9857,0.549664761911272,9910,-0.0416626795934215,-53
"5329","1124122",0.708708269328431,1501,0.739658493463388,1325,-0.0309502241349571,176
"5330","2124122",0.645485096820242,3348,0.683284008822565,2997,-0.0377989120023227,351
"5331","3124122",0.602370888006738,5119,0.654490175622785,4215,-0.0521192876160467,904
"5332","4124122",0.560896557306199,7124,0.612079800500975,6386,-0.0511832431947762,738
"5333","1224122",0.654750491735435,2994,0.684354214517682,2954,-0.0296037227822469,40
"5334","2224122",0.591527319227246,5602,0.627979729876858,5506,-0.0364524106496125,96
"5335","3224122",0.548413110413742,7769,0.599185896677079,7107,-0.0507727862633365,662
"5336","4224122",0.506938779713202,9908,0.556775521555269,9524,-0.0498367418420662,384
"5337","1324122",0.626771021458659,4043,0.657303647184384,4092,-0.0305326257257251,-49
"5338","2324122",0.56354784895047,6984,0.60092916254356,7003,-0.0373813135930907,-19
"5339","3324122",0.520433640136966,9214,0.572135329343781,8645,-0.0517016892068147,569
"5340","4324122",0.478959309436426,11279,0.529724954221971,11015,-0.0507656447855445,264
"5341","1424122",0.587834523473663,5784,0.616674143216278,6130,-0.0288396197426153,-346
"5342","2424122",0.524611350965474,9015,0.560299658575455,9309,-0.035688307609981,-294
"5343","3424122",0.48149714215197,11158,0.531505825375675,10917,-0.050008683223705,241
"5344","4424122",0.44002281145143,12942,0.489095450253865,12975,-0.0490726388024347,-33
"5345","1134122",0.665375747163331,2651,0.701193401015359,2379,-0.0358176538520277,272
"5346","2134122",0.602152574655142,5127,0.644818916374536,4663,-0.0426663417193933,464
"5347","3134122",0.559038365841639,7225,0.616025083174756,6166,-0.0569867173331173,1059
"5348","4134122",0.517564035141099,9378,0.573614708052946,8565,-0.0560506729118471,813
"5349","1234122",0.611417969570335,4735,0.645889122069653,4616,-0.0344711524993178,119
"5350","2234122",0.548194797062146,7779,0.58951463742883,7634,-0.0413198403666833,145
"5351","3234122",0.505080588248643,10002,0.56072080422905,9284,-0.0556402159804074,718
"5352","4234122",0.463606257548103,11970,0.51831042910724,11598,-0.0547041715591369,372
"5353","1334122",0.583438499293559,6032,0.618838554736355,6001,-0.035400055442796,31
"5354","2334122",0.52021532678537,9227,0.562464070095532,9197,-0.0422487433101616,30
"5355","3334122",0.477101117971866,11373,0.533670236895752,10814,-0.0565691189238856,559
"5356","4334122",0.435626787271327,13119,0.491259861773942,12877,-0.0556330745026152,242
"5357","1434122",0.544502001308563,7991,0.578209050768249,8308,-0.0337070494596862,-317
"5358","2434122",0.481278828800374,11168,0.521834566127426,11408,-0.0405557373270519,-240
"5359","3434122",0.438164619986871,13011,0.493040732927646,12799,-0.0548761129407758,212
"5360","4434122",0.396690289286331,14396,0.450630357805836,14394,-0.0539400685195055,2
"5361","1144122",0.616342182708502,4491,0.660794906888275,3941,-0.0444527241797733,550
"5362","2144122",0.553119010200313,7538,0.604420422247452,6811,-0.0513014120471389,727
"5363","3144122",0.510004801386809,9760,0.575626589047672,8455,-0.0656217876608629,1305
"5364","4144122",0.468530470686269,11759,0.533216213925862,10835,-0.0646857432395924,924
"5365","1244122",0.562384405115506,7047,0.605490627942569,6738,-0.0431062228270631,309
"5366","2244122",0.499161232607317,10308,0.549116143301745,9945,-0.0499549106944287,363
"5367","3244122",0.456047023793813,12306,0.520322310101966,11479,-0.0642752863081527,827
"5368","4244122",0.414572693093273,13861,0.477911934980156,13424,-0.0633392418868824,437
"5369","1344122",0.534404934838729,8497,0.578440060609271,8291,-0.0440351257705414,206
"5370","2344122",0.471181762330541,11644,0.522065575968447,11398,-0.050883813637907,246
"5371","3344122",0.428067553517037,13400,0.493271742768668,12791,-0.065204189251631,609
"5372","4344122",0.386593222816497,14666,0.450861367646858,14382,-0.0642681448303607,284
"5373","1444122",0.495468436853733,10470,0.537810556641165,10591,-0.0423421197874315,-121
"5374","2444122",0.432245264345544,13256,0.481436072000342,13277,-0.0491908076547973,-21
"5375","3444122",0.389131055532041,14608,0.452642238800562,14327,-0.0635111832685213,281
"5376","4444122",0.347656724831501,15471,0.410231863678752,15397,-0.062575138847251,74
"5377","1111222",0.855013865351385,84,0.86335914375756,88,-0.0083452784061746,-4
"5378","2111222",0.791790692843196,363,0.806984659116736,364,-0.0151939662735402,-1
"5379","3111222",0.748676484029693,804,0.778190825916957,660,-0.0295143418872642,144
"5380","4111222",0.707202153329153,1540,0.735780450795147,1405,-0.0285782974659939,135
"5381","1211222",0.801056087758389,302,0.808054864811853,356,-0.00699877705346463,-54
"5382","2211222",0.7378329152502,959,0.75168038017103,1071,-0.0138474649208302,-112
"5383","3211222",0.694718706436696,1821,0.722886546971251,1728,-0.0281678405345542,93
"5384","4211222",0.653244375736157,3067,0.68047617184944,3113,-0.0272317961132837,-46
"5385","1311222",0.773076617481613,518,0.781004297478555,627,-0.00792767999694288,-109
"5386","2311222",0.709853444973424,1471,0.724629812837732,1686,-0.0147763678643085,-215
"5387","3311222",0.66673923615992,2604,0.695835979637953,2544,-0.0290967434780325,60
"5388","4311222",0.62526490545938,4115,0.653425604516142,4266,-0.028160699056762,-151
"5389","1411222",0.734140119496617,1022,0.74037479351045,1309,-0.00623467401383304,-287
"5390","2411222",0.670916946988428,2472,0.684000308869626,2968,-0.0130833618811987,-496
"5391","3411222",0.627802738174924,4002,0.655206475669847,4176,-0.0274037374949228,-174
"5392","4411222",0.586328407474384,5864,0.612796100548037,6342,-0.0264676930736523,-478
"5393","1121222",0.787034594484965,394,0.802789832100153,401,-0.0157552376151878,-7
"5394","2121222",0.723811421976776,1194,0.74641534745933,1179,-0.0226039254825534,15
"5395","3121222",0.680697213163273,2208,0.71762151425955,1869,-0.0369243010962774,339
"5396","4121222",0.639222882462733,3597,0.67521113913774,3313,-0.0359882566750072,284
"5397","1221222",0.733076816891969,1040,0.747485553154447,1157,-0.0144087362624779,-117
"5398","2221222",0.66985364438378,2508,0.691111068513623,2703,-0.0212574241298434,-195
"5399","3221222",0.626739435570276,4045,0.662317235313844,3866,-0.0355777997435675,179
"5400","4221222",0.585265104869737,5940,0.619906860192034,5940,-0.034641755322297,0
"5401","1321222",0.705097346615193,1588,0.720434985821149,1799,-0.0153376392059561,-211
"5402","2321222",0.641874174107004,3486,0.664060501180325,3796,-0.0221863270733217,-310
"5403","3321222",0.5987599652935,5284,0.635266667980546,5167,-0.0365067026870457,117
"5404","4321222",0.55728563459296,7323,0.592856292858736,7464,-0.0355706582657752,-141
"5405","1421222",0.666160848630197,2625,0.679805481853043,3147,-0.0136446332228463,-522
"5406","2421222",0.602937676122008,5091,0.62343099721222,5759,-0.020493321090212,-668
"5407","3421222",0.559823467308504,7180,0.59463716401244,7363,-0.034813696703936,-183
"5408","4421222",0.518349136607964,9319,0.55222678889063,9785,-0.0338776522826655,-466
"5409","1131222",0.743702072319865,872,0.764324739652124,865,-0.0206226673322587,7
"5410","2131222",0.680478899811676,2214,0.707950255011301,2148,-0.0274713551996243,66
"5411","3131222",0.637364690998173,3662,0.679156421811521,3167,-0.0417917308133483,495
"5412","4131222",0.595890360297633,5428,0.636746046689711,5087,-0.0408556863920778,341
"5413","1231222",0.689744294726869,1952,0.709020460706418,2113,-0.0192761659795485,-161
"5414","2231222",0.62652112221868,4057,0.652645976065594,4296,-0.0261248538469141,-239
"5415","3231222",0.583406913405177,6033,0.623852142865815,5733,-0.0404452294606381,300
"5416","4231222",0.541932582704637,8127,0.581441767744005,8108,-0.0395091850393678,19
"5417","1331222",0.661764824450093,2764,0.68196989337312,3054,-0.0202050689230268,-290
"5418","2331222",0.598541651941904,5297,0.625595408732297,5636,-0.0270537567903923,-339
"5419","3331222",0.555427443128401,7431,0.596801575532517,7249,-0.0413741324041164,182
"5420","4331222",0.513953112427861,9570,0.554391200410707,9660,-0.0404380879828461,-90
"5421","1431222",0.622828326465097,4223,0.641340389405014,4855,-0.0185120629399169,-632
"5422","2431222",0.559605153956908,7190,0.584965904764191,7888,-0.0253607508072826,-698
"5423","3431222",0.516490945143405,9439,0.556172071564411,9563,-0.0396811264210066,-124
"5424","4431222",0.475016614442865,11468,0.513761696442601,11842,-0.0387450819997364,-374
"5425","1141222",0.694668507865036,1823,0.72392624552504,1701,-0.0292577376600041,122
"5426","2141222",0.631445335356847,3864,0.667551760884217,3628,-0.0361064255273696,236
"5427","3141222",0.588331126543344,5767,0.638757927684437,5000,-0.0504268011410937,767
"5428","4141222",0.546856795842803,7856,0.596347552562627,7274,-0.0494907567198234,582
"5429","1241222",0.64071073027204,3535,0.668621966579334,3587,-0.0279112363072941,-52
"5430","2241222",0.577487557763851,6315,0.61224748193851,6376,-0.0347599241746597,-61
"5431","3241222",0.534373348950347,8498,0.583453648738731,7981,-0.0490802997883837,517
"5432","4241222",0.492899018249807,10603,0.541043273616921,10419,-0.0481442553671132,184
"5433","1341222",0.612731259995263,4674,0.641571399246036,4843,-0.0288401392507723,-169
"5434","2341222",0.549508087487075,7721,0.585196914605213,7879,-0.0356888271181379,-158
"5435","3341222",0.506393878673571,9933,0.556403081405433,9548,-0.0500092027318619,385
"5436","4341222",0.464919547973031,11912,0.513992706283623,11832,-0.0490731583105914,80
"5437","1441222",0.573794762010267,6489,0.60094189527793,7002,-0.0271471332676625,-513
"5438","2441222",0.510571589502079,9737,0.544567410637107,10203,-0.0339958211350282,-466
"5439","3441222",0.467457380688575,11795,0.515773577437327,11731,-0.0483161967487522,64
"5440","4441222",0.425983049988035,13473,0.473363202315517,13629,-0.0473801523274818,-156
"5441","1112222",0.821928953589696,188,0.825040162228908,243,-0.00311120863921144,-55
"5442","2112222",0.758705781081507,682,0.768665677588084,789,-0.00995989650657703,-107
"5443","3112222",0.715591572268004,1358,0.739871844388305,1318,-0.024280272120301,40
"5444","4112222",0.674117241567464,2389,0.697461469266494,2487,-0.0233442276990308,-98
"5445","1212222",0.7679711759967,571,0.769735883283201,777,-0.00176470728650147,-206
"5446","2212222",0.704748003488511,1596,0.713361398642378,1975,-0.00861339515386705,-379
"5447","3212222",0.661633794675007,2769,0.684567565442599,2944,-0.0229337707675911,-175
"5448","4212222",0.620159463974468,4330,0.642157190320788,4804,-0.0219977263463206,-474
"5449","1312222",0.739991705719924,925,0.742685315949903,1257,-0.00269361022997971,-332
"5450","2312222",0.676768533211735,2320,0.68631083130908,2881,-0.0095422980973453,-561
"5451","3312222",0.633654324398231,3791,0.657516998109301,4080,-0.0238626737110693,-289
"5452","4312222",0.592179993697691,5580,0.61510662298749,6208,-0.0229266292897988,-628
"5453","1412222",0.701055207734928,1673,0.702055811981798,2359,-0.00100060424686987,-686
"5454","2412222",0.637832035226739,3640,0.645681327340974,4624,-0.00784929211423557,-984
"5455","3412222",0.594717826413235,5481,0.616887494141195,6115,-0.0221696677279596,-634
"5456","4412222",0.553243495712695,7530,0.574477119019385,8522,-0.0212336233066891,-992
"5457","1122222",0.753949682723276,733,0.764470850571501,861,-0.0105211678482247,-128
"5458","2122222",0.690726510215087,1933,0.708096365930677,2140,-0.0173698557155902,-207
"5459","3122222",0.647612301401584,3280,0.679302532730898,3164,-0.0316902313293143,116
"5460","4122222",0.606137970701044,4972,0.636892157609088,5080,-0.030754186908044,-108
"5461","1222222",0.69999190513028,1692,0.709166571625795,2108,-0.00917466649551468,-416
"5462","2222222",0.636768732622091,3681,0.652792086984971,4290,-0.0160233543628803,-609
"5463","3222222",0.593654523808588,5523,0.623998253785192,5723,-0.0303437299766043,-200
"5464","4222222",0.552180193108048,7591,0.581587878663381,8098,-0.0294076855553338,-507
"5465","1322222",0.672012434853504,2445,0.682116004292497,3044,-0.0101035694389929,-599
"5466","2322222",0.608789262345315,4856,0.625741519651673,5626,-0.0169522573063585,-770
"5467","3322222",0.565675053531811,6901,0.596947686451894,7241,-0.0312726329200825,-340
"5468","4322222",0.524200722831272,9037,0.554537311330084,9649,-0.030336588498812,-612
"5469","1422222",0.633075936868508,3808,0.641486500324391,4849,-0.00841056345588309,-1041
"5470","2422222",0.569852764360319,6697,0.585112015683568,7882,-0.0152592513232488,-1185
"5471","3422222",0.526738555546815,8918,0.556318182483788,9557,-0.0295796269369728,-639
"5472","4422222",0.485264224846276,10985,0.513907807361978,11837,-0.0286435825157023,-852
"5473","1132222",0.710617160558176,1459,0.726005758123472,1641,-0.0153885975652955,-182
"5474","2132222",0.647393988049987,3288,0.669631273482649,3529,-0.0222372854326611,-241
"5475","3132222",0.604279779236484,5040,0.640837440282869,4876,-0.0365576610463851,164
"5476","4132222",0.562805448535944,7021,0.598427065161059,7148,-0.0356216166251146,-127
"5477","1232222",0.65665938296518,2936,0.670701479177766,3482,-0.0140420962125853,-546
"5478","2232222",0.593436210456991,5537,0.614326994536942,6246,-0.0208907840799509,-709
"5479","3232222",0.550322001643488,7692,0.585533161337163,7860,-0.0352111596936749,-168
"5480","4232222",0.508847670942948,9809,0.543122786215353,10280,-0.0342751152724047,-471
"5481","1332222",0.628679912688404,3977,0.643650911844468,4726,-0.0149709991560636,-749
"5482","2332222",0.565456740180215,6915,0.587276427203644,7756,-0.0218196870234292,-841
"5483","3332222",0.522342531366712,9128,0.558482594003865,9423,-0.0361400626371532,-295
"5484","4332222",0.480868200666172,11190,0.516072218882055,11714,-0.0352040182158829,-524
"5485","1432222",0.589743414703408,5699,0.603021407876362,6880,-0.0132779931729538,-1181
"5486","2432222",0.526520242195219,8930,0.546646923235539,10073,-0.0201266810403194,-1143
"5487","3432222",0.483406033381716,11077,0.517853090035759,11623,-0.0344470566540435,-546
"5488","4432222",0.441931702681176,12868,0.475442714913949,13533,-0.0335110122327731,-665
"5489","1142222",0.661583596103347,2771,0.685607263996388,2905,-0.0240236678930409,-134
"5490","2142222",0.598360423595158,5305,0.629232779355565,5446,-0.0308723557604065,-141
"5491","3142222",0.555246214781655,7442,0.600438946155785,7037,-0.0451927313741305,405
"5492","4142222",0.513771884081115,9578,0.558028571033975,9443,-0.0442566869528602,135
"5493","1242222",0.607625818510351,4910,0.630302985050682,5392,-0.0226771665403309,-482
"5494","2242222",0.544402646002162,7993,0.573928500409858,8550,-0.0295258544076965,-557
"5495","3242222",0.501288437188658,10210,0.545134667210079,10162,-0.0438462300214205,48
"5496","4242222",0.459814106488118,12151,0.502724292088269,12359,-0.04291018560015,-208
"5497","1342222",0.579646348233575,6223,0.603252417717384,6865,-0.0236060694838092,-642
"5498","2342222",0.516423175725386,9443,0.54687793307656,10063,-0.0304547573511748,-620
"5499","3342222",0.473308966911882,11554,0.518084099876781,11611,-0.0447751329648988,-57
"5500","4342222",0.431834636211342,13275,0.475673724754971,13522,-0.0438390885436283,-247
"5501","1442222",0.540709850248579,8197,0.562622913749278,9186,-0.0219130635006993,-989
"5502","2442222",0.47748667774039,11345,0.506248429108455,12195,-0.028761751368065,-850
"5503","3442222",0.434372468926886,13174,0.477454595908675,13452,-0.043082126981789,-278
"5504","4442222",0.392898138226346,14509,0.435044220786865,14842,-0.0421460825605186,-333
"5505","1113222",0.78304577801721,423,0.799543571839669,424,-0.0164977938224581,-1
"5506","2113222",0.719822605509022,1274,0.743169087198845,1246,-0.0233464816898237,28
"5507","3113222",0.676708396695518,2322,0.714375253999066,1951,-0.0376668573035477,371
"5508","4113222",0.635234065994978,3736,0.671964878877255,3440,-0.0367308128822772,296
"5509","1213222",0.729088000424214,1102,0.744239292893962,1224,-0.0151512924697479,-122
"5510","2213222",0.665864827916026,2630,0.687864808253139,2814,-0.0219999803371135,-184
"5511","3213222",0.622750619102522,4225,0.65907097505336,4006,-0.0363203559508375,219
"5512","4213222",0.581276288401982,6133,0.616660599931549,6131,-0.0353843115295672,2
"5513","1313222",0.701108530147438,1672,0.717188725560664,1885,-0.0160801954132261,-213
"5514","2313222",0.637885357639249,3637,0.660814240919841,3940,-0.0229288832805917,-303
"5515","3313222",0.594771148825746,5479,0.632020407720062,5316,-0.0372492588943157,163
"5516","4313222",0.553296818125206,7527,0.589610032598251,7627,-0.0363132144730455,-100
"5517","1413222",0.662172032162442,2756,0.676559221592559,3271,-0.0143871894301163,-515
"5518","2413222",0.598948859654253,5278,0.620184736951735,5931,-0.021235877297482,-653
"5519","3413222",0.55583465084075,7405,0.591390903751956,7531,-0.035556252911206,-126
"5520","4413222",0.51436032014021,9545,0.548980528630146,9952,-0.0346202084899357,-407
"5521","1123222",0.71506650715079,1364,0.738974260182262,1335,-0.0239077530314713,29
"5522","2123222",0.651843334642602,3122,0.682599775541438,3020,-0.0307564408988369,102
"5523","3123222",0.608729125829098,4861,0.653805942341659,4242,-0.0450768165125609,619
"5524","4123222",0.567254795128558,6834,0.611395567219849,6422,-0.0441407720912904,412
"5525","1223222",0.661108729557794,2782,0.683669981236556,2978,-0.0225612516787611,-196
"5526","2223222",0.597885557049606,5327,0.627295496595732,5544,-0.0294099395461267,-217
"5527","3223222",0.554771348236102,7456,0.598501663395953,7141,-0.0437303151598507,315
"5528","4223222",0.513297017535562,9609,0.556091288274142,9567,-0.0427942707385804,42
"5529","1323222",0.633129259281018,3805,0.656619413903258,4126,-0.0234901546222394,-321
"5530","2323222",0.569906086772829,6695,0.600244929262434,7045,-0.0303388424896049,-350
"5531","3323222",0.526791877959326,8913,0.571451096062655,8698,-0.044659218103329,215
"5532","4323222",0.485317547258786,10983,0.529040720940845,11052,-0.0437231736820587,-69
"5533","1423222",0.594192761296022,5507,0.615989909935152,6171,-0.0217971486391295,-664
"5534","2423222",0.530969588787833,8683,0.559615425294329,9359,-0.0286458365064952,-676
"5535","3423222",0.48785537997433,10861,0.530821592094549,10951,-0.0429662121202192,-90
"5536","4423222",0.44638104927379,12700,0.488411216972739,13004,-0.042030167698949,-304
"5537","1133222",0.671733984985691,2453,0.700509167734233,2391,-0.028775182748542,62
"5538","2133222",0.608510812477502,4871,0.64413468309341,4691,-0.0356238706159075,180
"5539","3133222",0.565396603663999,6917,0.61534084989363,6195,-0.0499442462296316,722
"5540","4133222",0.523922272963459,9050,0.57293047477182,8599,-0.0490082018083613,451
"5541","1233222",0.617776207392695,4434,0.645204888788527,4644,-0.027428681395832,-210
"5542","2233222",0.554553034884506,7474,0.588830404147703,7667,-0.0342773692631976,-193
"5543","3233222",0.511438826071002,9695,0.560036570947924,9331,-0.0485977448769216,364
"5544","4233222",0.469964495370462,11695,0.517626195826114,11634,-0.0476617004556511,61
"5545","1333222",0.589796737115919,5697,0.618154321455229,6040,-0.0283575843393102,-343
"5546","2333222",0.52657356460773,8927,0.561779836814405,9229,-0.0352062722066758,-302
"5547","3333222",0.483459355794226,11074,0.532986003614626,10849,-0.0495266478203998,225
"5548","4333222",0.441985025093686,12867,0.490575628492816,12907,-0.0485906033991294,-40
"5549","1433222",0.550860239130923,7660,0.577524817487123,8346,-0.0266645783562004,-686
"5550","2433222",0.487637066622734,10874,0.5211503328463,11436,-0.0335132662235661,-562
"5551","3433222",0.44452285780923,12773,0.49235649964652,12834,-0.0478336418372902,-61
"5552","4433222",0.40304852710869,14213,0.44994612452471,14420,-0.0468975974160197,-207
"5553","1143222",0.622700420530861,4229,0.660110673607149,3965,-0.0374102530762875,264
"5554","2143222",0.559477248022672,7195,0.603736188966326,6840,-0.0442589409436531,355
"5555","3143222",0.516363039209169,9448,0.574942355766546,8491,-0.0585793165573771,957
"5556","4143222",0.474888708508629,11480,0.532531980644736,10870,-0.0576432721361066,610
"5557","1243222",0.568742642937865,6749,0.604806394661443,6785,-0.0360637517235773,-36
"5558","2243222",0.505519470429676,9975,0.548431910020619,9984,-0.0429124395909429,-9
"5559","3243222",0.462405261616173,12025,0.51963807682084,11517,-0.0572328152046669,508
"5560","4243222",0.420930930915633,13652,0.47722770169903,13462,-0.0562967707833967,190
"5561","1343222",0.540763172661089,8192,0.577755827328145,8338,-0.0369926546670556,-146
"5562","2343222",0.4775400001529,11343,0.521381342687321,11431,-0.0438413425344212,-88
"5563","3343222",0.434425791339397,13171,0.492587509487542,12821,-0.0581617181481452,350
"5564","4343222",0.392951460638857,14507,0.450177134365732,14416,-0.057225673726875,91
"5565","1443222",0.501826674676093,10176,0.537126323360039,10630,-0.0352996486839458,-454
"5566","2443222",0.438603502167904,12989,0.480751838719216,13310,-0.0421483365513115,-321
"5567","3443222",0.395489293354401,14428,0.451958005519436,14346,-0.0564687121650355,82
"5568","4443222",0.354014962653861,15362,0.409547630397626,15414,-0.0555326677437652,-52
"5569","1114222",0.730838706046641,1078,0.754892958466013,1010,-0.0240542524193721,68
"5570","2114222",0.667615533538452,2584,0.698518473825189,2459,-0.0309029402867377,125
"5571","3114222",0.624501324724948,4155,0.66972464062541,3523,-0.0452233159004617,632
"5572","4114222",0.583026994024408,6046,0.6273142655036,5541,-0.0442872714791912,505
"5573","1214222",0.676880928453645,2317,0.699588679520306,2422,-0.0227077510666619,-105
"5574","2214222",0.613657755945456,4630,0.643214194879483,4750,-0.0295564389340275,-120
"5575","3214222",0.570543547131952,6658,0.614420361679704,6241,-0.0438768145477515,417
"5576","4214222",0.529069216431412,8787,0.572009986557893,8656,-0.0429407701264812,131
"5577","1314222",0.648901458176868,3228,0.672538112187009,3420,-0.0236366540101401,-192
"5578","2314222",0.58567828566868,5906,0.616163627546185,6161,-0.0304853418775057,-255
"5579","3314222",0.542564076855176,8090,0.587369794346406,7749,-0.0448057174912297,341
"5580","4314222",0.501089746154636,10213,0.544959419224595,10172,-0.0438696730699595,41
"5581","1414222",0.609964960191872,4801,0.631908608218903,5325,-0.0219436480270303,-524
"5582","2414222",0.546741787683684,7861,0.57553412357808,8460,-0.028792335894396,-599
"5583","3414222",0.50362757887018,10081,0.5467402903783,10067,-0.04311271150812,14
"5584","4414222",0.46215324816964,12041,0.50432991525649,12279,-0.0421766670868498,-238
"5585","1124222",0.662859435180221,2732,0.694323646808606,2600,-0.0314642116283853,132
"5586","2124222",0.599636262672032,5245,0.637949162167783,5042,-0.0383128994957509,203
"5587","3124222",0.556522053858528,7367,0.609155328968003,6546,-0.0526332751094749,821
"5588","4124222",0.515047723157988,9515,0.566744953846193,8956,-0.0516972306882044,559
"5589","1224222",0.608901657587225,4852,0.6390193678629,4988,-0.0301177102756751,-136
"5590","2224222",0.545678485079036,7924,0.582644883222076,8045,-0.0369663981430407,-121
"5591","3224222",0.502564276265532,10134,0.553851050022297,9696,-0.0512867737567647,438
"5592","4224222",0.461089945564992,12093,0.511440674900487,11965,-0.0503507293354944,128
"5593","1324222",0.580922187310448,6152,0.611968800529602,6398,-0.0310466132191534,-246
"5594","2324222",0.51769901480226,9365,0.555594315888779,9598,-0.037895301086519,-233
"5595","3324222",0.474584805988756,11491,0.526800482688999,11154,-0.052215676700243,337
"5596","4324222",0.433110475288216,13229,0.484390107567189,13167,-0.0512796322789726,62
"5597","1424222",0.541985689325452,8125,0.571339296561496,8706,-0.0293536072360435,-581
"5598","2424222",0.478762516817264,11286,0.514964811920673,11779,-0.0362022951034092,-493
"5599","3424222",0.43564830800376,13116,0.486170978720893,13090,-0.0505226707171333,26
"5600","4424222",0.39417397730322,14473,0.443760603599083,14612,-0.0495866262958629,-139
"5601","1134222",0.619526913015121,4358,0.655858554360577,4152,-0.036331641345456,206
"5602","2134222",0.556303740506932,7383,0.599484069719754,7085,-0.0431803292128216,298
"5603","3134222",0.513189531693429,9612,0.570690236519974,8742,-0.0575007048265456,870
"5604","4134222",0.471715200992889,11627,0.528279861398164,11087,-0.0565646604052753,540
"5605","1234222",0.565569135422125,6911,0.600554275414871,7031,-0.034985139992746,-120
"5606","2234222",0.502345962913936,10146,0.544179790774048,10227,-0.0418338278601116,-81
"5607","3234222",0.459231754100432,12177,0.515385957574268,11755,-0.0561542034738356,422
"5608","4234222",0.417757423399893,13758,0.472975582452458,13649,-0.0552181590525652,109
"5609","1334222",0.537589665145349,8344,0.573503708081573,8574,-0.0359140429362242,-230
"5610","2334222",0.47436649263716,11504,0.51712922344075,11659,-0.0427627308035898,-155
"5611","3334222",0.431252283823656,13292,0.48833539024097,13007,-0.0570831064173138,285
"5612","4334222",0.389777953123116,14595,0.44592501511916,14544,-0.0561470619960434,51
"5613","1434222",0.498653167160353,10329,0.532874204113467,10855,-0.0342210369531144,-526
"5614","2434222",0.435429994652164,13127,0.476499719472644,13493,-0.04106972482048,-366
"5615","3434222",0.39231578583866,14523,0.447705886272864,14494,-0.0553901004342041,29
"5616","4434222",0.35084145513812,15421,0.405295511151054,15498,-0.0544540560129337,-77
"5617","1144222",0.570493348560291,6663,0.615460060233493,6190,-0.0449667116732015,473
"5618","2144222",0.507270176052103,9886,0.55908557559267,9392,-0.0518153995405671,494
"5619","3144222",0.464155967238599,11949,0.53029174239289,10988,-0.0661357751542911,961
"5620","4144222",0.422681636538059,13590,0.48788136727108,13024,-0.0651997307330207,566
"5621","1244222",0.516535570967295,9435,0.560155781287787,9321,-0.0436202103204913,114
"5622","2244222",0.453312398459106,12414,0.503781296646963,12311,-0.050468898187857,103
"5623","3244222",0.410198189645603,13990,0.474987463447184,13553,-0.064789273801581,437
"5624","4244222",0.368723858945063,15081,0.432577088325374,14915,-0.0638532293803106,166
"5625","1344222",0.488556100690519,10824,0.533105213954489,10841,-0.0445491132639696,-17
"5626","2344222",0.42533292818233,13495,0.476730729313666,13484,-0.0513978011313352,11
"5627","3344222",0.382218719368827,14777,0.447936896113886,14484,-0.0657181767450593,293
"5628","4344222",0.340744388668287,15583,0.405526520992076,15494,-0.0647821323237889,89
"5629","1444222",0.449619602705523,12565,0.492475709986383,12829,-0.0428561072808598,-264
"5630","2444222",0.386396430197334,14668,0.43610122534556,14819,-0.0497047951482255,-151
"5631","3444222",0.343282221383831,15537,0.40730739214578,15459,-0.0640251707619496,78
"5632","4444222",0.301807890683291,16018,0.36489701702397,16021,-0.0630891263406792,-3
"5633","1111322",0.832559886346077,151,0.845309153829885,144,-0.012749267483808,7
"5634","2111322",0.769336713837888,563,0.788934669189062,532,-0.0195979553511736,31
"5635","3111322",0.726222505024385,1156,0.760140835989282,932,-0.0339183309648976,224
"5636","4111322",0.684748174323845,2083,0.717730460867472,1868,-0.0329822865436273,215
"5637","1211322",0.778602108753081,465,0.790004874884179,518,-0.011402766131098,-53
"5638","2211322",0.715378936244892,1362,0.733630390243356,1446,-0.0182514539984636,-84
"5639","3211322",0.672264727431388,2437,0.704836557043576,2254,-0.0325718296121876,183
"5640","4211322",0.630790396730849,3880,0.662426181921766,3861,-0.0316357851909171,19
"5641","1311322",0.750622638476305,779,0.762954307550881,894,-0.0123316690745763,-115
"5642","2311322",0.687399465968116,2016,0.706579822910058,2203,-0.0191803569419419,-187
"5643","3311322",0.644285257154612,3392,0.677785989710278,3214,-0.0335007325556659,178
"5644","4311322",0.602810926454072,5096,0.635375614588468,5156,-0.0325646881343954,-60
"5645","1411322",0.711686140491309,1430,0.722324803582775,1744,-0.0106386630914664,-314
"5646","2411322",0.64846296798312,3250,0.665950318941952,3697,-0.0174873509588321,-447
"5647","3411322",0.605348759169616,4993,0.637156485742172,5071,-0.0318077265725561,-78
"5648","4411322",0.563874428469076,6969,0.594746110620362,7357,-0.0308716821512857,-388
"5649","1121322",0.764580615479657,614,0.784739842172478,581,-0.0201592266928212,33
"5650","2121322",0.701357442971468,1667,0.728365357531655,1576,-0.0270079145601868,91
"5651","3121322",0.658243234157965,2883,0.699571524331876,2423,-0.0413282901739108,460
"5652","4121322",0.616768903457425,4465,0.657161149210065,4098,-0.0403922457526406,367
"5653","1221322",0.710622837886661,1458,0.729435563226772,1545,-0.0188127253401112,-87
"5654","2221322",0.647399665378472,3287,0.673061078585949,3394,-0.0256614132074768,-107
"5655","3221322",0.604285456564968,5039,0.644267245386169,4685,-0.0399817888212008,354
"5656","4221322",0.562811125864429,7019,0.601856870264359,6939,-0.0390457443999304,80
"5657","1321322",0.682643367609885,2146,0.702384995893474,2344,-0.0197416282835895,-198
"5658","2321322",0.619420195101696,4365,0.646010511252651,4609,-0.0265903161509551,-244
"5659","3321322",0.576305986288192,6367,0.617216678052871,6098,-0.0409106917646791,269
"5660","4321322",0.534831655587652,8469,0.574806302931061,8503,-0.0399746473434086,-34
"5661","1421322",0.643706869624889,3404,0.661755491925368,3900,-0.0180486223004797,-496
"5662","2421322",0.5804836971167,6175,0.605381007284545,6747,-0.0248973101678454,-572
"5663","3421322",0.537369488303196,8352,0.576587174084766,8395,-0.0392176857815694,-43
"5664","4421322",0.495895157602656,10455,0.534176798962955,10783,-0.0382816413602989,-328
"5665","1131322",0.721248093314557,1249,0.746274749724449,1182,-0.0250266564098921,67
"5666","2131322",0.658024920806368,2888,0.689900265083626,2745,-0.0318753442772577,143
"5667","3131322",0.614910711992865,4557,0.661106431883847,3927,-0.0461957198909817,630
"5668","4131322",0.573436381292325,6509,0.618696056762036,6007,-0.0452596754697112,502
"5669","1231322",0.667290315721561,2594,0.690970470778743,2710,-0.0236801550571819,-116
"5670","2231322",0.604067143213372,5048,0.63459598613792,5202,-0.0305288429245475,-154
"5671","3231322",0.560952934399869,7120,0.60580215293814,6715,-0.0448492185382715,405
"5672","4231322",0.519478603699329,9253,0.56339177781633,9139,-0.0439131741170012,114
"5673","1331322",0.639310845444785,3594,0.663919903445445,3803,-0.0246090580006602,-209
"5674","2331322",0.576087672936596,6381,0.607545418804622,6628,-0.0314577458680257,-247
"5675","3331322",0.532973464123093,8577,0.578751585604843,8273,-0.0457781214817498,304
"5676","4331322",0.491499133422553,10663,0.536341210483032,10667,-0.0448420770604795,-4
"5677","1431322",0.600374347459789,5211,0.62329039947734,5767,-0.0229160520175503,-556
"5678","2431322",0.5371511749516,8366,0.566915914836516,8945,-0.029764739884916,-579
"5679","3431322",0.494036966138097,10542,0.538122081636737,10571,-0.04408511549864,-29
"5680","4431322",0.452562635437557,12437,0.495711706514926,12682,-0.0431490710773698,-245
"5681","1141322",0.672214528859728,2439,0.705876255597365,2219,-0.0336617267376375,220
"5682","2141322",0.608991356351539,4845,0.649501770956542,4434,-0.040510414605003,411
"5683","3141322",0.565877147538036,6892,0.620707937756763,5902,-0.0548307902187271,990
"5684","4141322",0.524402816837495,9025,0.578297562634952,8302,-0.0538947457974568,723
"5685","1241322",0.618256751266732,4419,0.650571976651659,4391,-0.0323152253849275,28
"5686","2241322",0.555033578758543,7447,0.594197492010836,7394,-0.0391639132522931,53
"5687","3241322",0.511919369945039,9675,0.565403658811056,9021,-0.0534842888660171,654
"5688","4241322",0.470445039244499,11671,0.522993283689246,11349,-0.0525482444447466,322
"5689","1341322",0.590277280989955,5681,0.623521409318361,5754,-0.0332441283284057,-73
"5690","2341322",0.527054108481767,8901,0.567146924677538,8933,-0.0400928161957713,-32
"5691","3341322",0.483939899668263,11056,0.538353091477758,10561,-0.0544131918094953,495
"5692","4341322",0.442465568967723,12853,0.495942716355948,12673,-0.0534771473882249,180
"5693","1441322",0.55134078300496,7634,0.582891905350255,8025,-0.0315511223452959,-391
"5694","2441322",0.488117610496771,10850,0.526517420709432,11168,-0.0383998102126616,-318
"5695","3441322",0.445003401683267,12758,0.497723587509653,12591,-0.0527201858263857,167
"5696","4441322",0.403529070982727,14205,0.455313212387842,14235,-0.0517841414051152,-30
"5697","1112322",0.799474974584388,317,0.806990172301233,363,-0.00751519771684483,-46
"5698","2112322",0.736251802076199,991,0.75061568766041,1090,-0.0143638855842104,-99
"5699","3112322",0.693137593262696,1871,0.72182185446063,1758,-0.0286842611979344,113
"5700","4112322",0.651663262562156,3133,0.67941147933882,3161,-0.0277482167766642,-28
"5701","1212322",0.745517196991392,851,0.751685893355527,1070,-0.00616869636413486,-219
"5702","2212322",0.682294024483203,2161,0.695311408714703,2568,-0.0130173842315005,-407
"5703","3212322",0.6391798156697,3600,0.666517575514924,3666,-0.0273377598452245,-66
"5704","4212322",0.59770548496916,5335,0.624107200393114,5716,-0.026401715423954,-381
"5705","1312322",0.717537726714616,1317,0.724635326022229,1685,-0.00709759930761311,-368
"5706","2312322",0.654314554206427,3020,0.668260841381406,3609,-0.0139462871749787,-589
"5707","3312322",0.611200345392923,4748,0.639467008181626,4955,-0.0282666627887027,-207
"5708","4312322",0.569726014692383,6707,0.597056633059816,7234,-0.0273306183674322,-527
"5709","1412322",0.67860122872962,2267,0.684005822054123,2967,-0.00540459332450327,-700
"5710","2412322",0.615378056221431,4534,0.6276313374133,5531,-0.012253281191869,-997
"5711","3412322",0.572263847407927,6574,0.59883750421352,7121,-0.026573656805593,-547
"5712","4412322",0.530789516707387,8692,0.55642712909171,9547,-0.0256376123843225,-855
"5713","1122322",0.731495703717968,1070,0.746420860643826,1178,-0.0149251569258581,-108
"5714","2122322",0.668272531209779,2566,0.690046376003003,2739,-0.0217738447932236,-173
"5715","3122322",0.625158322396276,4121,0.661252542803223,3924,-0.0360942204069477,197
"5716","4122322",0.583683991695736,6013,0.618842167681413,6000,-0.0351581759856774,13
"5717","1222322",0.677537926124972,2303,0.69111658169812,2702,-0.0135786555731481,-399
"5718","2222322",0.614314753616783,4593,0.634742097057297,5196,-0.0204273434405137,-603
"5719","3222322",0.57120054480328,6628,0.605948263857517,6705,-0.0347477190542377,-77
"5720","4222322",0.52972621410274,8744,0.563537888735707,9127,-0.0338116746329672,-383
"5721","1322322",0.649558455848196,3207,0.664066014364822,3795,-0.0145075585166263,-588
"5722","2322322",0.586335283340007,5863,0.607691529723999,6621,-0.0213562463839919,-758
"5723","3322322",0.543221074526503,8059,0.578897696524219,8267,-0.0356766219977159,-208
"5724","4322322",0.501746743825964,10181,0.536487321402409,10659,-0.0347405775764454,-478
"5725","1422322",0.6106219578632,4765,0.623436510396716,5758,-0.0128145525335165,-993
"5726","2422322",0.547398785355011,7818,0.567062025755893,8938,-0.0196632404008822,-1120
"5727","3422322",0.504284576541507,10044,0.538268192556114,10565,-0.0339836160146062,-521
"5728","4422322",0.462810245840968,12006,0.495857817434303,12678,-0.0330475715933357,-672
"5729","1132322",0.688163181552868,1992,0.707955768195797,2147,-0.0197925866429289,-155
"5730","2132322",0.62494000904468,4133,0.651581283554974,4336,-0.0266412745102945,-203
"5731","3132322",0.581825800231176,6100,0.622787450355195,5792,-0.0409616501240185,308
"5732","4132322",0.540351469530636,8217,0.580377075233384,8165,-0.040025605702748,52
"5733","1232322",0.634205403959872,3775,0.652651489250091,4295,-0.0184460852902187,-520
"5734","2232322",0.570982231451683,6638,0.596277004609268,7277,-0.0252947731575843,-639
"5735","3232322",0.52786802263818,8851,0.567483171409488,8913,-0.0396151487713083,-62
"5736","4232322",0.48639369193764,10934,0.525072796287678,11243,-0.0386791043500381,-309
"5737","1332322",0.606225933683096,4969,0.625600921916793,5635,-0.019374988233697,-666
"5738","2332322",0.543002761174907,8069,0.56922643727597,8818,-0.0262236761010626,-749
"5739","3332322",0.499888552361404,10274,0.54043260407619,10455,-0.0405440517147866,-181
"5740","4332322",0.458414221660864,12215,0.49802222895438,12581,-0.0396080072935163,-366
"5741","1432322",0.5672894356981,6831,0.584971417948687,7887,-0.0176819822505871,-1056
"5742","2432322",0.504066263189911,10059,0.528596933307864,11072,-0.0245306701179528,-1013
"5743","3432322",0.460952054376408,12098,0.499803100108085,12508,-0.0388510457316769,-410
"5744","4432322",0.419477723675868,13714,0.457392724986274,14165,-0.0379150013104066,-451
"5745","1142322",0.639129617098039,3602,0.667557274068713,3627,-0.0284276569706743,-25
"5746","2142322",0.57590644458985,6389,0.61118278942789,6429,-0.0352763448380399,-40
"5747","3142322",0.532792235776347,8582,0.58238895622811,8061,-0.0495967204517639,521
"5748","4142322",0.491317905075807,10675,0.5399785811063,10477,-0.0486606760304936,198
"5749","1242322",0.585171839505043,5945,0.612252995123007,6374,-0.0270811556179643,-429
"5750","2242322",0.521948666996854,9150,0.555878510482184,9585,-0.0339298434853299,-435
"5751","3242322",0.47883445818335,11285,0.527084677282404,11139,-0.0482502190990539,146
"5752","4242322",0.43736012748281,13043,0.484674302160594,13152,-0.0473141746777835,-109
"5753","1342322",0.557192369228267,7335,0.585202427789709,7878,-0.0280100585614426,-543
"5754","2342322",0.493969196720078,10546,0.528827943148886,11061,-0.0348587464288082,-515
"5755","3342322",0.450854987906574,12512,0.500034109949106,12500,-0.0491791220425322,12
"5756","4342322",0.409380657206034,14018,0.457623734827296,14161,-0.0482430776212617,-143
"5757","1442322",0.518255871243271,9333,0.544572923821603,10202,-0.0263170525783327,-869
"5758","2442322",0.455032698735082,12338,0.48819843918078,13010,-0.0331657404456985,-672
"5759","3442322",0.411918489921578,13941,0.459404605981001,14107,-0.0474861160594225,-166
"5760","4442322",0.370444159221038,15040,0.41699423085919,15258,-0.0465500716381521,-218
"5761","1113322",0.760591799011902,663,0.781493581911994,617,-0.0209017829000915,46
"5762","2113322",0.697368626503714,1763,0.725119097271171,1674,-0.0277504707674571,89
"5763","3113322",0.65425441769021,3022,0.696325264071391,2526,-0.0420708463811811,496
"5764","4113322",0.61278008698967,4667,0.653914888949581,4240,-0.0411348019599106,427
"5765","1213322",0.706634021418906,1553,0.726189302966288,1635,-0.0195552815473813,-82
"5766","2213322",0.643410848910718,3420,0.669814818325464,3518,-0.0264039694147469,-98
"5767","3213322",0.600296640097214,5215,0.641020985125685,4871,-0.0407243450284709,344
"5768","4213322",0.558822309396674,7230,0.598610610003875,7136,-0.0397883006072006,94
"5769","1313322",0.67865455114213,2265,0.69913873563299,2437,-0.0204841844908595,-172
"5770","2313322",0.615431378633941,4530,0.642764250992166,4776,-0.0273328723582251,-246
"5771","3313322",0.572317169820438,6572,0.613970417792387,6271,-0.0416532479719491,301
"5772","4313322",0.530842839119898,8689,0.571560042670577,8688,-0.0407172035506789,1
"5773","1413322",0.639718053157134,3571,0.658509231664884,4030,-0.0187911785077497,-459
"5774","2413322",0.576494880648945,6360,0.602134747024061,6926,-0.0256398663751154,-566
"5775","3413322",0.533380671835442,8546,0.573340913824281,8582,-0.0399602419888394,-36
"5776","4413322",0.491906341134902,10649,0.530930538702471,10945,-0.0390241975675691,-296
"5777","1123322",0.692612528145482,1887,0.720924270254587,1782,-0.0283117421091047,105
"5778","2123322",0.629389355637294,3941,0.664549785613764,3776,-0.0351604299764703,165
"5779","3123322",0.58627514682379,5868,0.635755952413984,5134,-0.0494808055901943,734
"5780","4123322",0.54480081612325,7970,0.593345577292174,7441,-0.0485447611689238,529
"5781","1223322",0.638654750552486,3613,0.665619991308881,3715,-0.0269652407563945,-102
"5782","2223322",0.575431578044298,6404,0.609245506668058,6538,-0.0338139286237601,-134
"5783","3223322",0.532317369230794,8604,0.580451673468278,8161,-0.0481343042374841,443
"5784","4223322",0.490843038530254,10694,0.538041298346468,10574,-0.0471982598162138,120
"5785","1323322",0.61067528027571,4762,0.638569423975583,5013,-0.0278941436998728,-251
"5786","2323322",0.547452107767521,7815,0.58219493933476,8072,-0.0347428315672383,-257
"5787","3323322",0.504337898954018,10040,0.55340110613498,9724,-0.0490632071809624,316
"5788","4323322",0.462863568253478,12004,0.51099073101317,11985,-0.0481271627596921,19
"5789","1423322",0.571738782290714,6595,0.597939920007477,7186,-0.0262011377167629,-591
"5790","2423322",0.508515609782525,9822,0.541565435366654,10387,-0.0330498255841286,-565
"5791","3423322",0.465401400969022,11879,0.512771602166875,11889,-0.0473702011978526,-10
"5792","4423322",0.423927070268482,13548,0.470361227045064,13752,-0.0464341567765824,-204
"5793","1133322",0.649280005980383,3221,0.682459177806558,3024,-0.0331791718261754,197
"5794","2133322",0.586056833472194,5885,0.626084693165735,5612,-0.0400278596935409,273
"5795","3133322",0.542942624658691,8070,0.597290859965956,7219,-0.054348235307265,851
"5796","4133322",0.50146829395815,10199,0.554880484844145,9631,-0.0534121908859947,568
"5797","1233322",0.595322228387387,5462,0.627154898860852,5553,-0.0318326704734654,-91
"5798","2233322",0.532099055879198,8619,0.570780414220029,8739,-0.038681358340831,-120
"5799","3233322",0.488984847065694,10799,0.541986581020249,10356,-0.053001733954555,443
"5800","4233322",0.447510516365154,12654,0.499576205898439,12518,-0.0520656895332846,136
"5801","1333322",0.56734275811061,6826,0.600104331527554,7053,-0.0327615734169436,-227
"5802","2333322",0.504119585602422,10054,0.543729846886731,10252,-0.0396102612843092,-198
"5803","3333322",0.461005376788918,12095,0.514936013686951,11781,-0.0539306368980332,314
"5804","4333322",0.419531046088378,13711,0.472525638565141,13667,-0.0529945924767628,44
"5805","1433322",0.528406260125615,8817,0.559474827559448,9362,-0.0310685674338338,-545
"5806","2433322",0.465183087617426,11897,0.503100342918625,12343,-0.0379172553011995,-446
"5807","3433322",0.422068878803922,13608,0.474306509718846,13584,-0.0522376309149236,24
"5808","4433322",0.380594548103382,14821,0.431896134597035,14932,-0.0513015864936531,-111
"5809","1143322",0.600246441525553,5217,0.642060683679474,4812,-0.0418142421539209,405
"5810","2143322",0.537023269017364,8368,0.585686199038651,7852,-0.0486629300212865,516
"5811","3143322",0.493909060203861,10548,0.556892365838871,9517,-0.0629833056350105,1031
"5812","4143322",0.452434729503321,12441,0.514481990717061,11809,-0.0620472612137401,632
"5813","1243322",0.546288663932557,7885,0.586756404733768,7794,-0.0404677408012107,91
"5814","2243322",0.483065491424368,11092,0.530381920092945,10982,-0.0473164286685763,110
"5815","3243322",0.439951282610865,12945,0.501588086893165,12419,-0.0616368042823004,526
"5816","4243322",0.398476951910325,14334,0.459177711771355,14116,-0.0607007598610302,218
"5817","1343322",0.518309193655781,9324,0.55970583740047,9356,-0.041396643744689,-32
"5818","2343322",0.455086021147592,12334,0.503331352759647,12331,-0.0482453316120546,3
"5819","3343322",0.411971812334089,13938,0.474537519559867,13575,-0.0625657072257786,363
"5820","4343322",0.370497481633549,15038,0.432127144438057,14928,-0.0616296628045084,110
"5821","1443322",0.479372695670785,11248,0.519076333432364,11552,-0.0397036377615791,-304
"5822","2443322",0.416149523162596,13809,0.462701848791541,13989,-0.0465523256289449,-180
"5823","3443322",0.373035314349093,14984,0.433908015591762,14869,-0.060872701242669,115
"5824","4443322",0.331560983648553,15708,0.391497640469951,15711,-0.0599366568213986,-3
"5825","1114322",0.708384727041333,1511,0.736842968538338,1378,-0.0284582414970055,133
"5826","2114322",0.645161554533144,3362,0.680468483897515,3115,-0.0353069293643711,247
"5827","3114322",0.60204734571964,5131,0.651674650697735,4330,-0.0496273049780951,801
"5828","4114322",0.5605730150191,7145,0.609264275575925,6533,-0.0486912605568246,612
"5829","1214322",0.654426949448337,3013,0.681538689592632,3073,-0.0271117401442953,-60
"5830","2214322",0.591203776940148,5623,0.625164204951809,5659,-0.0339604280116609,-36
"5831","3214322",0.548089568126644,7786,0.596370371752029,7272,-0.0482808036253849,514
"5832","4214322",0.506615237426104,9920,0.553959996630219,9685,-0.0473447592041146,235
"5833","1314322",0.62644747917156,4059,0.654488122259334,4216,-0.0280406430877735,-157
"5834","2314322",0.563224306663372,7005,0.598113637618511,7174,-0.0348893309551391,-169
"5835","3314322",0.520110097849868,9231,0.569319804418731,8812,-0.0492097065688631,419
"5836","4314322",0.478635767149328,11290,0.526909429296921,11148,-0.0482736621475929,142
"5837","1414322",0.587510981186564,5802,0.613858618291228,6279,-0.0263476371046637,-477
"5838","2414322",0.524287808678376,9034,0.557484133650405,9478,-0.0331963249720294,-444
"5839","3414322",0.481173599864872,11174,0.528690300450625,11068,-0.0475167005857534,106
"5840","4414322",0.439699269164332,12957,0.486279925328815,13082,-0.0465806561644832,-125
"5841","1124322",0.640405456174913,3549,0.676273656880931,3281,-0.0358682007060187,268
"5842","2124322",0.577182283666724,6330,0.619899172240108,5942,-0.0427168885733843,388
"5843","3124322",0.53406807485322,8508,0.591105339040329,7545,-0.0570372641871083,963
"5844","4124322",0.49259374415268,10612,0.548694963918518,9966,-0.0561012197658378,646
"5845","1224322",0.586447678581917,5855,0.620969377935225,5890,-0.0345216993533085,-35
"5846","2224322",0.523224506073728,9076,0.564594893294402,9068,-0.0413703872206741,8
"5847","3224322",0.480110297260224,11215,0.535801060094622,10697,-0.0556907628343981,518
"5848","4224322",0.438635966559684,12987,0.493390684972812,12785,-0.0547547184131279,202
"5849","1324322",0.55846820830514,7252,0.593918810601927,7410,-0.0354506022967868,-158
"5850","2324322",0.495245035796952,10482,0.537544325961104,10609,-0.0422992901641523,-127
"5851","3324322",0.452130826983448,12457,0.508750492761324,12077,-0.0566196657778764,380
"5852","4324322",0.410656496282908,13976,0.466340117639514,13874,-0.0556836213566061,102
"5853","1424322",0.519531710320144,9250,0.553289306633821,9730,-0.0337575963136769,-480
"5854","2424322",0.456308537811956,12288,0.496914821992998,12623,-0.0406062841810426,-335
"5855","3424322",0.413194328998452,13894,0.468120988793219,13820,-0.0549266597947667,74
"5856","4424322",0.371719998297912,15012,0.425710613671408,15066,-0.0539906153734964,-54
"5857","1134322",0.597072934009813,5369,0.637808564432902,5049,-0.0407356304230894,320
"5858","2134322",0.533849761501624,8517,0.581434079792079,8109,-0.047584318290455,408
"5859","3134322",0.490735552688121,10697,0.5526402465923,9765,-0.061904693904179,932
"5860","4134322",0.449261221987581,12583,0.510229871470489,12020,-0.0609686494829088,563
"5861","1234322",0.543115156416817,8067,0.582504285487196,8052,-0.0393891290703794,15
"5862","2234322",0.479891983908628,11223,0.526129800846373,11194,-0.046237816937745,29
"5863","3234322",0.436777775095124,13069,0.497335967646593,12608,-0.060558192551469,461
"5864","4234322",0.395303444394585,14436,0.454925592524783,14251,-0.0596221481301986,185
"5865","1334322",0.515135686140041,9512,0.555453718153898,9607,-0.0403180320138576,-95
"5866","2334322",0.451912513631852,12462,0.499079233513075,12546,-0.0471667198812233,-84
"5867","3334322",0.408798304818348,14036,0.470285400313296,13756,-0.0614870954949473,280
"5868","4334322",0.367323974117808,15114,0.427875025191485,15027,-0.0605510510736769,87
"5869","1434322",0.476199188155045,11414,0.514824214185792,11788,-0.0386250260307478,-374
"5870","2434322",0.412976015646856,13907,0.458449729544969,14138,-0.0454737138981136,-231
"5871","3434322",0.369861806833352,15051,0.42965589634519,14988,-0.0597940895118375,63
"5872","4434322",0.328387476132812,15752,0.38724552122338,15764,-0.0588580450905672,-12
"5873","1144322",0.548039369554983,7790,0.597410070305818,7215,-0.0493707007508349,575
"5874","2144322",0.484816197046795,11005,0.541035585664995,10420,-0.0562193886182005,585
"5875","3144322",0.441701988233291,12874,0.512241752465216,11918,-0.0705397642319246,956
"5876","4144322",0.400227657532751,14293,0.469831377343405,13770,-0.0696037198106542,523
"5877","1244322",0.494081591961987,10540,0.542105791360112,10348,-0.0480241993981247,192
"5878","2244322",0.430858419453798,13309,0.485731306719289,13110,-0.0548728872654904,199
"5879","3244322",0.387744210640295,14642,0.456937473519509,14184,-0.0691932628792145,458
"5880","4244322",0.346269879939755,15486,0.414527098397699,15315,-0.0682572184579441,171
"5881","1344322",0.466102121685211,11858,0.515055224026814,11774,-0.048953102341603,84
"5882","2344322",0.402878949177022,14216,0.458680739385991,14131,-0.0558017902089686,85
"5883","3344322",0.359764740363519,15264,0.429886906186212,14982,-0.0701221658226927,282
"5884","4344322",0.318290409662979,15859,0.387476531064401,15762,-0.0691861214014224,97
"5885","1444322",0.427165623700215,13430,0.474425720058708,13579,-0.0472600963584932,-149
"5886","2444322",0.363942451192026,15185,0.418051235417885,15235,-0.054108784225859,-50
"5887","3444322",0.320828242378523,15837,0.389257402218106,15742,-0.068429159839583,95
"5888","4444322",0.279353911677983,16169,0.346847027096295,16152,-0.0674931154183127,17
"5889","1111422",0.80276786933393,294,0.81118401399277,329,-0.00841614465884022,-35
"5890","2111422",0.739544696825741,931,0.754809529351946,1013,-0.0152648325262058,-82
"5891","3111422",0.696430488012237,1787,0.726015696152167,1640,-0.0295852081399298,147
"5892","4111422",0.654956157311697,2988,0.683605321030357,2982,-0.0286491637186596,6
"5893","1211422",0.748810091740933,800,0.755879735047064,997,-0.00706964330613025,-197
"5894","2211422",0.685586919232744,2066,0.69950525040624,2425,-0.0139183311734958,-359
"5895","3211422",0.642472710419241,3464,0.670711417206461,3481,-0.0282387067872198,-17
"5896","4211422",0.600998379718701,5186,0.62830104208465,5486,-0.0273026623659494,-300
"5897","1311422",0.720830621464157,1257,0.728829167713766,1568,-0.0079985462496085,-311
"5898","2311422",0.657607448955968,2898,0.672454683072942,3424,-0.0148472341169741,-526
"5899","3311422",0.614493240142465,4584,0.643660849873163,4724,-0.0291676097306981,-140
"5900","4311422",0.573018909441925,6533,0.601250474751353,6984,-0.0282315653094276,-451
"5901","1411422",0.681894123479161,2169,0.68819966374566,2806,-0.00630554026649865,-637
"5902","2411422",0.618670950970972,4392,0.631825179104837,5327,-0.0131542281338644,-935
"5903","3411422",0.575556742157469,6398,0.603031345905057,6879,-0.0274746037475884,-481
"5904","4411422",0.534082411456929,8507,0.560620970783247,9290,-0.0265385593263179,-783
"5905","1121422",0.73478859846751,1013,0.750614702335363,1091,-0.0158261038678534,-78
"5906","2121422",0.671565425959321,2456,0.69424021769454,2602,-0.022674791735219,-146
"5907","3121422",0.628451217145817,3985,0.66544638449476,3723,-0.036995167348943,262
"5908","4121422",0.586976886445277,5829,0.62303600937295,5782,-0.0360591229276728,47
"5909","1221422",0.680830820874513,2203,0.695310423389657,2569,-0.0144796025151435,-366
"5910","2221422",0.617607648366324,4437,0.638935938748833,4991,-0.0213282903825091,-554
"5911","3221422",0.574493439552821,6459,0.610142105549054,6474,-0.0356486659962331,-15
"5912","4221422",0.533019108852281,8576,0.567731730427244,8900,-0.0347126215749626,-324
"5913","1321422",0.652851350597737,3083,0.668259856056359,3610,-0.0154085054586217,-527
"5914","2321422",0.589628178089548,5701,0.611885371415536,6403,-0.0222571933259873,-702
"5915","3321422",0.546513969276045,7871,0.583091538215756,8011,-0.0365775689397113,-140
"5916","4321422",0.505039638575505,10005,0.540681163093946,10441,-0.0356415245184408,-436
"5917","1421422",0.613914852612741,4618,0.627630352088253,5532,-0.0137154994755119,-914
"5918","2421422",0.550691680104552,7666,0.57125586744743,8710,-0.0205641873428776,-1044
"5919","3421422",0.507577471291049,9874,0.54246203424765,10321,-0.0348845629566016,-447
"5920","4421422",0.466103140590509,11857,0.50005165912584,12498,-0.0339485185353311,-641
"5921","1131422",0.69145607630241,1925,0.712149609887334,2004,-0.0206935335849243,-79
"5922","2131422",0.628232903794221,3991,0.655775125246511,4157,-0.0275422214522899,-166
"5923","3131422",0.585118694980717,5946,0.626981292046731,5563,-0.0418625970660139,383
"5924","4131422",0.543644364280178,8030,0.584570916924921,7914,-0.0409265526447434,116
"5925","1231422",0.637498298709414,3658,0.656845330941628,4110,-0.0193470322322141,-452
"5926","2231422",0.574275126201225,6466,0.600470846300805,7034,-0.0261957200995797,-568
"5927","3231422",0.531160917387721,8674,0.571677013101025,8678,-0.0405160957133037,-4
"5928","4231422",0.489686586687181,10760,0.529266637979215,11040,-0.0395800512920335,-280
"5929","1331422",0.609518828432638,4823,0.62979476360833,5420,-0.0202759351756924,-597
"5930","2331422",0.546295655924449,7884,0.573420278967507,8579,-0.027124623043058,-695
"5931","3331422",0.503181447110945,10110,0.544626445767727,10199,-0.041444998656782,-89
"5932","4331422",0.461707116410405,12058,0.502216070645917,12383,-0.0405089542355117,-325
"5933","1431422",0.570582330447642,6656,0.589165259640224,7650,-0.0185829291925825,-994
"5934","2431422",0.507359157939453,9883,0.532790774999401,10861,-0.0254316170599482,-978
"5935","3431422",0.464244949125949,11943,0.503996941799622,12301,-0.0397519926736722,-358
"5936","4431422",0.422770618425409,13588,0.461586566677811,14029,-0.0388159482524019,-441
"5937","1141422",0.64242251184758,3467,0.67175111576025,3447,-0.0293286039126697,20
"5938","2141422",0.579199339339391,6247,0.615376631119427,6194,-0.0361772917800353,53
"5939","3141422",0.536085130525888,8420,0.586582797919647,7803,-0.0504976673937593,617
"5940","4141422",0.494610799825348,10515,0.544172422797837,10228,-0.049561622972489,287
"5941","1241422",0.588464734254584,5761,0.616446836814544,6146,-0.0279821025599597,-385
"5942","2241422",0.525241561746395,8990,0.560072352173721,9327,-0.0348307904273253,-337
"5943","3241422",0.482127352932892,11135,0.531278518973941,10926,-0.0491511660410493,209
"5944","4241422",0.440653022232352,12920,0.488868143852131,12985,-0.0482151216197789,-65
"5945","1341422",0.560485263977808,7151,0.589396269481246,7640,-0.028911005503438,-489
"5946","2341422",0.497262091469619,10400,0.533021784840423,10848,-0.0357596933708035,-448
"5947","3341422",0.454147882656116,12385,0.504227951640643,12287,-0.0500800689845275,98
"5948","4341422",0.412673551955576,13916,0.461817576518833,14021,-0.0491440245632571,-105
"5949","1441422",0.521548765992812,9169,0.54876676551314,9961,-0.0272179995203281,-792
"5950","2441422",0.458325593484623,12218,0.492392280872317,12832,-0.0340666873876938,-614
"5951","3441422",0.41521138467112,13841,0.463598447672537,13959,-0.0483870630014178,-118
"5952","4441422",0.37373705397058,14971,0.421188072550727,15166,-0.0474510185801473,-195
"5953","1112422",0.769682957572241,558,0.772865032464118,727,-0.00318207489187705,-169
"5954","2112422",0.706459785064052,1561,0.716490547823294,1898,-0.0100307627592426,-337
"5955","3112422",0.663345576250548,2723,0.687696714623515,2821,-0.0243511383729667,-98
"5956","4112422",0.621871245550008,4262,0.645286339501705,4638,-0.0234150939516964,-376
"5957","1212422",0.715725179979244,1352,0.717560753518411,1872,-0.00183557353916708,-520
"5958","2212422",0.652502007471055,3100,0.661186268877588,3925,-0.00868426140653267,-825
"5959","3212422",0.609387798657552,4830,0.632392435677809,5293,-0.0230046370202567,-463
"5960","4212422",0.567913467957012,6803,0.589982060555998,7603,-0.0220685925989862,-800
"5961","1312422",0.687745709702468,1999,0.690510186185114,2730,-0.00276447648264533,-731
"5962","2312422",0.624522537194279,4154,0.63413570154429,5227,-0.00961316435001092,-1073
"5963","3312422",0.581408328380776,6126,0.605341868344511,6752,-0.0239335399637349,-626
"5964","4312422",0.539933997680236,8233,0.5629314932227,9168,-0.0229974955424644,-935
"5965","1412422",0.648809211717472,3230,0.649880682217008,4424,-0.00107147049953549,-1194
"5966","2412422",0.585586039209283,5911,0.593506197576185,7434,-0.00792015836690119,-1523
"5967","3412422",0.54247183039578,8094,0.564712364376405,9056,-0.0222405339806252,-962
"5968","4412422",0.50099749969524,10215,0.522301989254595,11384,-0.0213044895593547,-1169
"5969","1122422",0.701703686705821,1661,0.712295720806711,1996,-0.0105920341008903,-335
"5970","2122422",0.638480514197632,3620,0.655921236165888,4148,-0.0174407219682559,-528
"5971","3122422",0.595366305384128,5457,0.627127402966108,5554,-0.0317610975819799,-97
"5972","4122422",0.553891974683588,7505,0.584717027844298,7906,-0.0308250531607096,-401
"5973","1222422",0.647745909112824,3273,0.656991441861005,4102,-0.0092455327481803,-829
"5974","2222422",0.584522736604635,5975,0.600616957220181,7027,-0.0160942206155459,-1052
"5975","3222422",0.541408527791132,8153,0.571823124020402,8668,-0.0304145962292699,-515
"5976","4222422",0.499934197090592,10271,0.529412748898592,11032,-0.0294785518079994,-761
"5977","1322422",0.619766438836048,4344,0.629940874527707,5412,-0.0101744356916585,-1068
"5978","2322422",0.556543266327859,7365,0.573566389886883,8569,-0.0170231235590241,-1204
"5979","3322422",0.513429057514356,9599,0.544772556687104,10189,-0.0313434991727481,-590
"5980","4322422",0.471954726813816,11620,0.502362181565294,12375,-0.0304074547514777,-755
"5981","1422422",0.580829940851052,6160,0.589311370559601,7643,-0.0084814297085487,-1483
"5982","2422422",0.517606768342863,9371,0.532936885918778,10852,-0.0153301175759144,-1481
"5983","3422422",0.47449255952936,11500,0.504143052718998,12291,-0.0296504931896384,-791
"5984","4422422",0.43301822882882,13234,0.461732677597188,14024,-0.028714448768368,-790
"5985","1132422",0.658371164540721,2879,0.673830628358682,3354,-0.0154594638179611,-475
"5986","2132422",0.595147992032532,5466,0.617456143717859,6076,-0.0223081516853267,-610
"5987","3132422",0.552033783219029,7596,0.588662310518079,7673,-0.0366285272990508,-77
"5988","4132422",0.510559452518489,9739,0.546251935396269,10096,-0.0356924828777803,-357
"5989","1232422",0.604413386947725,5036,0.618526349412976,6017,-0.014112962465251,-981
"5990","2232422",0.541190214439536,8166,0.562151864772153,9209,-0.0209616503326165,-1043
"5991","3232422",0.498076005626032,10363,0.533358031572373,10826,-0.0352820259463406,-463
"5992","4232422",0.456601674925492,12275,0.490947656450563,12891,-0.0343459815250703,-616
"5993","1332422",0.576433916670949,6363,0.591475782079678,7529,-0.0150418654087292,-1166
"5994","2332422",0.51321074416276,9611,0.535101297438855,10732,-0.0218905532760948,-1121
"5995","3332422",0.470096535349256,11687,0.506307464239075,12193,-0.0362109288898188,-506
"5996","4332422",0.428622204648716,13386,0.463897089117265,13949,-0.0352748844685485,-563
"5997","1432422",0.537497418685953,8350,0.550846278111572,9854,-0.0133488594256194,-1504
"5998","2432422",0.474274246177764,11509,0.494471793470749,12737,-0.0201975472929851,-1228
"5999","3432422",0.43116003736426,13300,0.465677960270969,13903,-0.0345179229067091,-603
"6000","4432422",0.38968570666372,14598,0.423267585149159,15121,-0.0335818784854387,-523
"6001","1142422",0.609337600085891,4835,0.633432134231598,5248,-0.0240945341457065,-413
"6002","2142422",0.546114427577703,7898,0.577057649590775,8368,-0.0309432220130721,-470
"6003","3142422",0.503000218764199,10118,0.548263816390995,9994,-0.0452635976267961,124
"6004","4142422",0.461525888063659,12067,0.505853441269185,12209,-0.0443275532055258,-142
"6005","1242422",0.555379822492895,7438,0.578127855285892,8313,-0.0227480327929965,-875
"6006","2242422",0.492156649984706,10636,0.521753370645068,11410,-0.0295967206603621,-774
"6007","3242422",0.449042441171203,12596,0.492959537445289,12804,-0.0439170962740861,-208
"6008","4242422",0.407568110470663,14083,0.450549162323479,14398,-0.0429810518528157,-315
"6009","1342422",0.527400352216119,8878,0.551077287952594,9844,-0.0236769357364748,-966
"6010","2342422",0.46417717970793,11947,0.49470280331177,12729,-0.0305256236038404,-782
"6011","3342422",0.421062970894427,13648,0.465908970111991,13893,-0.0448459992175643,-245
"6012","4342422",0.379588640193887,14850,0.423498594990181,15115,-0.0439099547962939,-265
"6013","1442422",0.488463854231123,10833,0.510447783984488,12012,-0.0219839297533649,-1179
"6014","2442422",0.425240681722934,13499,0.454073299343665,14281,-0.0288326176207306,-782
"6015","3442422",0.382126472909431,14779,0.425279466143885,15080,-0.0431529932344545,-301
"6016","4442422",0.340652142208891,15586,0.382869091022075,15820,-0.0422169488131841,-234
"6017","1113422",0.730799781999755,1079,0.747368442074879,1161,-0.0165686600751237,-82
"6018","2113422",0.667576609491566,2585,0.690993957434055,2709,-0.0234173479424893,-124
"6019","3113422",0.624462400678063,4158,0.662200124234276,3872,-0.0377377235562133,286
"6020","4113422",0.582988069977523,6047,0.619789749112466,5953,-0.0368016791349428,94
"6021","1213422",0.676842004406759,2318,0.692064163129172,2668,-0.0152221587224135,-350
"6022","2213422",0.61361883189857,4632,0.635689678488349,5136,-0.0220708465897791,-504
"6023","3213422",0.570504623085067,6662,0.60689584528857,6655,-0.0363912222035031,7
"6024","4213422",0.529030292384526,8790,0.564485470166759,9075,-0.0354551777822328,-285
"6025","1313422",0.648862534129983,3229,0.665013595795874,3751,-0.0161510616658918,-522
"6026","2313422",0.585639361621794,5908,0.608639111155051,6578,-0.0229997495332573,-670
"6027","3313422",0.54252515280829,8092,0.579845277955272,8209,-0.0373201251469814,-117
"6028","4313422",0.50105082210775,10214,0.537434902833461,10616,-0.0363840807257111,-402
"6029","1413422",0.609926036144987,4802,0.624384091827769,5699,-0.0144580556827819,-897
"6030","2413422",0.546702863636798,7862,0.568009607186945,8886,-0.0213067435501476,-1024
"6031","3413422",0.503588654823294,10087,0.539215773987166,10512,-0.0356271191638716,-425
"6032","4413422",0.462114324122754,12043,0.496805398865356,12630,-0.0346910747426014,-587
"6033","1123422",0.662820511133335,2733,0.686799130417472,2862,-0.0239786192841369,-129
"6034","2123422",0.599597338625146,5248,0.630424645776649,5387,-0.0308273071515025,-139
"6035","3123422",0.556483129811643,7370,0.601630812576869,6954,-0.0451476827652265,416
"6036","4123422",0.515008799111103,9516,0.559220437455059,9383,-0.044211638343956,133
"6037","1223422",0.608862733540339,4853,0.631494851471766,5338,-0.0226321179314267,-485
"6038","2223422",0.54563956103215,7927,0.575120366830942,8483,-0.0294808057987923,-556
"6039","3223422",0.502525352218647,10136,0.546326533631163,10089,-0.0438011814125163,47
"6040","4223422",0.461051021518107,12094,0.503916158509353,12303,-0.0428651369912461,-209
"6041","1323422",0.580883263263563,6156,0.604444284138468,6809,-0.023561020874905,-653
"6042","2323422",0.517660090755374,9367,0.548069799497644,10004,-0.0304097087422706,-637
"6043","3323422",0.47454588194187,11495,0.519275966297865,11543,-0.0447300843559946,-48
"6044","4323422",0.43307155124133,13231,0.476865591176055,13475,-0.0437940399347244,-244
"6045","1423422",0.541946765278567,8126,0.563814780170362,9117,-0.0218680148917951,-991
"6046","2423422",0.478723592770378,11288,0.507440295529539,12140,-0.0287167027591608,-852
"6047","3423422",0.435609383956874,13120,0.478646462329759,13385,-0.0430370783728849,-265
"6048","4423422",0.394135053256334,14474,0.436236087207949,14813,-0.0421010339516146,-339
"6049","1133422",0.619487988968235,4361,0.648334037969443,4482,-0.0288460490012076,-121
"6050","2133422",0.556264816460047,7385,0.59195955332862,7504,-0.0356947368685732,-119
"6051","3133422",0.513150607646543,9613,0.56316572012884,9153,-0.0500151124822972,460
"6052","4133422",0.471676276946003,11629,0.52075534500703,11457,-0.0490790680610269,172
"6053","1233422",0.565530211375239,6913,0.593029759023737,7451,-0.0274995476484976,-538
"6054","2233422",0.50230703886705,10150,0.536655274382913,10654,-0.0343482355158632,-504
"6055","3233422",0.459192830053547,12179,0.507861441183134,12124,-0.0486686111295872,55
"6056","4233422",0.417718499353007,13759,0.465451066061324,13910,-0.0477325667083168,-151
"6057","1333422",0.537550741098463,8347,0.565979191690439,8990,-0.0284284505919759,-643
"6058","2333422",0.474327568590274,11505,0.509604707049616,12044,-0.0352771384593414,-539
"6059","3333422",0.431213359776771,13293,0.480810873849836,13308,-0.0495975140730655,-15
"6060","4333422",0.389739029076231,14596,0.438400498728026,14751,-0.048661469651795,-155
"6061","1433422",0.498614243113467,10330,0.525349687722333,11228,-0.026735444608866,-898
"6062","2433422",0.435391070605278,13129,0.46897520308151,13795,-0.0335841324762318,-666
"6063","3433422",0.392276861791775,14525,0.44018136988173,14709,-0.0479045080899557,-184
"6064","4433422",0.350802531091235,15422,0.39777099475992,15620,-0.0469684636686852,-198
"6065","1143422",0.570454424513406,6667,0.607935543842359,6612,-0.0374811193289531,55
"6066","2143422",0.507231252005217,9889,0.551561059201536,9815,-0.0443298071963187,74
"6067","3143422",0.464117043191713,11950,0.522767226001756,11358,-0.0586501828100428,592
"6068","4143422",0.422642712491174,13591,0.480356850879946,13323,-0.0577141383887723,268
"6069","1243422",0.51649664692041,9438,0.552631264896653,9768,-0.036134617976243,-330
"6070","2243422",0.453273474412221,12417,0.496256780255829,12658,-0.0429833058436086,-241
"6071","3243422",0.410159265598717,13992,0.46746294705605,13837,-0.0573036814573326,155
"6072","4243422",0.368684934898177,15082,0.42505257193424,15085,-0.0563676370360623,-3
"6073","1343422",0.488517176643634,10827,0.525580697563355,11222,-0.0370635209197212,-395
"6074","2343422",0.425294004135445,13496,0.469206212922532,13790,-0.0439122087870868,-294
"6075","3343422",0.382179795321941,14778,0.440412379722752,14703,-0.0582325844008108,75
"6076","4343422",0.340705464621401,15585,0.398002004600942,15618,-0.0572965399795405,-33
"6077","1443422",0.449580678658638,12568,0.484951193595249,13141,-0.0353705149366114,-573
"6078","2443422",0.386357506150449,14669,0.428576708954426,15012,-0.0422192028039771,-343
"6079","3443422",0.343243297336945,15539,0.399782875754646,15590,-0.056539578417701,-51
"6080","4443422",0.301768966636405,16019,0.357372500632836,16078,-0.0556035339964307,-59
"6081","1114422",0.678592710029185,2268,0.702717828701223,2329,-0.0241251186720377,-61
"6082","2114422",0.615369537520996,4535,0.6463433440604,4591,-0.0309738065394033,-56
"6083","3114422",0.572255328707493,6575,0.61754951086062,6071,-0.0452941821531273,504
"6084","4114422",0.530780998006953,8693,0.57513913573881,8481,-0.0443581377318568,212
"6085","1214422",0.624634932436189,4145,0.647413549755517,4537,-0.0227786173193275,-392
"6086","2214422",0.561411759928,7091,0.591039065114693,7547,-0.0296273051866931,-456
"6087","3214422",0.518297551114497,9326,0.562245231914914,9207,-0.0439476808004171,119
"6088","4214422",0.476823220413957,11380,0.519834856793103,11508,-0.0430116363791468,-128
"6089","1314422",0.596655462159413,5382,0.620362982422219,5925,-0.0237075202628058,-543
"6090","2314422",0.533432289651224,8543,0.563988497781395,9109,-0.0305562081301713,-566
"6091","3314422",0.490318080837721,10726,0.535194664581616,10729,-0.0448765837438954,-3
"6092","4314422",0.44884375013718,12600,0.492784289459806,12812,-0.043940539322625,-212
"6093","1414422",0.557718964174417,7287,0.579733478454113,8213,-0.0220145142796959,-926
"6094","2414422",0.494495791666228,10518,0.52335899381329,11328,-0.0288632021470616,-810
"6095","3414422",0.451381582852725,12483,0.49456516061351,12734,-0.0431835777607857,-251
"6096","4414422",0.409907252152185,14000,0.4521547854917,14340,-0.0422475333395153,-340
"6097","1124422",0.610613439162765,4767,0.642148517043816,4806,-0.0315350778810509,-39
"6098","2124422",0.547390266654576,7819,0.585774032402993,7846,-0.0383837657484165,-27
"6099","3124422",0.504276057841073,10045,0.556980199203213,9510,-0.0527041413621405,535
"6100","4124422",0.462801727140533,12007,0.514569824081403,11801,-0.05176809694087,206
"6101","1224422",0.556655661569769,7360,0.58684423809811,7790,-0.0301885765283407,-430
"6102","2224422",0.49343248906158,10569,0.530469753457287,10978,-0.0370372643957063,-409
"6103","3224422",0.450318280248077,12532,0.501675920257507,12416,-0.0513576400094304,116
"6104","4224422",0.408843949547537,14035,0.459265545135697,14114,-0.05042159558816,-79
"6105","1324422",0.528676191292993,8802,0.559793670764812,9353,-0.031117479471819,-551
"6106","2324422",0.465453018784804,11877,0.503419186123989,12326,-0.0379661673391846,-449
"6107","3324422",0.4223388099713,13600,0.474625352924209,13570,-0.0522865429529086,30
"6108","4324422",0.380864479270761,14814,0.432214977802399,14925,-0.0513504985316382,-111
"6109","1424422",0.489739693307997,10759,0.519164166796706,11550,-0.0294244734887091,-791
"6110","2424422",0.426516520799808,13452,0.462789682155883,13985,-0.0362731613560749,-533
"6111","3424422",0.383402311986305,14749,0.433995848956103,14867,-0.0505935369697988,-118
"6112","4424422",0.341927981285765,15562,0.391585473834293,15709,-0.0496574925485284,-147
"6113","1134422",0.567280916997666,6833,0.603683424595787,6842,-0.0364025075981216,-9
"6114","2134422",0.504057744489477,10060,0.547308939954964,10041,-0.0432511954654872,19
"6115","3134422",0.460943535675973,12099,0.518515106755184,11585,-0.0575715710792112,514
"6116","4134422",0.419469204975433,13715,0.476104731633374,13507,-0.0566355266579409,208
"6117","1234422",0.513323139404669,9607,0.548379145650081,9987,-0.0350560062454116,-380
"6118","2234422",0.45009996689648,12539,0.492004661009258,12850,-0.0419046941127771,-311
"6119","3234422",0.406985758082977,14101,0.463210827809478,13971,-0.0562250697265012,130
"6120","4234422",0.365511427382437,15156,0.420800452687668,15181,-0.0552890253052307,-25
"6121","1334422",0.485343669127893,10982,0.521328578316783,11432,-0.0359849091888899,-450
"6122","2334422",0.422120496619704,13606,0.46495409367596,13925,-0.0428335970562554,-319
"6123","3334422",0.379006287806201,14856,0.43616026047618,14816,-0.0571539726699793,40
"6124","4334422",0.337531957105661,15636,0.39374988535437,15675,-0.0562179282487089,-39
"6125","1434422",0.446407171142897,12699,0.480699074348677,13313,-0.03429190320578,-614
"6126","2434422",0.383183998634708,14753,0.424324589707854,15102,-0.0411405910731456,-349
"6127","3434422",0.340069789821205,15592,0.395530756508075,15652,-0.0554609666868696,-60
"6128","4434422",0.298595459120665,16050,0.353120381386264,16109,-0.0545249222655992,-59
"6129","1144422",0.518247352542836,9334,0.563284930468703,9146,-0.0450375779258672,188
"6130","2144422",0.455024180034647,12339,0.50691044582788,12169,-0.0518862657932327,170
"6131","3144422",0.411909971221144,13942,0.4781166126281,13415,-0.0662066414069567,527
"6132","4144422",0.370435640520604,15041,0.43570623750629,14827,-0.0652705969856863,214
"6133","1244422",0.46428957494984,11942,0.507980651522997,12118,-0.043691076573157,-176
"6134","2244422",0.401066402441651,14276,0.451606166882174,14360,-0.0505397644405226,-84
"6135","3244422",0.357952193628148,15294,0.422812333682394,15132,-0.0648601400542466,162
"6136","4244422",0.316477862927608,15884,0.380401958560584,15860,-0.0639240956329761,24
"6137","1344422",0.436310104673064,13086,0.480930084189699,13303,-0.0446199795166353,-217
"6138","2344422",0.373086932164875,14981,0.424555599548876,15097,-0.0514686673840008,-116
"6139","3344422",0.329972723351371,15728,0.395761766349096,15647,-0.0657890429977248,81
"6140","4344422",0.288498392650831,16114,0.353351391227286,16107,-0.0648529985764544,7
"6141","1444422",0.397373606688068,14372,0.440300580221593,14706,-0.0429269735335254,-334
"6142","2444422",0.334150434179879,15676,0.38392609558077,15808,-0.049775661400891,-132
"6143","3444422",0.291036225366375,16094,0.35513226238099,16093,-0.0640960370146151,1
"6144","4444422",0.249561894665835,16287,0.31272188725918,16300,-0.0631599925933447,-13
"6145","1111132",0.871812873701328,57,0.888102540318598,46,-0.0162896666172708,11
"6146","2111132",0.808589701193139,258,0.831728055677775,204,-0.0231383544846364,54
"6147","3111132",0.765475492379635,603,0.802934222477996,400,-0.0374587300983604,203
"6148","4111132",0.724001161679095,1192,0.760523847356185,928,-0.03652268567709,264
"6149","1211132",0.817855096108332,204,0.832798261372892,201,-0.0149431652645607,3
"6150","2211132",0.754631923600143,726,0.776423776732069,678,-0.0217918531319263,48
"6151","3211132",0.711517714786639,1433,0.74762994353229,1155,-0.0361122287456503,278
"6152","4211132",0.670043384086099,2503,0.705219568410479,2244,-0.03517618432438,259
"6153","1311132",0.789875625831555,379,0.805747694039594,373,-0.015872068208039,6
"6154","2311132",0.726652453323366,1149,0.749373209398771,1117,-0.0227207560754046,32
"6155","3311132",0.683538244509863,2119,0.720579376198992,1789,-0.0370411316891286,330
"6156","4311132",0.642063913809323,3482,0.678169001077181,3198,-0.0361050872678582,284
"6157","1411132",0.750939127846559,774,0.765118190071489,855,-0.0141790622249292,-81
"6158","2411132",0.68771595533837,2001,0.708743705430665,2124,-0.0210277500922949,-123
"6159","3411132",0.644601746524867,3378,0.679949872230886,3141,-0.0353481257060189,237
"6160","4411132",0.603127415824327,5086,0.637539497109076,5060,-0.0344120812847485,26
"6161","1121132",0.803833602834908,287,0.827533228661192,230,-0.023699625826284,57
"6162","2121132",0.740610430326719,914,0.771158744020368,752,-0.0305483136936496,162
"6163","3121132",0.697496221513215,1759,0.742364910820589,1261,-0.0448686893073736,498
"6164","4121132",0.656021890812675,2949,0.699954535698779,2408,-0.0439326448861033,541
"6165","1221132",0.749875825241912,782,0.772228949715486,736,-0.022353124473574,46
"6166","2221132",0.686652652733723,2033,0.715854465074662,1910,-0.0292018123409395,123
"6167","3221132",0.643538443920219,3411,0.687060631874883,2850,-0.0435221879546636,561
"6168","4221132",0.602064113219679,5129,0.644650256753072,4670,-0.0425861435333932,459
"6169","1321132",0.721896354965135,1233,0.745178382382188,1206,-0.0232820274170522,27
"6170","2321132",0.658673182456947,2862,0.688803897741364,2782,-0.0301307152844178,80
"6171","3321132",0.615558973643443,4521,0.660010064541585,3969,-0.0444510908981418,552
"6172","4321132",0.574084642942903,6474,0.617599689419775,6069,-0.0435150464768714,405
"6173","1421132",0.682959856980139,2136,0.704548878414082,2258,-0.0215890214339424,-122
"6174","2421132",0.61973668447195,4348,0.648174393773259,4493,-0.0284377093013081,-145
"6175","3421132",0.576622475658447,6353,0.619380560573479,5974,-0.0427580849150321,379
"6176","4421132",0.535148144957907,8459,0.576970185451669,8374,-0.0418220404937617,85
"6177","1131132",0.760501080669808,665,0.789068136213163,530,-0.0285670555433548,135
"6178","2131132",0.697277908161619,1767,0.73269365157234,1474,-0.0354157434107204,293
"6179","3131132",0.654163699348116,3027,0.70389981837256,2280,-0.0497361190244444,747
"6180","4131132",0.612689368647576,4675,0.66148944325075,3912,-0.048800074603174,763
"6181","1231132",0.706543303076812,1556,0.733763857267457,1443,-0.0272205541906447,113
"6182","2231132",0.643320130568623,3426,0.677389372626633,3232,-0.0340692420580103,194
"6183","3231132",0.60020592175512,5222,0.648595539426854,4468,-0.0483896176717343,754
"6184","4231132",0.55873159105458,7236,0.606185164305044,6691,-0.047453573250464,545
"6185","1331132",0.678563832800036,2271,0.706713289934159,2195,-0.028149457134123,76
"6186","2331132",0.615340660291847,4537,0.650338805293335,4407,-0.0349981450014886,130
"6187","3331132",0.572226451478343,6578,0.621544972093556,5855,-0.0493185206152126,723
"6188","4331132",0.530752120777803,8697,0.579134596971746,8247,-0.0483824761939422,450
"6189","1431132",0.63962733481504,3573,0.666083785966053,3693,-0.0264564511510131,-120
"6190","2431132",0.576404162306851,6365,0.60970930132523,6511,-0.0333051390183788,-146
"6191","3431132",0.533289953493347,8556,0.58091546812545,8138,-0.0476255146321028,418
"6192","4431132",0.491815622792807,10654,0.53850509300364,10552,-0.0466894702108325,102
"6193","1141132",0.711467516214979,1440,0.748669642086079,1131,-0.0372021258711003,309
"6194","2141132",0.64824434370679,3258,0.692295157445255,2659,-0.0440508137384659,599
"6195","3141132",0.605130134893286,5004,0.663501324245476,3816,-0.0583711893521899,1188
"6196","4141132",0.563655804192746,6976,0.621090949123666,5882,-0.0574351449309195,1094
"6197","1241132",0.657509738621982,2906,0.693365363140373,2630,-0.0358556245183902,276
"6198","2241132",0.594286566113793,5502,0.636990878499549,5075,-0.0427043123857558,427
"6199","3241132",0.55117235730029,7646,0.60819704529977,6599,-0.0570246879994798,1047
"6200","4241132",0.50969802659975,9769,0.56578667017796,9000,-0.0560886435782094,769
"6201","1341132",0.629530268345206,3938,0.666314795807075,3676,-0.0367845274618684,262
"6202","2341132",0.566307095837017,6874,0.609940311166251,6488,-0.043633215329234,386
"6203","3341132",0.523192887023514,9079,0.581146477966472,8124,-0.057953590942958,955
"6204","4341132",0.481718556322974,11148,0.538736102844662,10535,-0.0570175465216877,613
"6205","1441132",0.59059377036021,5661,0.625685291838969,5630,-0.0350915214787586,31
"6206","2441132",0.527370597852021,8884,0.569310807198146,8813,-0.0419402093461243,71
"6207","3441132",0.484256389038518,11033,0.540516973998366,10452,-0.0562605849598483,581
"6208","4441132",0.442782058337978,12842,0.498106598876556,12578,-0.0553245405385779,264
"6209","1112132",0.838727961939639,128,0.849783558789946,127,-0.0110555968503077,1
"6210","2112132",0.77550478943145,497,0.793409074149123,474,-0.0179042847176732,23
"6211","3112132",0.732390580617946,1052,0.764615240949344,860,-0.0322246603313973,192
"6212","4112132",0.690916249917406,1930,0.722204865827533,1746,-0.0312886159101269,184
"6213","1212132",0.784770184346643,406,0.79447927984424,466,-0.00970909549759758,-60
"6214","2212132",0.721547011838454,1244,0.738104795203417,1350,-0.0165577833649632,-106
"6215","3212132",0.67843280302495,2273,0.709310962003637,2106,-0.0308781589786872,167
"6216","4212132",0.63695847232441,3674,0.666900586881827,3654,-0.0299421145574168,20
"6217","1312132",0.756790714069866,698,0.767428712510942,810,-0.0106379984410758,-112
"6218","2312132",0.693567541561678,1858,0.711054227870119,2048,-0.0174866863084414,-190
"6219","3312132",0.650453332748174,3172,0.68226039467034,3035,-0.0318070619221654,137
"6220","4312132",0.608979002047634,4846,0.639850019548529,4925,-0.030871017500895,-79
"6221","1412132",0.71785421608487,1309,0.726799208542836,1620,-0.00894499245796598,-311
"6222","2412132",0.654631043576682,3002,0.670424723902013,3493,-0.0157936803253317,-491
"6223","3412132",0.611516834763178,4726,0.641630890702234,4839,-0.0301140559390557,-113
"6224","4412132",0.570042504062638,6692,0.599220515580423,7103,-0.0291780115177853,-411
"6225","1122132",0.770748691073219,543,0.78921424713254,528,-0.0184655560593209,15
"6226","2122132",0.70752551856503,1534,0.732839762491716,1470,-0.0253142439266865,64
"6227","3122132",0.664411309751526,2680,0.704045929291937,2273,-0.0396346195404105,407
"6228","4122132",0.622936979050986,4220,0.661635554170127,3907,-0.0386985751191401,313
"6229","1222132",0.716790913480223,1323,0.733909968186833,1437,-0.0171190547066108,-114
"6230","2222132",0.653567740972034,3054,0.67753548354601,3225,-0.0239677425739764,-171
"6231","3222132",0.61045353215853,4772,0.648741650346231,4462,-0.0382881181877004,310
"6232","4222132",0.56897920145799,6736,0.60633127522442,6681,-0.03735207376643,55
"6233","1322132",0.688811443203446,1971,0.706859400853535,2188,-0.018047957650089,-217
"6234","2322132",0.625588270695258,4096,0.650484916212712,4397,-0.0248966455174546,-301
"6235","3322132",0.582474061881754,6063,0.621691083012933,5847,-0.0392170211311786,216
"6236","4322132",0.540999731181214,8175,0.579280707891122,8237,-0.0382809767099083,-62
"6237","1422132",0.64987494521845,3194,0.66622989688543,3682,-0.0163549516669792,-488
"6238","2422132",0.586651772710262,5841,0.609855412244606,6494,-0.0232036395343449,-653
"6239","3422132",0.543537563896758,8036,0.581061579044827,8128,-0.0375240151480689,-92
"6240","4422132",0.502063233196218,10164,0.538651203923017,10540,-0.0365879707267985,-376
"6241","1132132",0.727416168908119,1128,0.750749154684511,1088,-0.0233329857763916,40
"6242","2132132",0.66419299639993,2689,0.694374670043687,2596,-0.0301816736437572,93
"6243","3132132",0.621078787586427,4286,0.665580836843908,3717,-0.0445020492574812,569
"6244","4132132",0.579604456885887,6226,0.623170461722098,5773,-0.0435660048362109,453
"6245","1232132",0.673458391315123,2402,0.695444875738805,2561,-0.0219864844236816,-159
"6246","2232132",0.610235218806934,4787,0.639070391097981,4983,-0.0288351722910472,-196
"6247","3232132",0.567121009993431,6837,0.610276557898202,6470,-0.0431555479047712,367
"6248","4232132",0.525646679292891,8969,0.567866182776391,8896,-0.0422195034835008,73
"6249","1332132",0.645478921038347,3349,0.668394308405507,3597,-0.0229153873671598,-248
"6250","2332132",0.582255748530158,6083,0.612019823764683,6392,-0.0297640752345254,-309
"6251","3332132",0.539141539716654,8270,0.583225990564904,8000,-0.0440844508482494,270
"6252","4332132",0.497667209016114,10377,0.540815615443094,10432,-0.043148406426979,-55
"6253","1432132",0.606542423053351,4951,0.627764804437401,5523,-0.02122238138405,-572
"6254","2432132",0.543319250545162,8052,0.571390319796578,8701,-0.0280710692514157,-649
"6255","3432132",0.500205041731658,10256,0.542596486596798,10311,-0.0423914448651397,-55
"6256","4432132",0.458730711031119,12203,0.500186111474988,12487,-0.0414554004438693,-284
"6257","1142132",0.67838260445329,2279,0.710350660557427,2074,-0.0319680561041371,205
"6258","2142132",0.615159431945101,4549,0.653976175916603,4237,-0.0388167439715027,312
"6259","3142132",0.572045223131597,6586,0.625182342716824,5657,-0.0531371195852267,929
"6260","4142132",0.530570892431057,8704,0.582771967595014,8035,-0.0522010751639563,669
"6261","1242132",0.624424826860293,4162,0.65504638161172,4189,-0.030621554751427,-27
"6262","2242132",0.561201654352105,7110,0.598671896970897,7133,-0.0374702426187926,-23
"6263","3242132",0.518087445538601,9344,0.569878063771118,8782,-0.0517906182325166,562
"6264","4242132",0.476613114838061,11395,0.527467688649307,11122,-0.0508545738112463,273
"6265","1342132",0.596445356583517,5397,0.627995814278423,5504,-0.0315504576949053,-107
"6266","2342132",0.533222184075328,8564,0.571621329637599,8683,-0.0383991455622709,-119
"6267","3342132",0.490107975261825,10738,0.54282749643782,10297,-0.0527195211759949,441
"6268","4342132",0.448633644561285,12612,0.500417121316009,12472,-0.0517834767547245,140
"6269","1442132",0.557508858598521,7307,0.587366310310317,7751,-0.0298574517117954,-444
"6270","2442132",0.494285686090332,10532,0.530991825669494,10940,-0.0367061395791611,-408
"6271","3442132",0.451171477276829,12497,0.502197992469714,12384,-0.0510265151928851,113
"6272","4442132",0.409697146576289,14009,0.459787617347904,14088,-0.0500904707716148,-79
"6273","1113132",0.799844786367153,313,0.824286968400707,248,-0.0244421820335543,65
"6274","2113132",0.736621613858964,982,0.767912483759884,798,-0.0312908699009199,184
"6275","3113132",0.693507405045461,1861,0.739118650560105,1332,-0.0456112455146439,529
"6276","4113132",0.652033074344921,3117,0.696708275438294,2516,-0.0446752010933734,601
"6277","1213132",0.745887008774157,841,0.768982689455001,785,-0.0230956806808441,56
"6278","2213132",0.682663836265968,2144,0.712608204814178,1990,-0.0299443685482097,154
"6279","3213132",0.639549627452465,3578,0.683814371614398,2975,-0.0442647441619337,603
"6280","4213132",0.598075296751925,5317,0.641403996492588,4851,-0.0433286997406634,466
"6281","1313132",0.717907538497381,1306,0.741932122121703,1269,-0.0240245836243224,37
"6282","2313132",0.654684365989192,2999,0.68555763748088,2906,-0.030873271491688,93
"6283","3313132",0.611570157175689,4722,0.6567638042811,4112,-0.045193647105412,610
"6284","4313132",0.570095826475148,6686,0.61435342915929,6245,-0.0442576026841417,441
"6285","1413132",0.678971040512385,2256,0.701302618153597,2376,-0.0223315776412125,-120
"6286","2413132",0.615747868004196,4505,0.644928133512774,4656,-0.0291802655085782,-151
"6287","3413132",0.572633659190693,6551,0.616134300312995,6163,-0.0435006411223022,388
"6288","4413132",0.531159328490152,8675,0.573723925191184,8559,-0.042564596701032,116
"6289","1123132",0.731865515500733,1062,0.763717656743301,879,-0.0318521412425675,183
"6290","2123132",0.668642342992544,2551,0.707343172102477,2169,-0.0387008291099331,382
"6291","3123132",0.625528134179041,4101,0.678549338902698,3185,-0.0530212047236571,916
"6292","4123132",0.584053803478501,5999,0.636138963780888,5118,-0.0520851603023866,881
"6293","1223132",0.677907737907737,2289,0.708413377797594,2133,-0.0305056398898573,156
"6294","2223132",0.614684565399548,4565,0.652038893156771,4320,-0.0373543277572229,245
"6295","3223132",0.571570356586045,6602,0.623245059956992,5769,-0.0516747033709469,833
"6296","4223132",0.530096025885505,8728,0.580834684835181,8141,-0.0507386589496767,587
"6297","1323132",0.649928267630961,3193,0.681362810464296,3080,-0.0314345428333356,113
"6298","2323132",0.586705095122772,5839,0.624988325823473,5666,-0.0382832307007012,173
"6299","3323132",0.543590886309269,8033,0.596194492623694,7280,-0.0526036063144252,753
"6300","4323132",0.502116555608728,10160,0.553784117501883,9699,-0.0516675618931549,461
"6301","1423132",0.610991769645965,4755,0.640733306496191,4884,-0.0297415368502257,-129
"6302","2423132",0.547768597137776,7799,0.584358821855367,7925,-0.0365902247175914,-126
"6303","3423132",0.504654388324273,10022,0.555564988655588,9601,-0.0509106003313154,421
"6304","4423132",0.463180057623732,11993,0.513154613533778,11873,-0.0499745559100452,120
"6305","1133132",0.688532993335634,1983,0.725252564295272,1666,-0.0367195709596382,317
"6306","2133132",0.625309820827445,4113,0.668878079654448,3569,-0.0435682588270038,544
"6307","3133132",0.582195612013941,6088,0.640084246454669,4910,-0.0578886344407278,1178
"6308","4133132",0.540721281313401,8196,0.597673871332859,7196,-0.0569525900194575,1000
"6309","1233132",0.634575215742637,3757,0.669948285349566,3512,-0.0353730696069282,245
"6310","2233132",0.571352043234448,6619,0.613573800708742,6293,-0.0422217574742938,326
"6311","3233132",0.528237834420945,8829,0.584779967508963,7902,-0.0565421330880178,927
"6312","4233132",0.486763503720405,10916,0.542369592387152,10327,-0.0556060886667473,589
"6313","1333132",0.606595745465861,4949,0.642897718016268,4765,-0.0363019725504065,184
"6314","2333132",0.543372572957672,8050,0.586523233375444,7806,-0.043150660417772,244
"6315","3333132",0.500258364144169,10253,0.557729400175665,9461,-0.0574710360314961,792
"6316","4333132",0.458784033443629,12201,0.515319025053855,11758,-0.0565349916102256,443
"6317","1433132",0.567659247480865,6814,0.602268214048162,6919,-0.0346089665672966,-105
"6318","2433132",0.504436074972676,10035,0.545893729407339,10120,-0.0414576544346623,-85
"6319","3433132",0.461321866159173,12080,0.517099896207559,11660,-0.0557780300483863,420
"6320","4433132",0.419847535458633,13702,0.474689521085749,13566,-0.0548419856271158,136
"6321","1143132",0.639499428880804,3585,0.684854070168188,2932,-0.0453546412873838,653
"6322","2143132",0.576276256372615,6371,0.628479585527364,5476,-0.0522033291547493,895
"6323","3143132",0.533162047559112,8569,0.599685752327585,7074,-0.0665237047684734,1495
"6324","4143132",0.491687716858572,10658,0.557275377205775,9491,-0.0655876603472029,1167
"6325","1243132",0.585541651287808,5918,0.629549791222481,5432,-0.0440081399346736,486
"6326","2243132",0.522318478779619,9130,0.573175306581658,8587,-0.0508568278020392,543
"6327","3243132",0.479204269966116,11260,0.544381473381879,10217,-0.0651772034157632,1043
"6328","4243132",0.437729939265575,13027,0.501971098260068,12395,-0.0642411589944929,632
"6329","1343132",0.557562181011032,7299,0.602499223889184,6901,-0.0449370428781518,398
"6330","2343132",0.494339008502843,10529,0.54612473924836,10107,-0.0517857307455174,422
"6331","3343132",0.451224799689339,12493,0.517330906048581,11647,-0.0661061063592414,846
"6332","4343132",0.409750468988799,14006,0.47492053092677,13557,-0.0651700619379711,449
"6333","1443132",0.518625683026036,9304,0.561869719921078,9225,-0.043244036895042,79
"6334","2443132",0.455402510517847,12321,0.505495235280255,12226,-0.0500927247624077,95
"6335","3443132",0.412288301704343,13930,0.476701402080475,13485,-0.0644131003761317,445
"6336","4443132",0.370813971003803,15035,0.434291026958665,14861,-0.0634770559548613,174
"6337","1114132",0.747637714396583,819,0.779636355027052,641,-0.0319986406304682,178
"6338","2114132",0.684414541888394,2094,0.723261870386228,1720,-0.0388473284978338,374
"6339","3114132",0.641300333074891,3516,0.694468037186449,2593,-0.0531677041115578,923
"6340","4114132",0.599826002374351,5238,0.652057662064638,4319,-0.0522316596902874,919
"6341","1214132",0.693679936803587,1851,0.724332076081345,1691,-0.0306521392777581,160
"6342","2214132",0.630456764295398,3895,0.667957591440522,3614,-0.0375008271451237,281
"6343","3214132",0.587342555481895,5809,0.639163758240743,4974,-0.0518212027588477,835
"6344","4214132",0.545868224781355,7913,0.596753383118932,7251,-0.0508851583375773,662
"6345","1314132",0.665700466526811,2634,0.697281508748047,2496,-0.0315810422212364,138
"6346","2314132",0.602477294018622,5111,0.640907024107224,4874,-0.038429730088602,237
"6347","3314132",0.559363085205119,7204,0.612113190907445,6382,-0.052750105702326,822
"6348","4314132",0.517888754504579,9356,0.569702815785634,8789,-0.0518140612810556,567
"6349","1414132",0.626763968541815,4044,0.656652004779942,4124,-0.0298880362381265,-80
"6350","2414132",0.563540796033626,6985,0.600277520139118,7044,-0.0367367241054922,-59
"6351","3414132",0.520426587220123,9215,0.571483686939339,8695,-0.0510570997192162,520
"6352","4414132",0.478952256519583,11280,0.529073311817529,11051,-0.0501210552979459,229
"6353","1124132",0.679658443530163,2236,0.719067043369645,1826,-0.0394085998394814,410
"6354","2124132",0.616435271021974,4482,0.662692558728821,3850,-0.046257287706847,632
"6355","3124132",0.573321062208471,6521,0.633898725529042,5230,-0.060577663320571,1291
"6356","4124132",0.531846731507931,8631,0.591488350407232,7528,-0.0596416188993006,1103
"6357","1224132",0.625700665937167,4085,0.663762764423939,3807,-0.0380620984867713,278
"6358","2224132",0.562477493428978,7036,0.607388279783115,6632,-0.0449107863541369,404
"6359","3224132",0.519363284615475,9257,0.578594446583336,8282,-0.0592311619678609,975
"6360","4224132",0.477888953914935,11324,0.536184071461525,10676,-0.0582951175465906,648
"6361","1324132",0.597721195660391,5334,0.636712197090641,5090,-0.0389910014302496,244
"6362","2324132",0.534498023152202,8489,0.580337712449817,8169,-0.0458396892976152,320
"6363","3324132",0.491383814338699,10669,0.551543879250038,9816,-0.0601600649113392,853
"6364","4324132",0.449909483638159,12550,0.509133504128228,12058,-0.0592240204900688,492
"6365","1424132",0.558784697675395,7233,0.596082693122535,7286,-0.0372979954471397,-53
"6366","2424132",0.495561525167206,10465,0.539708208481712,10488,-0.0441466833145054,-23
"6367","3424132",0.452447316353703,12438,0.510914375281932,11990,-0.0584670589282295,448
"6368","4424132",0.410972985653163,13965,0.468504000160122,13810,-0.0575310145069591,155
"6369","1134132",0.636325921365064,3702,0.680601950921616,3108,-0.0442760295565522,594
"6370","2134132",0.573102748856875,6530,0.624227466280793,5710,-0.0511247174239178,820
"6371","3134132",0.529988540043371,8738,0.595433633081013,7321,-0.0654450930376418,1417
"6372","4134132",0.488514209342831,10828,0.553023257959203,9745,-0.0645090486163714,1083
"6373","1234132",0.582368143772068,6072,0.62529767197591,5654,-0.0429295282038421,418
"6374","2234132",0.519144971263879,9276,0.568923187335086,8838,-0.0497782160712077,438
"6375","3234132",0.476030762450375,11421,0.540129354135307,10467,-0.0640985916849317,954
"6376","4234132",0.434556431749835,13163,0.497718979013497,12592,-0.0631625472636613,571
"6377","1334132",0.554388673495291,7481,0.598247104642612,7160,-0.0438584311473204,321
"6378","2334132",0.491165500987103,10683,0.541872620001788,10363,-0.0507071190146859,320
"6379","3334132",0.448051292173599,12637,0.513078786802009,11874,-0.06502749462841,763
"6380","4334132",0.406576961473059,14113,0.470668411680199,13736,-0.0640914502071396,377
"6381","1434132",0.515452175510295,9498,0.557617600674506,9470,-0.0421654251642105,28
"6382","2434132",0.452229003002107,12455,0.501243116033683,12433,-0.0490141130315762,22
"6383","3434132",0.409114794188603,14029,0.472449282833903,13670,-0.0633344886453002,359
"6384","4434132",0.367640463488063,15109,0.430038907712093,14977,-0.0623984442240298,132
"6385","1144132",0.587292356910234,5817,0.640203456794532,4903,-0.0529110998842977,914
"6386","2144132",0.524069184402045,9043,0.583828972153709,7959,-0.0597597877516632,1084
"6387","3144132",0.480954975588542,11187,0.555035138953929,9625,-0.0740801633653873,1562
"6388","4144132",0.439480644888002,12963,0.512624763832119,11896,-0.0731441189441169,1067
"6389","1244132",0.533334579317238,8551,0.584899177848826,7892,-0.0515645985315876,659
"6390","2244132",0.470111406809049,11685,0.528524693208002,11074,-0.0584132863989532,611
"6391","3244132",0.426997197995546,13437,0.499730860008223,12510,-0.0727336620126772,927
"6392","4244132",0.385522867295006,14692,0.457320484886413,14166,-0.0717976175914068,526
"6393","1344132",0.505355109040462,9986,0.557848610515528,9453,-0.0524935014750658,533
"6394","2344132",0.442131936532273,12863,0.501474125874704,12421,-0.0593421893424314,442
"6395","3344132",0.39901772771877,14323,0.472680292674925,13659,-0.0736625649561554,664
"6396","4344132",0.35754339701823,15303,0.430269917553115,14970,-0.072726520534885,333
"6397","1444132",0.466418611055466,11841,0.517219106547422,11654,-0.050800495491956,187
"6398","2444132",0.403195438547277,14210,0.460844621906599,14054,-0.0576491833593217,156
"6399","3444132",0.360081229733774,15257,0.432050788706819,14930,-0.0719695589730457,327
"6400","4444132",0.318606899033234,15857,0.389640413585009,15736,-0.0710335145517753,121
"6401","1111232",0.825964039553117,173,0.842767693663817,154,-0.0168036541106991,19
"6402","2111232",0.762740867044929,629,0.786393209022993,564,-0.0236523419780647,65
"6403","3111232",0.719626658231425,1279,0.757599375823214,969,-0.0379727175917887,310
"6404","4111232",0.678152327530885,2285,0.715189000701403,1929,-0.0370366731705183,356
"6405","1211232",0.772006261960121,526,0.78746341471811,551,-0.015457152757989,-25
"6406","2211232",0.708783089451932,1497,0.731088930077287,1510,-0.0223058406253546,-13
"6407","3211232",0.665668880638429,2637,0.702295096877508,2350,-0.0366262162390786,287
"6408","4211232",0.624194549937889,4172,0.659884721755697,3975,-0.0356901718178082,197
"6409","1311232",0.744026791683345,866,0.760412847384812,930,-0.0163860557014672,-64
"6410","2311232",0.680803619175156,2204,0.704038362743989,2275,-0.0232347435688328,-71
"6411","3311232",0.637689410361653,3649,0.67524452954421,3312,-0.0375551191825568,337
"6412","4311232",0.596215079661113,5413,0.632834154422399,5276,-0.0366190747612865,137
"6413","1411232",0.705090293698349,1589,0.719783343416707,1809,-0.0146930497183574,-220
"6414","2411232",0.64186712119016,3487,0.663408858775883,3821,-0.0215417375857231,-334
"6415","3411232",0.598752912376657,5286,0.634615025576104,5200,-0.0358621131994471,86
"6416","4411232",0.557278581676117,7325,0.592204650454294,7491,-0.0349260687781767,-166
"6417","1121232",0.757984768686698,686,0.78219838200641,608,-0.0242136133197123,78
"6418","2121232",0.694761596178509,1819,0.725823897365587,1645,-0.0310623011870779,174
"6419","3121232",0.651647387365005,3134,0.697030064165807,2505,-0.0453826768008019,629
"6420","4121232",0.610173056664465,4790,0.654619689043997,4206,-0.0444466323795315,584
"6421","1221232",0.704026991093701,1608,0.726894103060704,1616,-0.0228671119670022,-8
"6422","2221232",0.640803818585512,3529,0.67051961841988,3487,-0.0297157998343678,42
"6423","3221232",0.597689609772009,5337,0.641725785220101,4831,-0.0440361754480918,506
"6424","4221232",0.556215279071469,7388,0.59931541009829,7092,-0.0431001310268214,296
"6425","1321232",0.676047520816925,2340,0.699843535727406,2413,-0.0237960149104804,-73
"6426","2321232",0.612824348308736,4666,0.643469051086582,4737,-0.030644702777846,-71
"6427","3321232",0.569710139495233,6709,0.614675217886803,6226,-0.04496507839157,483
"6428","4321232",0.528235808794693,8830,0.572264842764993,8636,-0.0440290339702997,194
"6429","1421232",0.637111022831929,3671,0.6592140317593,3999,-0.0221030089273706,-328
"6430","2421232",0.57388785032374,6484,0.602839547118477,6886,-0.0289516967947363,-402
"6431","3421232",0.530773641510237,8695,0.574045713918697,8545,-0.0432720724084603,150
"6432","4421232",0.489299310809697,10781,0.531635338796887,10907,-0.0423360279871899,-126
"6433","1131232",0.714652246521598,1374,0.743733289558381,1239,-0.029081043036783,135
"6434","2131232",0.651429074013409,3141,0.687358804917558,2841,-0.0359297309041486,300
"6435","3131232",0.608314865199906,4880,0.658564971717778,4028,-0.0502501065178727,852
"6436","4131232",0.566840534499366,6848,0.616154596595968,6162,-0.0493140620966023,686
"6437","1231232",0.660694468928602,2793,0.688429010612675,2796,-0.027734541684073,-3
"6438","2231232",0.597471296420413,5353,0.632054525971851,5315,-0.0345832295514386,38
"6439","3231232",0.554357087606909,7484,0.603260692772072,6864,-0.0489036051651626,620
"6440","4231232",0.512882756906369,9633,0.560850317650262,9273,-0.0479675607438922,360
"6441","1331232",0.632714998651826,3817,0.661378443279377,3917,-0.0286634446275512,-100
"6442","2331232",0.569491826143637,6721,0.605003958638553,6773,-0.0355121324949168,-52
"6443","3331232",0.526377617330133,8937,0.576210125438774,8415,-0.0498325081086408,522
"6444","4331232",0.484903286629593,11002,0.533799750316964,10802,-0.0488964636873704,200
"6445","1431232",0.59377850066683,5518,0.620748939311271,5898,-0.0269704386444414,-380
"6446","2431232",0.530555328158641,8705,0.564374454670448,9079,-0.0338191265118071,-374
"6447","3431232",0.487441119345137,10887,0.535580621470668,10704,-0.0481395021255311,183
"6448","4431232",0.445966788644597,12717,0.493170246348858,12794,-0.0472034577042607,-77
"6449","1141232",0.665618682066768,2643,0.703334795431297,2304,-0.0377161133645285,339
"6450","2141232",0.60239550955858,5116,0.646960310790474,4561,-0.0445648012318941,555
"6451","3141232",0.559281300745076,7211,0.618166477590694,6039,-0.0588851768456181,1172
"6452","4141232",0.517806970044536,9361,0.575756102468884,8444,-0.0579491324243477,917
"6453","1241232",0.611660904473772,4715,0.648030516485591,4502,-0.0363696120118184,213
"6454","2241232",0.548437731965583,7765,0.591656031844767,7519,-0.043218299879184,246
"6455","3241232",0.50532352315208,9988,0.562862198644988,9172,-0.057538675492908,816
"6456","4241232",0.46384919245154,11963,0.520451823523178,11472,-0.0566026310716377,491
"6457","1341232",0.583681434196996,6015,0.620979949152293,5889,-0.0372985149552967,126
"6458","2341232",0.520458261688807,9211,0.564605464511469,9066,-0.0441472028226623,145
"6459","3341232",0.477344052875304,11353,0.53581163131169,10696,-0.0584675784363863,657
"6460","4341232",0.435869722174764,13106,0.49340125618988,12784,-0.0575315340151159,322
"6461","1441232",0.544744936212,7980,0.580350445184187,8168,-0.0356055089721868,-188
"6462","2441232",0.481521763703811,11155,0.523975960543364,11300,-0.0424541968395525,-145
"6463","3441232",0.438407554890308,12998,0.495182127343584,12713,-0.0567745724532766,285
"6464","4441232",0.396933224189768,14388,0.452771752221774,14322,-0.0558385280320062,66
"6465","1112232",0.792879127791429,356,0.804448712135164,389,-0.0115695843437359,-33
"6466","2112232",0.72965595528324,1096,0.748074227494341,1147,-0.0184182722111015,-51
"6467","3112232",0.686541746469736,2042,0.719280394294562,1823,-0.0327386478248255,219
"6468","4112232",0.645067415769196,3364,0.676870019172751,3257,-0.0318026034035551,107
"6469","1212232",0.738921350198432,936,0.749144433189458,1123,-0.0102230829910258,-187
"6470","2212232",0.675698177690244,2345,0.692769948548635,2651,-0.0170717708583914,-306
"6471","3212232",0.63258396887674,3821,0.663976115348855,3800,-0.0313921464721154,21
"6472","4212232",0.5911096381762,5627,0.621565740227045,5852,-0.030456102050845,-225
"6473","1312232",0.710941879921656,1448,0.72209386585616,1750,-0.0111519859345041,-302
"6474","2312232",0.647718707413467,3274,0.665719381215337,3709,-0.0180006738018696,-435
"6475","3312232",0.604604498599964,5024,0.636925548015558,5078,-0.0323210494155937,-54
"6476","4312232",0.563130167899424,7007,0.594515172893747,7369,-0.0313850049943233,-362
"6477","1412232",0.67200538193666,2446,0.681464361888054,3076,-0.00945897995139422,-630
"6478","2412232",0.608782209428471,4857,0.625089877247231,5663,-0.0163076678187599,-806
"6479","3412232",0.565668000614968,6902,0.596296044047452,7275,-0.0306280434324839,-373
"6480","4412232",0.524193669914428,9039,0.553885668925642,9692,-0.0296919990112136,-653
"6481","1122232",0.724899856925009,1179,0.743879400477758,1236,-0.0189795435527491,-57
"6482","2122232",0.66167668441682,2767,0.687504915836934,2832,-0.0258282314201147,-65
"6483","3122232",0.618562475603316,4402,0.658711082637155,4025,-0.0401486070338387,377
"6484","4122232",0.577088144902776,6335,0.616300707515345,6154,-0.0392125626125683,181
"6485","1222232",0.670942079332012,2471,0.688575121532051,2790,-0.017633042200039,-319
"6486","2222232",0.607718906823824,4903,0.632200636891228,5305,-0.0244817300674046,-402
"6487","3222232",0.56460469801032,6943,0.603406803691449,6854,-0.0388021056811286,89
"6488","4222232",0.52313036730978,9083,0.560996428569638,9263,-0.0378660612598583,-180
"6489","1322232",0.642962609055236,3442,0.661524554198754,3910,-0.0185619451435173,-468
"6490","2322232",0.579739436547047,6216,0.60515006955793,6763,-0.0254106330108829,-547
"6491","3322232",0.536625227733544,8385,0.576356236358151,8404,-0.0397310086246069,-19
"6492","4322232",0.495150897033004,10488,0.53394586123634,10792,-0.0387949642033365,-304
"6493","1422232",0.60402611107024,5049,0.620895050230648,5893,-0.0168689391604074,-844
"6494","2422232",0.540802938562051,8188,0.564520565589825,9071,-0.0237176270277731,-883
"6495","3422232",0.497688729748548,10374,0.535726732390045,10701,-0.0380380026414971,-327
"6496","4422232",0.456214399048008,12296,0.493316357268235,12788,-0.0371019582202268,-492
"6497","1132232",0.681567334759909,2184,0.705414308029729,2240,-0.0238469732698199,-56
"6498","2132232",0.61834416225172,4414,0.649039823388906,4457,-0.0306956611371855,-43
"6499","3132232",0.575229953438217,6422,0.620245990189126,5930,-0.0450160367509095,492
"6500","4132232",0.533755622737677,8525,0.577835615067316,8334,-0.0440799923296391,191
"6501","1232232",0.627609557166913,4011,0.650110029084023,4420,-0.0225004719171098,-409
"6502","2232232",0.564386384658724,6955,0.593735544443199,7424,-0.0293491597844754,-469
"6503","3232232",0.52127217584522,9183,0.56494171124342,9045,-0.0436695353981994,138
"6504","4232232",0.47979784514468,11226,0.52253133612161,11371,-0.042733490976929,-145
"6505","1332232",0.599630086890137,5246,0.623059461750725,5781,-0.023429374860588,-535
"6506","2332232",0.536406914381948,8403,0.566684977109901,8960,-0.0302780627279536,-557
"6507","3332232",0.493292705568444,10580,0.537891143910122,10587,-0.0445984383416776,-7
"6508","4332232",0.451818374867904,12466,0.495480768788312,12696,-0.0436623939204073,-230
"6509","1432232",0.560693588905141,7135,0.582429957782619,8057,-0.0217363688774782,-922
"6510","2432232",0.497470416396952,10392,0.526055473141796,11200,-0.0285850567448439,-808
"6511","3432232",0.454356207583448,12369,0.497261639942016,12612,-0.0429054323585679,-243
"6512","4432232",0.412881876882908,13909,0.454851264820206,14257,-0.0419693879372975,-348
"6513","1142232",0.632533770305079,3826,0.665015813902645,3750,-0.0324820435975653,76
"6514","2142232",0.56931059779689,6726,0.608641329261821,6577,-0.0393307314649309,149
"6515","3142232",0.526196388983387,8951,0.579847496062042,8208,-0.053651107078655,743
"6516","4142232",0.484722058282847,11008,0.537437120940232,10615,-0.0527150626573846,393
"6517","1242232",0.578575992712083,6272,0.609711534956939,6510,-0.0311355422448553,-238
"6518","2242232",0.515352820203894,9503,0.553337050316115,9727,-0.0379842301122209,-224
"6519","3242232",0.472238611390391,11605,0.524543217116336,11272,-0.0523046057259449,333
"6520","4242232",0.430764280689851,13313,0.482132841994525,13247,-0.0513685613046745,66
"6521","1342232",0.550596522435307,7671,0.582660967623641,8044,-0.0320644451883335,-373
"6522","2342232",0.487373349927118,10890,0.526286482982817,11185,-0.0389131330556991,-295
"6523","3342232",0.444259141113615,12790,0.497492649783038,12602,-0.0532335086694231,188
"6524","4342232",0.402784810413075,14221,0.455082274661228,14244,-0.0522974642481527,-23
"6525","1442232",0.511660024450311,9686,0.542031463655535,10352,-0.0303714392052237,-666
"6526","2442232",0.448436851942122,12620,0.485656979014712,13114,-0.0372201270725894,-494
"6527","3442232",0.405322643128619,14157,0.456863145814932,14186,-0.0515405026863134,-29
"6528","4442232",0.363848312428079,15188,0.414452770693122,15316,-0.050604458265043,-128
"6529","1113232",0.753995952218943,732,0.778952121745925,652,-0.0249561695269825,80
"6530","2113232",0.690772779710754,1932,0.722577637105102,1736,-0.0318048573943481,196
"6531","3113232",0.64765857089725,3276,0.693783803905323,2614,-0.0461252330080721,662
"6532","4113232",0.606184240196711,4970,0.651373428783512,4350,-0.0451891885868017,620
"6533","1213232",0.700038174625947,1691,0.723647842800219,1710,-0.0236096681742723,-19
"6534","2213232",0.636815002117758,3679,0.667273358159396,3636,-0.0304583560416379,43
"6535","3213232",0.593700793304255,5521,0.638479524959616,5018,-0.044778731655362,503
"6536","4213232",0.552226462603714,7589,0.596069149837806,7287,-0.0438426872340917,302
"6537","1313232",0.672058704349171,2444,0.696597275466921,2521,-0.0245385711177506,-77
"6538","2313232",0.608835531840982,4855,0.640222790826098,4902,-0.0313872589851162,-47
"6539","3313232",0.565721323027478,6900,0.611428957626319,6421,-0.0457076345988402,479
"6540","4313232",0.524246992326938,9035,0.569018582504508,8832,-0.0447715901775699,203
"6541","1413232",0.633122206364175,3806,0.655967771498815,4146,-0.0228455651346408,-340
"6542","2413232",0.569899033855986,6696,0.599593286857992,7079,-0.0296942530020065,-383
"6543","3413232",0.526784825042482,8914,0.570799453658213,8735,-0.0440146286157305,179
"6544","4413232",0.485310494341942,10984,0.528389078536402,11084,-0.0430785841944602,-100
"6545","1123232",0.686016681352523,2055,0.718382810088519,1849,-0.0323661287359958,206
"6546","2123232",0.622793508844334,4224,0.662008325447695,3881,-0.0392148166033613,343
"6547","3123232",0.579679300030831,6219,0.633214492247916,5257,-0.0535351922170854,962
"6548","4123232",0.538204969330291,8320,0.590804117126106,7560,-0.0525991477958149,760
"6549","1223232",0.632058903759527,3842,0.663078531142812,3835,-0.0310196273832856,7
"6550","2223232",0.568835731251338,6745,0.606704046501989,6661,-0.0378683152506512,84
"6551","3223232",0.525721522437835,8965,0.57791021330221,8324,-0.0521886908643752,641
"6552","4223232",0.484247191737294,11036,0.535499838180399,10709,-0.0512526464431049,327
"6553","1323232",0.604079433482751,5047,0.636027963809515,5122,-0.0319485303267638,-75
"6554","2323232",0.540856260974562,8186,0.579653479168691,8215,-0.0387972181941294,-29
"6555","3323232",0.497742052161058,10372,0.550859645968912,9852,-0.0531175938078534,520
"6556","4323232",0.456267721460518,12291,0.508449270847101,12088,-0.0521815493865831,203
"6557","1423232",0.565142935497755,6930,0.595398459841409,7324,-0.030255524343654,-394
"6558","2423232",0.501919762989566,10171,0.539023975200586,10519,-0.0371042122110197,-348
"6559","3423232",0.458805554176062,12198,0.510230142000806,12019,-0.0514245878247437,179
"6560","4423232",0.417331223475522,13777,0.467819766878996,13828,-0.0504885434034734,-51
"6561","1133232",0.642684159187423,3457,0.67991771764049,3143,-0.0372335584530664,314
"6562","2133232",0.579460986679235,6232,0.623543232999667,5753,-0.044082246320432,479
"6563","3133232",0.536346777865731,8406,0.594749399799887,7355,-0.058402621934156,1051
"6564","4133232",0.494872447165191,10507,0.552339024678077,9779,-0.0574665775128858,728
"6565","1233232",0.588726381594427,5746,0.624613438694784,5688,-0.0358870571003564,58
"6566","2233232",0.525503209086238,8980,0.56823895405396,8875,-0.042735744967722,105
"6567","3233232",0.482389000272735,11121,0.539445120854181,10503,-0.057056120581446,618
"6568","4233232",0.440914669572195,12912,0.49703474573237,12617,-0.0561200761601756,295
"6569","1333232",0.560746911317651,7132,0.597562871361486,7205,-0.0368159600438347,-73
"6570","2333232",0.497523738809462,10390,0.541188386720662,10411,-0.0436646479112003,-21
"6571","3333232",0.454409529995959,12366,0.512394553520883,11913,-0.0579850235249243,453
"6572","4333232",0.412935199295419,13908,0.469984178399073,13764,-0.0570489791036538,144
"6573","1433232",0.521810413332655,9157,0.55693336739338,9514,-0.0351229540607249,-357
"6574","2433232",0.458587240824466,12210,0.500558882752557,12467,-0.0419716419280906,-257
"6575","3433232",0.415473032010963,13832,0.471765049552777,13695,-0.0562920175418146,137
"6576","4433232",0.373998701310423,14965,0.429354674430967,14993,-0.0553559731205441,-28
"6577","1143232",0.593650594732594,5524,0.639519223513406,4952,-0.045868628780812,572
"6578","2143232",0.530427422224405,8710,0.583144738872582,8006,-0.0527173166481776,704
"6579","3143232",0.487313213410901,10894,0.554350905672803,9661,-0.0670376922619016,1233
"6580","4143232",0.445838882710362,12724,0.511940530550993,11934,-0.0661016478406311,790
"6581","1243232",0.539692817139598,8246,0.5842149445677,7937,-0.0445221274281018,309
"6582","2243232",0.476469644631409,11403,0.527840459926876,11104,-0.0513708152954674,299
"6583","3243232",0.433355435817905,13217,0.499046626727097,12548,-0.0656911909091914,669
"6584","4243232",0.391881105117365,14549,0.456636251605286,14190,-0.0647551464879211,359
"6585","1343232",0.511713346862822,9683,0.557164377234402,9503,-0.04545103037158,180
"6586","2343232",0.448490174354633,12618,0.500789892593578,12453,-0.0522997182389456,165
"6587","3343232",0.405375965541129,14156,0.471996059393799,13690,-0.0666200938526696,466
"6588","4343232",0.363901634840589,15186,0.429585684271989,14990,-0.0656840494313994,196
"6589","1443232",0.472776848877826,11575,0.516534873266296,11690,-0.0437580243884702,-115
"6590","2443232",0.409553676369637,14014,0.460160388625473,14078,-0.0506067122558359,-64
"6591","3443232",0.366439467556133,15138,0.431366555425693,14952,-0.0649270878695599,186
"6592","4443232",0.324965136855593,15792,0.388956180303883,15746,-0.0639910434482895,46
"6593","1114232",0.701788880248373,1657,0.73430150837227,1430,-0.0325126281238964,227
"6594","2114232",0.638565707740184,3614,0.677927023731446,3209,-0.039361315991262,405
"6595","3114232",0.595451498926681,5449,0.649133190531667,4451,-0.053681691604986,998
"6596","4114232",0.553977168226141,7501,0.606722815409857,6660,-0.0527456471837157,841
"6597","1214232",0.647831102655377,3267,0.678997229426563,3175,-0.0311661267711864,92
"6598","2214232",0.584607930147188,5971,0.62262274478574,5801,-0.0380148146385519,170
"6599","3214232",0.541493721333685,8145,0.593828911585961,7416,-0.052335190252276,729
"6600","4214232",0.500019390633145,10268,0.55141853646415,9821,-0.0513991458310056,447
"6601","1314232",0.619851632378601,4340,0.651946662093265,4323,-0.0320950297146646,17
"6602","2314232",0.556628459870412,7361,0.595572177452442,7313,-0.0389437175820302,48
"6603","3314232",0.513514251056909,9593,0.566778344252663,8952,-0.0532640931957542,641
"6604","4314232",0.472039920356369,11616,0.524367969130852,11280,-0.0523280487744838,336
"6605","1414232",0.580915134393605,6154,0.61131715812516,6425,-0.0304020237315548,-271
"6606","2414232",0.517691961885416,9366,0.554942673484336,9628,-0.0372507115989205,-262
"6607","3414232",0.474577753071913,11493,0.526148840284557,11192,-0.0515710872126445,301
"6608","4414232",0.433103422371373,13230,0.483738465162747,13193,-0.0506350427913741,37
"6609","1124232",0.633809609381953,3782,0.673732196714863,3361,-0.0399225873329097,421
"6610","2124232",0.570586436873764,6655,0.61735771207404,6084,-0.0467712752002752,571
"6611","3124232",0.527472228060261,8870,0.58856387887426,7686,-0.0610916508139993,1184
"6612","4124232",0.485997897359721,10955,0.54615350375245,10105,-0.0601556063927289,850
"6613","1224232",0.579851831788957,6211,0.618427917769157,6024,-0.0385760859801996,187
"6614","2224232",0.516628659280768,9431,0.562053433128333,9212,-0.0454247738475652,219
"6615","3224232",0.473514450467265,11542,0.533259599928554,10833,-0.0597451494612892,709
"6616","4224232",0.432040119766725,13264,0.490849224806744,12897,-0.0588091050400188,367
"6617","1324232",0.551872361512181,7603,0.591377350435859,7532,-0.0395049889236778,71
"6618","2324232",0.488649189003992,10817,0.535002865795035,10736,-0.0463536767910434,81
"6619","3324232",0.445534980190489,12729,0.506209032595256,12199,-0.0606740524047674,530
"6620","4324232",0.404060649489949,14187,0.463798657473446,13952,-0.059738007983497,235
"6621","1424232",0.512935863527185,9629,0.550747846467753,9857,-0.037811982940568,-228
"6622","2424232",0.449712691018996,12558,0.49437336182693,12742,-0.0446606708079337,-184
"6623","3424232",0.406598482205493,14111,0.46557952862715,13908,-0.0589810464216577,203
"6624","4424232",0.365124151504953,15163,0.42316915350534,15124,-0.0580450020003873,39
"6625","1134232",0.590477087216854,5665,0.635267104266834,5166,-0.0447900170499804,499
"6626","2134232",0.527253914708665,8888,0.578892619626011,8268,-0.051638704917346,620
"6627","3134232",0.484139705895161,11042,0.550098786426231,9889,-0.06595908053107,1153
"6628","4134232",0.442665375194621,12845,0.507688411304421,12131,-0.0650230361097996,714
"6629","1234232",0.536519309623857,8393,0.579962825321128,8201,-0.0434435156972703,192
"6630","2234232",0.473296137115669,11555,0.523588340680304,11317,-0.0502922035646359,238
"6631","3234232",0.430181928302165,13336,0.494794507480525,12726,-0.0646125791783599,610
"6632","4234232",0.388707597601625,14616,0.452384132358715,14333,-0.0636765347570896,283
"6633","1334232",0.508539839347081,9819,0.55291225798783,9750,-0.0443724186407486,69
"6634","2334232",0.445316666838892,12746,0.496537773347007,12641,-0.0512211065081142,105
"6635","3334232",0.402202458025389,14241,0.467743940147227,13830,-0.0655414821218382,411
"6636","4334232",0.360728127324849,15244,0.425333565025417,15076,-0.0646054377005678,168
"6637","1434232",0.469603341362085,11711,0.512282754019724,11917,-0.0426794126576387,-206
"6638","2434232",0.406380168853896,14120,0.455908269378901,14216,-0.0495281005250044,-96
"6639","3434232",0.363265960040393,15199,0.427114436179121,15041,-0.0638484761387285,158
"6640","4434232",0.321791629339853,15825,0.384704061057311,15799,-0.0629124317174581,26
"6641","1144232",0.541443522762024,8149,0.59486861013975,7350,-0.0534250873777259,799
"6642","2144232",0.478220350253835,11309,0.538494125498927,10553,-0.0602737752450915,756
"6643","3144232",0.435106141440332,13143,0.509700292299147,12041,-0.0745941508588155,1102
"6644","4144232",0.393631810739792,14486,0.467289917177337,13842,-0.0736581064375451,644
"6645","1244232",0.487485745169028,10881,0.539564331194044,10494,-0.0520785860250158,387
"6646","2244232",0.424262572660839,13539,0.48318984655322,13211,-0.0589272738923814,328
"6647","3244232",0.381148363847336,14805,0.454396013353441,14273,-0.0732476495061054,532
"6648","4244232",0.339674033146796,15605,0.411985638231631,15364,-0.072311605084835,241
"6649","1344232",0.459506274892252,12162,0.512513763860746,11901,-0.0530074889684941,261
"6650","2344232",0.396283102384063,14409,0.456139279219922,14203,-0.0598561768358596,206
"6651","3344232",0.353168893570559,15384,0.427345446020143,15037,-0.0741765524495837,347
"6652","4344232",0.311694562870019,15936,0.384935070898333,15795,-0.0732405080283133,141
"6653","1444232",0.420569776907256,13668,0.47188425989264,13692,-0.0513144829853842,-24
"6654","2444232",0.357346604399067,15306,0.415509775251817,15291,-0.0581631708527499,15
"6655","3444232",0.314232395585563,15909,0.386715942052037,15775,-0.0724835464664739,134
"6656","4444232",0.272758064885023,16205,0.344305566930227,16171,-0.0715475020452035,34
"6657","1111332",0.80351006054781,291,0.824717703736142,245,-0.0212076431883325,46
"6658","2111332",0.740286888039621,922,0.768343219095319,793,-0.028056331055698,129
"6659","3111332",0.697172679226117,1770,0.739549385895539,1329,-0.0423767066694221,441
"6660","4111332",0.655698348525577,2957,0.697139010773729,2503,-0.0414406622481518,454
"6661","1211332",0.749552282954813,792,0.769413424790436,781,-0.0198611418356225,11
"6662","2211332",0.686329110446624,2049,0.713038940149612,1982,-0.0267098297029881,67
"6663","3211332",0.643214901633121,3431,0.684245106949833,2961,-0.0410302053167121,470
"6664","4211332",0.601740570932581,5144,0.641834731828023,4824,-0.0400941608954416,320
"6665","1311332",0.721572812678037,1243,0.742362857457138,1262,-0.0207900447791007,-19
"6666","2311332",0.658349640169848,2880,0.685988372816315,2890,-0.0276387326464663,-10
"6667","3311332",0.615235431356345,4545,0.657194539616535,4096,-0.0419591082601903,449
"6668","4311332",0.573761100655805,6491,0.614784164494725,6221,-0.0410230638389198,270
"6669","1411332",0.682636314693041,2147,0.701733353489032,2363,-0.0190970387959909,-216
"6670","2411332",0.619413142184852,4366,0.645358868848209,4631,-0.0259457266633566,-265
"6671","3411332",0.576298933371349,6369,0.616565035648429,6136,-0.0402661022770806,233
"6672","4411332",0.534824602670809,8470,0.574154660526619,8540,-0.0393300578558101,-70
"6673","1121332",0.73553078968139,1005,0.764148392078735,867,-0.0286176023973457,138
"6674","2121332",0.672307617173201,2436,0.707773907437912,2152,-0.0354662902647113,284
"6675","3121332",0.629193408359697,3957,0.678980074238132,3177,-0.0497866658784353,780
"6676","4121332",0.587719077659157,5789,0.636569699116322,5096,-0.048850621457165,693
"6677","1221332",0.681573012088393,2182,0.708844113133029,2118,-0.0272711010446357,64
"6678","2221332",0.618349839580204,4413,0.652469628492206,4302,-0.0341197889120013,111
"6679","3221332",0.575235630766701,6421,0.623675795292426,5745,-0.0484401645257253,676
"6680","4221332",0.533761300066161,8523,0.581265420170616,8118,-0.0475041201044548,405
"6681","1321332",0.653593541811617,3052,0.681793545799731,3060,-0.028200003988114,-8
"6682","2321332",0.590370369303428,5676,0.625419061158908,5643,-0.0350486918554795,33
"6683","3321332",0.547256160489925,7835,0.596625227959128,7259,-0.0493690674692036,576
"6684","4321332",0.505781829789385,9960,0.554214852837318,9670,-0.0484330230479331,290
"6685","1421332",0.614657043826621,4569,0.641164041831625,4866,-0.0265069980050041,-297
"6686","2421332",0.551433871318432,7626,0.584789557190802,7899,-0.0333556858723698,-273
"6687","3421332",0.508319662504929,9839,0.555995723991023,9579,-0.0476760614860938,260
"6688","4421332",0.466845331804389,11821,0.513585348869212,11852,-0.0467400170648233,-31
"6689","1131332",0.69219826751629,1900,0.725683299630706,1653,-0.0334850321144166,247
"6690","2131332",0.628975095008101,3963,0.669308814989883,3549,-0.0403337199817821,414
"6691","3131332",0.585860886194597,5897,0.640514981790104,4894,-0.0546540955955062,1003
"6692","4131332",0.544386555494058,7995,0.598104606668293,7175,-0.0537180511742357,820
"6693","1231332",0.638240489923294,3629,0.670379020685,3497,-0.0321385307617064,132
"6694","2231332",0.575017317415105,6437,0.614004536044177,6269,-0.038987218629072,168
"6695","3231332",0.531903108601601,8628,0.585210702844397,7877,-0.053307594242796,751
"6696","4231332",0.490428777901061,10719,0.542800327722587,10301,-0.0523715498215257,418
"6697","1331332",0.610261019646518,4786,0.643328453351702,4744,-0.0330674337051846,42
"6698","2331332",0.547037847138329,7852,0.586953968710879,7779,-0.0399161215725502,73
"6699","3331332",0.503923638324825,10067,0.558160135511099,9436,-0.0542364971862742,631
"6700","4331332",0.462449307624285,12022,0.515749760389289,11732,-0.053300452765004,290
"6701","1431332",0.571324521661522,6621,0.602698949383596,6891,-0.0313744277220748,-270
"6702","2431332",0.508101349153333,9852,0.546324464742773,10090,-0.0382231155894405,-238
"6703","3431332",0.464987140339829,11907,0.517530631542994,11637,-0.0525434912031645,270
"6704","4431332",0.423512809639289,13560,0.475120256421183,13546,-0.0516074467818942,14
"6705","1141332",0.64316470306146,3434,0.685284805503622,2916,-0.0421201024421619,518
"6706","2141332",0.579941530553271,6206,0.628910320862799,5457,-0.0489687903095275,749
"6707","3141332",0.536827321739768,8376,0.60011648766302,7051,-0.0632891659232515,1325
"6708","4141332",0.495352991039228,10474,0.557706112541209,9463,-0.0623531215019812,1011
"6709","1241332",0.589206925468464,5725,0.629980526557916,5410,-0.0407736010894519,315
"6710","2241332",0.525983752960275,8959,0.573606041917093,8567,-0.0476222889568175,392
"6711","3241332",0.482869544146772,11100,0.544812208717313,10187,-0.0619426645705415,913
"6712","4241332",0.441395213446232,12887,0.502401833595503,12374,-0.061006620149271,513
"6713","1341332",0.561227455191688,7109,0.602929959224618,6881,-0.0417025040329302,228
"6714","2341332",0.498004282683499,10365,0.546555474583795,10080,-0.0485511919002958,285
"6715","3341332",0.454890073869996,12348,0.517761641384015,11628,-0.0628715675140198,720
"6716","4341332",0.413415743169456,13887,0.475351266262205,13536,-0.0619355230927493,351
"6717","1441332",0.522290957206692,9134,0.562300455256512,9204,-0.0400094980498203,-70
"6718","2441332",0.459067784698503,12185,0.505925970615689,12205,-0.046858185917186,-20
"6719","3441332",0.415953575885,13816,0.47713213741591,13466,-0.0611785615309101,350
"6720","4441332",0.37447924518446,14952,0.434721762294099,14850,-0.0602425171096396,102
"6721","1112332",0.77042514878612,551,0.78639872220749,563,-0.0159735734213693,-12
"6722","2112332",0.707201976277932,1541,0.730024237566667,1530,-0.0228222612887349,11
"6723","3112332",0.664087767464428,2692,0.701230404366887,2378,-0.0371426369024589,314
"6724","4112332",0.622613436763888,4235,0.658820029245077,4020,-0.0362065924811886,215
"6725","1212332",0.716467371193124,1336,0.731094443261784,1509,-0.0146270720686593,-173
"6726","2212332",0.653244198684935,3068,0.67471995862096,3329,-0.0214757599360249,-261
"6727","3212332",0.610129989871432,4792,0.645926125421181,4614,-0.0357961355497489,178
"6728","4212332",0.568655659170892,6753,0.60351575029937,6848,-0.0348600911284784,-95
"6729","1312332",0.688487900916348,1984,0.704043875928486,2274,-0.0155559750121376,-290
"6730","2312332",0.625264728408159,4116,0.647669391287662,4522,-0.0224046628795032,-406
"6731","3312332",0.582150519594656,6092,0.618875558087883,5998,-0.0367250384932272,94
"6732","4312332",0.540676188894116,8199,0.576465182966073,8400,-0.0357889940719567,-201
"6733","1412332",0.649551402931352,3208,0.66341437196038,3820,-0.0138629690290277,-612
"6734","2412332",0.586328230423163,5865,0.607039887319557,6649,-0.0207116568963934,-784
"6735","3412332",0.54321402160966,8060,0.578246054119777,8304,-0.0350320325101174,-244
"6736","4412332",0.50173969090912,10182,0.535835678997967,10695,-0.034095988088847,-513
"6737","1122332",0.702445877919701,1647,0.725829410550083,1644,-0.0233835326303825,3
"6738","2122332",0.639222705411512,3598,0.66945492590926,3541,-0.0302322204977481,57
"6739","3122332",0.596108496598008,5420,0.64066109270948,4887,-0.0445525961114721,533
"6740","4122332",0.554634165897468,7463,0.59825071758767,7159,-0.0436165516902018,304
"6741","1222332",0.648488100326704,3247,0.670525131604377,3485,-0.0220370312776725,-238
"6742","2222332",0.585264927818515,5941,0.614150646963554,6257,-0.0288857191450381,-316
"6743","3222332",0.542150719005012,8115,0.585356813763774,7865,-0.0432060947587621,250
"6744","4222332",0.500676388304472,10227,0.542946438641964,10287,-0.0422700503374916,-60
"6745","1322332",0.620508630049928,4313,0.643474564271079,4736,-0.0229659342211508,-423
"6746","2322332",0.557285457541739,7324,0.587100079630256,7768,-0.0298146220885164,-444
"6747","3322332",0.514171248728236,9557,0.558306246430476,9431,-0.0441349977022404,126
"6748","4322332",0.472696918027696,11580,0.515895871308666,11723,-0.0431989532809699,-143
"6749","1422332",0.581572132064932,6113,0.602845060302973,6885,-0.0212729282380409,-772
"6750","2422332",0.518348959556743,9320,0.54647057566215,10087,-0.0281216161054066,-767
"6751","3422332",0.47523475074324,11456,0.51767674246237,11632,-0.0424419917191307,-176
"6752","4422332",0.4337604200427,13195,0.47526636734056,13538,-0.0415059472978602,-343
"6753","1132332",0.659113355754601,2844,0.687364318102054,2840,-0.0282509623474534,4
"6754","2132332",0.595890183246412,5429,0.630989833461231,5363,-0.035099650214819,66
"6755","3132332",0.552775974432908,7549,0.602196000261451,6924,-0.049420025828543,625
"6756","4132332",0.511301643732369,9702,0.559785625139641,9354,-0.0484839814072725,348
"6757","1232332",0.605155578161605,5002,0.632060039156348,5314,-0.0269044609947432,-312
"6758","2232332",0.541932405653416,8128,0.575685554515525,8452,-0.0337531488621088,-324
"6759","3232332",0.498818196839912,10324,0.546891721315745,10062,-0.0480735244758328,262
"6760","4232332",0.457343866139372,12246,0.504481346193935,12273,-0.0471374800545625,-27
"6761","1332332",0.577176107884829,6331,0.60500947182305,6772,-0.0278333639382214,-441
"6762","2332332",0.51395293537664,9571,0.548634987182227,9971,-0.034682051805587,-400
"6763","3332332",0.470838726563136,11656,0.519841153982447,11507,-0.049002427419311,149
"6764","4332332",0.429364395862596,13362,0.477430778860637,13453,-0.0480663829980408,-91
"6765","1432332",0.538239609899833,8316,0.564379967854944,9078,-0.0261403579551116,-762
"6766","2432332",0.475016437391644,11469,0.508005483214121,12114,-0.0329890458224773,-645
"6767","3432332",0.43190222857814,13271,0.479211650014342,13367,-0.0473094214362013,-96
"6768","4432332",0.3904278978776,14576,0.436801274892531,14797,-0.046373377014931,-221
"6769","1142332",0.610079791299771,4796,0.64696582397497,4560,-0.0368860326751987,236
"6770","2142332",0.546856618791583,7857,0.590591339334147,7569,-0.0437347205425643,288
"6771","3142332",0.503742409978079,10078,0.561797506134367,9228,-0.0580550961562883,850
"6772","4142332",0.462268079277539,12032,0.519387131012557,11538,-0.0571190517350181,494
"6773","1242332",0.556122013706775,7393,0.591661545029264,7518,-0.0355395313224888,-125
"6774","2242332",0.492898841198586,10604,0.535287060388441,10725,-0.0423882191898544,-121
"6775","3242332",0.449784632385083,12556,0.506493227188661,12185,-0.0567085948035784,371
"6776","4242332",0.408310301684543,14047,0.464082852066851,13943,-0.0557725503823079,104
"6777","1342332",0.528142543429999,8842,0.564610977695966,9065,-0.036468434265967,-223
"6778","2342332",0.46491937092181,11913,0.508236493055143,12099,-0.0433171221333326,-186
"6779","3342332",0.421805162108307,13624,0.479442659855363,13358,-0.0576374977470566,266
"6780","4342332",0.380330831407767,14829,0.437032284733553,14787,-0.0567014533257861,42
"6781","1442332",0.489206045445003,10788,0.52398147372786,11299,-0.0347754282828572,-511
"6782","2442332",0.425982872936814,13474,0.467606989087037,13835,-0.0416241161502229,-361
"6783","3442332",0.382868664123311,14763,0.438813155887258,14741,-0.0559444917639469,22
"6784","4442332",0.341394333422771,15569,0.396402780765447,15638,-0.0550084473426764,-69
"6785","1113332",0.731541973213635,1069,0.760902131818251,921,-0.0293601586046159,148
"6786","2113332",0.668318800705446,2564,0.704527647177428,2261,-0.0362088464719815,303
"6787","3113332",0.625204591891943,4119,0.675733813977648,3299,-0.0505292220857055,820
"6788","4113332",0.583730261191403,6010,0.633323438855838,5253,-0.049593177664435,757
"6789","1213332",0.677584195620639,2302,0.705597852872545,2230,-0.0280136572519057,72
"6790","2213332",0.61436102311245,4591,0.649223368231721,4447,-0.0348623451192713,144
"6791","3213332",0.571246814298947,6626,0.620429535031942,5921,-0.0491827207329953,705
"6792","4213332",0.529772483598406,8742,0.578019159910132,8317,-0.0482466763117251,425
"6793","1313332",0.649604725343863,3205,0.678547285539247,3186,-0.028942560195384,19
"6794","2313332",0.586381552835674,5860,0.622172800898423,5820,-0.0357912480627496,40
"6795","3313332",0.54326734402217,8055,0.593378967698644,7439,-0.0501116236764736,616
"6796","4313332",0.50179301332163,10177,0.550968592576834,9847,-0.0491755792552033,330
"6797","1413332",0.610668227358867,4763,0.637917781571141,5043,-0.0272495542122742,-280
"6798","2413332",0.547445054850678,7816,0.581543296930318,8101,-0.0340982420796399,-285
"6799","3413332",0.504330846037174,10041,0.552749463730538,9761,-0.0484186176933639,280
"6800","4413332",0.462856515336634,12005,0.510339088608728,12016,-0.0474825732720936,-11
"6801","1123332",0.663562702347215,2716,0.700332820160844,2396,-0.0367701178136292,320
"6802","2123332",0.600339529839026,5213,0.643958335520021,4703,-0.0436188056809947,510
"6803","3123332",0.557225321025523,7330,0.615164502320241,6205,-0.0579391812947188,1125
"6804","4123332",0.515750990324983,9481,0.572754127198431,8606,-0.0570031368734483,875
"6805","1223332",0.609604924754219,4818,0.645028541215138,4652,-0.035423616460919,166
"6806","2223332",0.54638175224603,7880,0.588654056574315,7676,-0.0422723043282845,204
"6807","3223332",0.503267543432527,10103,0.559860223374535,9345,-0.0565926799420086,758
"6808","4223332",0.461793212731986,12056,0.517449848252725,11641,-0.0556566355207383,415
"6809","1323332",0.581625454477443,6109,0.61797797388184,6050,-0.0363525194043972,59
"6810","2323332",0.518402281969254,9317,0.561603489241017,9236,-0.0432012072717628,81
"6811","3323332",0.47528807315575,11453,0.532809656041237,10860,-0.0575215828854868,593
"6812","4323332",0.43381374245521,13192,0.490399280919427,12914,-0.0565855384642165,278
"6813","1423332",0.542688956492447,8083,0.577348469913734,8357,-0.0346595134212874,-274
"6814","2423332",0.479465783984258,11241,0.520973985272911,11444,-0.0415082012886531,-203
"6815","3423332",0.436351575170754,13082,0.492180152073131,12845,-0.0558285769023771,237
"6816","4423332",0.394877244470214,14453,0.449769776951321,14425,-0.0548925324811068,28
"6817","1133332",0.620230180182115,4328,0.661867727712815,3893,-0.0416375475306998,435
"6818","2133332",0.557007007673927,7343,0.605493243071992,6737,-0.0484862353980654,606
"6819","3133332",0.513892798860423,9573,0.576699409872212,8388,-0.0628066110117894,1185
"6820","4133332",0.472418468159883,11595,0.534289034750402,10776,-0.0618705665905191,819
"6821","1233332",0.566272402589119,6879,0.606563448767109,6671,-0.0402910461779898,208
"6822","2233332",0.50304923008093,10116,0.550188964126286,9885,-0.0471397340453554,231
"6823","3233332",0.459935021267427,12144,0.521395130926506,11429,-0.0614601096590794,715
"6824","4233332",0.418460690566887,13739,0.478984755804696,13375,-0.060524065237809,364
"6825","1333332",0.538292932312343,8313,0.579512881433811,8224,-0.0412199491214681,89
"6826","2333332",0.475069759804154,11467,0.523138396792988,11340,-0.0480686369888337,127
"6827","3333332",0.431955550990651,13269,0.494344563593208,12744,-0.0623890126025577,525
"6828","4333332",0.390481220290111,14575,0.451934188471398,14348,-0.0614529681812872,227
"6829","1433332",0.499356434327347,10299,0.538883377465705,10527,-0.0395269431383583,-228
"6830","2433332",0.436133261819158,13092,0.482508892824882,13232,-0.046375631005724,-140
"6831","3433332",0.393019053005655,14503,0.453715059625103,14295,-0.060696006619448,208
"6832","4433332",0.351544722305115,15414,0.411304684503292,15375,-0.0597599621981775,39
"6833","1143332",0.571196615727286,6629,0.621469233585731,5860,-0.0502726178584454,769
"6834","2143332",0.507973443219097,9859,0.565094748944908,9036,-0.057121305725811,823
"6835","3143332",0.464859234405593,11916,0.536300915745128,10669,-0.071441681339535,1247
"6836","4143332",0.423384903705054,13565,0.493890540623318,12760,-0.0705056369182645,805
"6837","1243332",0.51723883813429,9401,0.566164954640025,8982,-0.0489261165057352,419
"6838","2243332",0.454015665626101,12388,0.509790469999202,12036,-0.0557748043731008,352
"6839","3243332",0.410901456812597,13967,0.480996636799422,13299,-0.0700951799868248,668
"6840","4243332",0.369427126112057,15062,0.438586261677612,14745,-0.0691591355655545,317
"6841","1343332",0.489259367857514,10783,0.539114387306727,10517,-0.0498550194492134,266
"6842","2343332",0.426036195349325,13472,0.482739902665904,13225,-0.056703707316579,247
"6843","3343332",0.382921986535821,14762,0.453946069466124,14289,-0.071024082930303,473
"6844","4343332",0.341447655835281,15568,0.411535694344314,15371,-0.0700880385090328,197
"6845","1443332",0.450322869872518,12531,0.498484883338621,12567,-0.0481620134661036,-36
"6846","2443332",0.387099697364329,14654,0.442110398697798,14656,-0.0550107013334693,-2
"6847","3443332",0.343985488550825,15528,0.413316565498019,15344,-0.0693310769471933,184
"6848","4443332",0.302511157850285,16014,0.370906190376208,15965,-0.068395032525923,49
"6849","1114332",0.679334901243065,2248,0.716251518444595,1903,-0.0369166172015299,345
"6850","2114332",0.616111728734876,4496,0.659877033803772,3976,-0.0437653050688955,520
"6851","3114332",0.572997519921373,6535,0.631083200603992,5356,-0.0580856806826195,1179
"6852","4114332",0.531523189220833,8649,0.588672825482182,7672,-0.0571496362613491,977
"6853","1214332",0.625377123650069,4110,0.660947239498889,3935,-0.0355701158488197,175
"6854","2214332",0.56215395114188,7058,0.604572754858065,6802,-0.0424188037161853,256
"6855","3214332",0.519039742328377,9282,0.575778921658286,8442,-0.0567391793299094,840
"6856","4214332",0.477565411627837,11341,0.533368546536476,10824,-0.0558031349086391,517
"6857","1314332",0.597397653373293,5356,0.633896672165591,5231,-0.036499018792298,125
"6858","2314332",0.534174480865104,8504,0.577522187524768,8347,-0.0433477066596636,157
"6859","3314332",0.4910602720516,10689,0.548728354324988,9963,-0.0576680822733876,726
"6860","4314332",0.44958594135106,12567,0.506317979203178,12192,-0.0567320378521173,375
"6861","1414332",0.558461155388297,7253,0.593267168197485,7443,-0.0348060128091882,-190
"6862","2414332",0.495237982880108,10483,0.536892683556662,10643,-0.0416547006765539,-160
"6863","3414332",0.452123774066605,12458,0.508098850356882,12108,-0.0559750762902779,350
"6864","4414332",0.410649443366064,13977,0.465688475235072,13902,-0.0550390318690076,75
"6865","1124332",0.611355630376645,4739,0.655682206787188,4160,-0.0443265764105432,579
"6866","2124332",0.548132457868456,7785,0.599307722146365,7093,-0.0511752642779087,692
"6867","3124332",0.505018249054953,10009,0.570513888946586,8754,-0.0654956398916328,1255
"6868","4124332",0.463543918354413,11974,0.528103513824775,11093,-0.0645595954703623,881
"6869","1224332",0.557397852783649,7314,0.600377927841482,7040,-0.042980075057833,274
"6870","2224332",0.49417468027546,10538,0.544003443200659,10235,-0.0498287629251986,303
"6871","3224332",0.451060471461957,12505,0.515209610000879,11765,-0.0641491385389226,740
"6872","4224332",0.409586140761417,14013,0.472799234879069,13657,-0.0632130941176523,356
"6873","1324332",0.529418382506873,8765,0.573327360508184,8583,-0.0439089780013112,182
"6874","2324332",0.466195209998684,11852,0.516952875867361,11668,-0.0507576658686768,184
"6875","3324332",0.423081001185181,13581,0.488159042667581,13015,-0.0650780414824008,566
"6876","4324332",0.38160667048464,14791,0.445748667545771,14550,-0.0641419970611306,241
"6877","1424332",0.490481884521877,10710,0.532697856540078,10865,-0.0422159720182014,-155
"6878","2424332",0.427258712013688,13423,0.476323371899255,13498,-0.0490646598855671,-75
"6879","3424332",0.384144503200185,14727,0.447529538699476,14500,-0.0633850354992911,227
"6880","4424332",0.342670172499645,15550,0.405119163577665,15501,-0.0624489910780207,49
"6881","1134332",0.568023108211546,6797,0.617217114339159,6097,-0.0491940061276138,700
"6882","2134332",0.504799935703357,10013,0.560842629698336,9274,-0.0560426939949794,739
"6883","3134332",0.461685726889853,12060,0.532048796498557,10888,-0.0703630696087034,1172
"6884","4134332",0.420211396189313,13682,0.489638421376746,12950,-0.0694270251874332,732
"6885","1234332",0.514065330618549,9563,0.561912835393453,9223,-0.0478475047749038,340
"6886","2234332",0.45084215811036,12513,0.50553835075263,12224,-0.0546961926422694,289
"6887","3234332",0.407727949296857,14077,0.47674451755285,13483,-0.0690165682559934,594
"6888","4234332",0.366253618596317,15143,0.43433414243104,14860,-0.068080523834723,283
"6889","1334332",0.486085860341773,10950,0.534862268060155,10745,-0.0487764077183821,205
"6890","2334332",0.422862687833584,13585,0.478487783419332,13394,-0.0556250955857477,191
"6891","3334332",0.379748479020081,14847,0.449693950219552,14428,-0.0699454711994717,419
"6892","4334332",0.338274148319541,15625,0.407283575097742,15460,-0.0690094267782012,165
"6893","1434332",0.447149362356777,12671,0.494232764092049,12749,-0.0470834017352723,-78
"6894","2434332",0.383926189848588,14733,0.437858279451226,14764,-0.053932089602638,-31
"6895","3434332",0.340811981035085,15582,0.409064446251447,15424,-0.0682524652163619,158
"6896","4434332",0.299337650334545,16046,0.366654071129636,16004,-0.0673164207950916,42
"6897","1144332",0.518989543756716,9284,0.576818620212075,8382,-0.0578290764553594,902
"6898","2144332",0.455766371248527,12314,0.520444135571252,11473,-0.064677764322725,841
"6899","3144332",0.412652162435024,13918,0.491650302371473,12861,-0.078998139936449,1057
"6900","4144332",0.371177831734484,15023,0.449239927249662,14442,-0.0780620955151785,581
"6901","1244332",0.46503176616372,11903,0.521514341266369,11421,-0.0564825751026492,482
"6902","2244332",0.401808593655531,14257,0.465139856625546,13918,-0.0633312629700148,339
"6903","3244332",0.358694384842028,15278,0.436346023425766,14808,-0.0776516385837388,470
"6904","4244332",0.317220054141488,15870,0.393935648303956,15672,-0.0767155941624684,198
"6905","1344332",0.437052295886944,13057,0.494463773933071,12738,-0.0574114780461275,319
"6906","2344332",0.373829123378755,14968,0.438089289292248,14755,-0.064260165913493,213
"6907","3344332",0.330714914565251,15721,0.409295456092468,15419,-0.078580541527217,302
"6908","4344332",0.289240583864711,16105,0.366885080970658,16001,-0.0776444971059468,104
"6909","1444332",0.398115797901948,14348,0.453834269964965,14293,-0.0557184720630176,55
"6910","2444332",0.334892625393759,15669,0.397459785324142,15626,-0.0625671599303833,43
"6911","3444332",0.291778416580255,16091,0.368665952124363,15985,-0.0768875355441074,106
"6912","4444332",0.250304085879715,16283,0.326255577002552,16256,-0.075951491122837,27
"6913","1111432",0.773718043535662,512,0.790592563899027,509,-0.0168745203633647,3
"6914","2111432",0.710494871027473,1461,0.734218079258203,1433,-0.0237232082307303,28
"6915","3111432",0.66738066221397,2589,0.705424246058424,2239,-0.0380435838444543,350
"6916","4111432",0.62590633151343,4075,0.663013870936614,3841,-0.0371075394231839,234
"6917","1211432",0.719760265942666,1276,0.73528828495332,1416,-0.0155280190106546,-140
"6918","2211432",0.656537093434477,2937,0.678913800312497,3180,-0.0223767068780202,-243
"6919","3211432",0.613422884620973,4642,0.650119967112718,4419,-0.0366970824917442,223
"6920","4211432",0.571948553920434,6591,0.607709591990907,6620,-0.0357610380704738,-29
"6921","1311432",0.69178079566589,1913,0.708237717620023,2136,-0.0164569219541328,-223
"6922","2311432",0.628557623157701,3981,0.651863232979199,4327,-0.0233056098214984,-346
"6923","3311432",0.585443414344197,5929,0.62306939977942,5779,-0.0376259854352224,150
"6924","4311432",0.543969083643657,8021,0.580659024657609,8153,-0.0366899410139521,-132
"6925","1411432",0.652844297680894,3084,0.667608213651917,3624,-0.014763915971023,-540
"6926","2411432",0.589621125172705,5702,0.611233729011094,6426,-0.0216126038383887,-724
"6927","3411432",0.546506916359201,7873,0.582439895811314,8056,-0.0359329794521127,-183
"6928","4411432",0.505032585658661,10006,0.540029520689504,10472,-0.0349969350308423,-466
"6929","1121432",0.705738772669242,1572,0.73002325224162,1531,-0.0242844795723779,41
"6930","2121432",0.642515600161053,3462,0.673648767600797,3365,-0.0311331674397435,97
"6931","3121432",0.59940139134755,5260,0.644854934401017,4661,-0.0454535430534675,599
"6932","4121432",0.55792706064701,7278,0.602444559279207,6905,-0.0445174986321971,373
"6933","1221432",0.651780995076246,3125,0.674718973295914,3330,-0.0229379782196678,-205
"6934","2221432",0.588557822568057,5752,0.61834448865509,6027,-0.0297866660870334,-275
"6935","3221432",0.545443613754554,7938,0.589550655455311,7631,-0.0441070417007574,307
"6936","4221432",0.503969283054014,10064,0.547140280333501,10047,-0.043170997279487,17
"6937","1321432",0.62380152479947,4186,0.647668405962616,4523,-0.0238668811631461,-337
"6938","2321432",0.560578352291281,7144,0.591293921321792,7539,-0.0307155690305116,-395
"6939","3321432",0.517464143477777,9382,0.562500088122013,9193,-0.0450359446442357,189
"6940","4321432",0.475989812777237,11426,0.520089713000203,11490,-0.0440999002229653,-64
"6941","1421432",0.584865026814474,5956,0.60703890199451,6650,-0.0221738751800362,-694
"6942","2421432",0.521641854306285,9163,0.550664417353687,9860,-0.0290225630474019,-697
"6943","3421432",0.478527645492781,11295,0.521870584153907,11406,-0.0433429386611259,-111
"6944","4421432",0.437053314792241,13056,0.479460209032097,13355,-0.0424068942398556,-299
"6945","1131432",0.662406250504142,2750,0.691558159793591,2691,-0.0291519092894487,59
"6946","2131432",0.599183077995953,5269,0.635183675152768,5171,-0.0360005971568143,98
"6947","3131432",0.55606886918245,7395,0.606389841952988,6679,-0.0503209727705383,716
"6948","4131432",0.51459453848191,9527,0.563979466831178,9110,-0.0493849283492679,417
"6949","1231432",0.608448472911146,4875,0.636253880847885,5113,-0.0278054079367386,-238
"6950","2231432",0.545225300402957,7954,0.579879396207062,8205,-0.0346540958041042,-251
"6951","3231432",0.502111091589454,10161,0.551085563007282,9842,-0.0489744714178282,319
"6952","4231432",0.460636760888914,12113,0.508675187885472,12081,-0.0480384269965578,32
"6953","1331432",0.58046900263437,6178,0.609203313514587,6541,-0.0287343108802168,-363
"6954","2331432",0.517245830126181,9399,0.552828828873764,9758,-0.0355829987475824,-359
"6955","3331432",0.474131621312678,11518,0.524034995673984,11294,-0.0499033743613064,224
"6956","4331432",0.432657290612138,13243,0.481624620552174,13269,-0.048967329940036,-26
"6957","1431432",0.541532504649374,8144,0.568573809546481,8853,-0.027041304897107,-709
"6958","2431432",0.478309332141185,11307,0.512199324905658,11920,-0.0338899927644727,-613
"6959","3431432",0.435195123327682,13138,0.483405491705878,13204,-0.0482103683781967,-66
"6960","4431432",0.393720792627142,14484,0.440995116584068,14686,-0.0472743239569263,-202
"6961","1141432",0.613372686049313,4647,0.651159665666507,4362,-0.0377869796171941,285
"6962","2141432",0.550149513541124,7698,0.594785181025684,7354,-0.0446356674845597,344
"6963","3141432",0.50703530472762,9900,0.565991347825904,8989,-0.0589560430982837,911
"6964","4141432",0.46556097402708,11872,0.523580972704094,11318,-0.0580199986770134,554
"6965","1241432",0.559414908456317,7199,0.595855386720801,7304,-0.036440478264484,-105
"6966","2241432",0.496191735948128,10447,0.539480902079977,10501,-0.0432891661318496,-54
"6967","3241432",0.453077527134624,12426,0.510687068880198,12001,-0.0576095417455736,425
"6968","4241432",0.411603196434084,13950,0.468276693758388,13815,-0.0566734973243033,135
"6969","1341432",0.531435438179541,8658,0.568804819387503,8845,-0.0373693812079623,-187
"6970","2341432",0.468212265671352,11769,0.51243033474668,11910,-0.0442180690753279,-141
"6971","3341432",0.425098056857848,13507,0.4836365015469,13198,-0.0585384446890519,309
"6972","4341432",0.383623726157308,14742,0.44122612642509,14681,-0.0576024002677815,61
"6973","1441432",0.492498940194545,10622,0.528175315419397,11091,-0.0356763752248525,-469
"6974","2441432",0.429275767686356,13367,0.471800830778574,13693,-0.0425250630922182,-326
"6975","3441432",0.386161558872852,14675,0.443006997578794,14635,-0.0568454387059422,40
"6976","4441432",0.344687228172312,15518,0.400596622456984,15582,-0.0559093942846717,-64
"6977","1112432",0.740633131773973,913,0.752273582370375,1056,-0.0116404505964015,-143
"6978","2112432",0.677409959265784,2306,0.695899097729551,2543,-0.0184891384637671,-237
"6979","3112432",0.634295750452281,3770,0.667105264529772,3648,-0.0328095140774911,122
"6980","4112432",0.592821419751741,5554,0.624694889407961,5683,-0.0318734696562207,-129
"6981","1212432",0.686675354180977,2032,0.696969303424668,2509,-0.0102939492436914,-477
"6982","2212432",0.623452181672788,4205,0.640594818783845,4891,-0.017142637111057,-686
"6983","3212432",0.580337972859285,6186,0.611800985584066,6409,-0.031463012724781,-223
"6984","4212432",0.538863642158745,8285,0.569390610462255,8809,-0.0305269683035106,-524
"6985","1312432",0.658695883904201,2860,0.66991873609137,3514,-0.0112228521871697,-654
"6986","2312432",0.595472711396012,5447,0.613544251450547,6295,-0.0180715400545353,-848
"6987","3312432",0.552358502582508,7577,0.584750418250768,7904,-0.0323919156682593,-327
"6988","4312432",0.510884171881968,9725,0.542340043128957,10331,-0.0314558712469889,-606
"6989","1412432",0.619759385919205,4345,0.629289232123265,5443,-0.00952984620405983,-1098
"6990","2412432",0.556536213411016,7366,0.572914747482441,8601,-0.0163785340714255,-1235
"6991","3412432",0.513422004597512,9600,0.544120914282662,10232,-0.0306989096851495,-632
"6992","4412432",0.471947673896972,11621,0.501710539160852,12414,-0.0297628652638792,-793
"6993","1122432",0.672653860907553,2423,0.691704270712968,2683,-0.0190504098054147,-260
"6994","2122432",0.609430688399364,4827,0.635329786072145,5161,-0.0258990976727803,-334
"6995","3122432",0.566316479585861,6871,0.606535952872365,6673,-0.0402194732865043,198
"6996","4122432",0.524842148885321,9005,0.564125577750555,9096,-0.039283428865234,-91
"6997","1222432",0.618696083314557,4391,0.636399991767262,5103,-0.0177039084527046,-712
"6998","2222432",0.555472910806368,7428,0.580025507126438,8193,-0.0245525963200702,-765
"6999","3222432",0.512358701992865,9651,0.551231673926659,9833,-0.0388729719337942,-182
"7000","4222432",0.470884371292325,11653,0.508821298804848,12072,-0.0379369275125239,-419
"7001","1322432",0.590716613037781,5644,0.609349424433964,6531,-0.0186328113961829,-887
"7002","2322432",0.527493440529592,8869,0.55297493979314,9748,-0.0254814992635485,-879
"7003","3322432",0.484379231716088,11021,0.524181106593361,11290,-0.0398018748772725,-269
"7004","4322432",0.442904901015548,12831,0.481770731471551,13262,-0.0388658304560021,-431
"7005","1422432",0.551780115052785,7609,0.568719920465858,8849,-0.016939805413073,-1240
"7006","2422432",0.488556942544596,10823,0.512345435825035,11915,-0.0237884932804387,-1092
"7007","3422432",0.445442733731092,12735,0.483551602625255,13203,-0.0381088688941628,-468
"7008","4422432",0.403968403030552,14195,0.441141227503445,14682,-0.0371728244728924,-487
"7009","1132432",0.629321338742453,3949,0.653239178264939,4274,-0.0239178395224855,-325
"7010","2132432",0.566098166234265,6884,0.596864693624116,7246,-0.0307665273898511,-362
"7011","3132432",0.522983957420761,9093,0.568070860424336,8882,-0.0450869030035751,211
"7012","4132432",0.481509626720221,11156,0.525660485302526,11219,-0.0441508585823047,-63
"7013","1232432",0.575363561149457,6409,0.597934899319233,7187,-0.0225713381697754,-778
"7014","2232432",0.512140388641268,9664,0.541560414678409,10388,-0.029420026037141,-724
"7015","3232432",0.469026179827765,11739,0.51276658147863,11890,-0.043740401650865,-151
"7016","4232432",0.427551849127225,13409,0.47035620635682,13753,-0.0428043572295946,-344
"7017","1332432",0.547384090872681,7821,0.570884331985935,8732,-0.0235002411132537,-911
"7018","2332432",0.484160918364492,11041,0.514509847345112,11806,-0.0303489289806192,-765
"7019","3332432",0.441046709550989,12902,0.485716014145332,13112,-0.0446693045943433,-210
"7020","4332432",0.399572378850449,14307,0.443305639023522,14628,-0.0437332601730729,-321
"7021","1432432",0.508447592887685,9829,0.530254828017829,10990,-0.0218072351301438,-1161
"7022","2432432",0.445224420379496,12749,0.473880343377006,13606,-0.0286559229975095,-857
"7023","3432432",0.402110211565993,14246,0.445086510177226,14570,-0.0429762986112335,-324
"7024","4432432",0.360635880865453,15247,0.402676135055416,15554,-0.042040254189963,-307
"7025","1142432",0.580287774287624,6191,0.612840684137855,6341,-0.032552909850231,-150
"7026","2142432",0.517064601779435,9409,0.556466199497032,9545,-0.0394015977175965,-136
"7027","3142432",0.473950392965932,11528,0.527672366297252,11114,-0.0537219733313206,414
"7028","4142432",0.432476062265392,13248,0.485261991175442,13129,-0.0527859289100502,119
"7029","1242432",0.526329996694628,8940,0.557536405192149,9477,-0.0312064084975209,-537
"7030","2242432",0.463106824186439,11995,0.501161920551325,12437,-0.0380550963648865,-442
"7031","3242432",0.419992615372935,13694,0.472368087351546,13674,-0.0523754719786105,20
"7032","4242432",0.378518284672395,14869,0.429957712229736,14980,-0.0514394275573401,-111
"7033","1342432",0.498350526417852,10342,0.530485837858851,10977,-0.0321353114409991,-635
"7034","2342432",0.435127353909663,13141,0.474111353218027,13596,-0.0389839993083647,-455
"7035","3342432",0.392013145096159,14540,0.445317520018248,14565,-0.0533043749220887,-25
"7036","4342432",0.350538814395619,15430,0.402907144896438,15548,-0.0523683305008182,-118
"7037","1442432",0.459414028432856,12169,0.489856333890745,12942,-0.0304423054578893,-773
"7038","2442432",0.396190855924667,14412,0.433481849249922,14881,-0.037290993325255,-469
"7039","3442432",0.353076647111163,15388,0.404688016050142,15512,-0.0516113689389789,-124
"7040","4442432",0.311602316410623,15940,0.362277640928332,16051,-0.0506753245177084,-111
"7041","1113432",0.701749956201487,1658,0.726776991981136,1621,-0.0250270357796482,37
"7042","2113432",0.638526783693299,3616,0.670402507340312,3494,-0.0318757236470137,122
"7043","3113432",0.595412574879795,5451,0.641608674140533,4842,-0.0461960992607378,609
"7044","4113432",0.553938244179255,7502,0.599198299018722,7106,-0.0452600548394673,396
"7045","1213432",0.647792178608491,3269,0.671472713035429,3456,-0.023680534426938,-187
"7046","2213432",0.584569006100302,5972,0.615098228394606,6209,-0.0305292222943035,-237
"7047","3213432",0.541454797286799,8148,0.586304395194827,7819,-0.0448495979080276,329
"7048","4213432",0.499980466586259,10269,0.543894020073016,10243,-0.0439135534867573,26
"7049","1313432",0.619812708331715,4341,0.644422145702131,4679,-0.0246094373704162,-338
"7050","2313432",0.556589535823526,7362,0.588047661061308,7709,-0.0314581252377818,-347
"7051","3313432",0.513475327010023,9595,0.559253827861529,9379,-0.0457785008515058,216
"7052","4313432",0.472000996309483,11617,0.516843452739718,11676,-0.0448424564302355,-59
"7053","1413432",0.580876210346719,6157,0.603792641734026,6836,-0.0229164313873064,-679
"7054","2413432",0.51765303783853,9368,0.547418157093202,10036,-0.0297651192546721,-668
"7055","3413432",0.474538829025027,11496,0.518624323893423,11579,-0.0440854948683961,-83
"7056","4413432",0.433064498324487,13232,0.476213948771613,13505,-0.0431494504471258,-273
"7057","1123432",0.633770685335067,3783,0.666207680323729,3685,-0.0324369949886614,98
"7058","2123432",0.570547512826879,6657,0.609833195682906,6497,-0.039285682856027,160
"7059","3123432",0.527433304013375,8872,0.581039362483126,8130,-0.053606058469751,742
"7060","4123432",0.485958973312835,10958,0.538628987361316,10543,-0.0526700140484805,415
"7061","1223432",0.579812907742071,6213,0.610903401378023,6442,-0.0310904936359512,-229
"7062","2223432",0.516589735233883,9432,0.554528916737199,9650,-0.0379391815033168,-218
"7063","3223432",0.473475526420379,11544,0.52573508353742,11213,-0.0522595571170408,331
"7064","4223432",0.432001195719839,13267,0.48332470841561,13206,-0.0513235126957705,61
"7065","1323432",0.551833437465295,7604,0.583852834044725,7957,-0.0320193965794294,-353
"7066","2323432",0.488610264957106,10819,0.527478349403901,11121,-0.038868084446795,-302
"7067","3323432",0.445496056143603,12731,0.498684516204122,12560,-0.053188460060519,171
"7068","4323432",0.404021725443063,14190,0.456274141082312,14198,-0.0522524156392488,-8
"7069","1423432",0.512896939480299,9631,0.543223330076619,10276,-0.0303263905963196,-645
"7070","2423432",0.44967376697211,12561,0.486848845435796,13057,-0.0371750784636853,-496
"7071","3423432",0.406559558158607,14114,0.458055012236016,14151,-0.0514954540774093,-37
"7072","4423432",0.365085227458067,15166,0.415644637114206,15286,-0.0505594096561389,-120
"7073","1133432",0.590438163169968,5671,0.6277425878757,5525,-0.037304424705732,146
"7074","2133432",0.527214990661779,8889,0.571368103234877,8703,-0.0441531125730976,186
"7075","3133432",0.484100781848276,11044,0.542574270035097,10316,-0.0584734881868216,728
"7076","4133432",0.442626451147735,12846,0.500163894913287,12490,-0.0575374437655514,356
"7077","1233432",0.536480385576972,8399,0.572438308929994,8628,-0.0359579233530221,-229
"7078","2233432",0.473257213068783,11557,0.51606382428917,11716,-0.0428066112203876,-159
"7079","3233432",0.430143004255279,13338,0.487269991089391,13043,-0.0571269868341117,295
"7080","4233432",0.388668673554739,14617,0.444859615967581,14577,-0.0561909424128412,40
"7081","1333432",0.508500915300195,9823,0.545387741596696,10150,-0.0368868262965003,-327
"7082","2333432",0.445277742792007,12747,0.489013256955872,12981,-0.0437355141638659,-234
"7083","3333432",0.402163533978503,14242,0.460219423756093,14076,-0.0580558897775899,166
"7084","4333432",0.360689203277963,15245,0.417809048634283,15243,-0.0571198453563193,2
"7085","1433432",0.4695644173152,11717,0.50475823762859,12256,-0.0351938203133905,-539
"7086","2433432",0.406341244807011,14121,0.448383752987767,14467,-0.0420425081807562,-346
"7087","3433432",0.363227035993507,15201,0.419589919787987,15209,-0.0563628837944801,-8
"7088","4433432",0.321752705292967,15826,0.377179544666177,15897,-0.0554268393732095,-71
"7089","1143432",0.541404598715138,8154,0.587344093748616,7752,-0.0459394950334776,402
"7090","2143432",0.478181426206949,11312,0.530969609107793,10941,-0.0527881829008432,371
"7091","3143432",0.435067217393446,13144,0.502175775908013,12386,-0.0671085585145672,758
"7092","4143432",0.393592886692906,14487,0.459765400786203,14089,-0.0661725140932967,398
"7093","1243432",0.487446821122142,10884,0.53203981480291,10889,-0.0445929936807674,-5
"7094","2243432",0.424223648613953,13540,0.475665330162086,13523,-0.051441681548133,17
"7095","3243432",0.38110943980045,14807,0.446871496962307,14519,-0.065762057161857,288
"7096","4243432",0.33963510909991,15606,0.404461121840497,15513,-0.0648260127405866,93
"7097","1343432",0.459467350845366,12164,0.504989247469612,12246,-0.0455218966242457,-82
"7098","2343432",0.396244178337177,14410,0.448614762828788,14460,-0.0523705844916112,-50
"7099","3343432",0.353129969523674,15386,0.419820929629009,15206,-0.0666909601053352,180
"7100","4343432",0.311655638823134,15938,0.377410554507199,15894,-0.0657549156840648,44
"7101","1443432",0.42053085286037,13672,0.464359743501506,13935,-0.0438288906411358,-263
"7102","2443432",0.357307680352181,15307,0.407985258860683,15443,-0.0506775785085014,-136
"7103","3443432",0.314193471538678,15911,0.379191425660903,15877,-0.0649979541222253,34
"7104","4443432",0.272719140838138,16206,0.336781050539093,16213,-0.064061909700955,-7
"7105","1114432",0.649542884230918,3209,0.68212637860748,3043,-0.032583494376562,166
"7106","2114432",0.586319711722729,5866,0.625751893966656,5625,-0.0394321822439276,241
"7107","3114432",0.543205502909225,8061,0.596958060766877,7240,-0.0537525578576517,821
"7108","4114432",0.501731172208685,10183,0.554547685645067,9648,-0.0528165134363813,535
"7109","1214432",0.595585106637922,5443,0.626822099661773,5574,-0.031236993023852,-131
"7110","2214432",0.532361934129733,8602,0.57044761502095,8756,-0.0380856808912176,-154
"7111","3214432",0.489247725316229,10784,0.541653781821171,10379,-0.0524060565049416,405
"7112","4214432",0.447773394615689,12646,0.49924340669936,12534,-0.0514700120836712,112
"7113","1314432",0.567605636361145,6815,0.599771532328476,7068,-0.0321658959673302,-253
"7114","2314432",0.504382463852956,10038,0.543397047687652,10266,-0.0390145838346958,-228
"7115","3314432",0.461268255039453,12086,0.514603214487873,11799,-0.0533349594484198,287
"7116","4314432",0.419793924338913,13704,0.472192839366062,13681,-0.0523989150271494,23
"7117","1414432",0.528669138376149,8803,0.55914202836037,9389,-0.0304728899842204,-586
"7118","2414432",0.46544596586796,11878,0.502767543719547,12356,-0.0373215778515861,-478
"7119","3414432",0.422331757054457,13601,0.473973710519767,13601,-0.0516419534653101,0
"7120","4414432",0.380857426353917,14815,0.431563335397957,14946,-0.0507059090440397,-131
"7121","1124432",0.581563613364498,6116,0.621557066950073,5854,-0.0399934535855753,262
"7122","2124432",0.518340440856309,9321,0.56518258230925,9029,-0.0468421414529409,292
"7123","3124432",0.475226232042805,11457,0.53638874910947,10665,-0.0611625170666649,792
"7124","4124432",0.433751901342265,13196,0.49397837398766,12756,-0.0602264726453945,440
"7125","1224432",0.527605835771502,8863,0.566252788004367,8978,-0.0386469522328652,-115
"7126","2224432",0.464382663263313,11937,0.509878303363543,12030,-0.0454956401002308,-93
"7127","3224432",0.421268454449809,13638,0.481084470163764,13292,-0.0598160157139548,346
"7128","4224432",0.379794123749269,14846,0.438674095041954,14743,-0.0588799712926844,103
"7129","1324432",0.499626365494725,10281,0.539202220671069,10514,-0.0395758551763434,-233
"7130","2324432",0.436403192986537,13080,0.482827736030246,13221,-0.046424543043709,-141
"7131","3324432",0.393288984173033,14495,0.454033902830466,14285,-0.060744918657433,210
"7132","4324432",0.351814653472493,15409,0.411623527708656,15370,-0.0598088742361625,39
"7133","1424432",0.460689867509729,12110,0.498572716702963,12563,-0.0378828491932336,-453
"7134","2424432",0.39746669500154,14367,0.44219823206214,14654,-0.0447315370605993,-287
"7135","3424432",0.354352486188037,15355,0.41340439886236,15342,-0.0590519126743232,13
"7136","4424432",0.312878155487497,15925,0.37099402374055,15964,-0.0581158682530527,-39
"7137","1134432",0.538231091199398,8317,0.583091974502044,8010,-0.044860883302646,307
"7138","2134432",0.475007918691209,11470,0.526717489861221,11158,-0.0517095711700116,312
"7139","3134432",0.431893709877706,13272,0.497923656661441,12582,-0.0660299467837356,690
"7140","4134432",0.390419379177166,14577,0.455513281539631,14228,-0.0650939023624653,349
"7141","1234432",0.484273313606402,11029,0.527787695556338,11110,-0.043514381949936,-81
"7142","2234432",0.421050141098213,13649,0.471413210915515,13708,-0.0503630698173015,-59
"7143","3234432",0.37793593228471,14887,0.442619377715735,14645,-0.0646834454310256,242
"7144","4234432",0.33646160158417,15647,0.400209002593925,15587,-0.0637474010097551,60
"7145","1334432",0.456293843329626,12289,0.50073712822304,12456,-0.0444432848934142,-167
"7146","2334432",0.393070670821437,14502,0.444362643582217,14590,-0.0512919727607798,-88
"7147","3334432",0.349956462007934,15439,0.415568810382437,15288,-0.0656123483745037,151
"7148","4334432",0.308482131307394,15968,0.373158435260627,15942,-0.0646763039532332,26
"7149","1434432",0.41735734534463,13774,0.460107624254934,14079,-0.0427502789103044,-305
"7150","2434432",0.354134172836441,15359,0.403733139614111,15526,-0.04959896677767,-167
"7151","3434432",0.311019964022938,15946,0.374939306414331,15926,-0.0639193423913939,20
"7152","4434432",0.269545633322397,16221,0.332528931292521,16235,-0.0629832979701236,-14
"7153","1144432",0.489197526744569,10789,0.54269348037496,10306,-0.0534959536303915,483
"7154","2144432",0.42597435423638,13475,0.486318995734137,13081,-0.0603446414977571,394
"7155","3144432",0.382860145422876,14764,0.457525162534357,14162,-0.0746650171114811,602
"7156","4144432",0.341385814722336,15570,0.415114787412547,15297,-0.0737289726902106,273
"7157","1244432",0.435239749151572,13134,0.487389201429254,13038,-0.0521494522776814,96
"7158","2244432",0.372016576643384,15007,0.43101471678843,14957,-0.058998140145047,50
"7159","3244432",0.32890236782988,15742,0.402220883588651,15561,-0.0733185157587709,181
"7160","4244432",0.28742803712934,16121,0.359810508466841,16064,-0.0723824713375004,57
"7161","1344432",0.407260278874796,14092,0.460338634095956,14070,-0.0530783552211597,22
"7162","2344432",0.344037106366607,15527,0.403964149455133,15521,-0.0599270430885251,6
"7163","3344432",0.300922897553104,16031,0.375170316255353,15923,-0.074247418702249,108
"7164","4344432",0.259448566852564,16258,0.332759941133543,16234,-0.0733113742809788,24
"7165","1444432",0.3683237808898,15092,0.41970913012785,15207,-0.0513853492380497,-115
"7166","2444432",0.305100608381611,15995,0.363334645487027,16036,-0.0582340371054153,-41
"7167","3444432",0.261986399568108,16245,0.334540812287247,16227,-0.0725544127191394,18
"7168","4444432",0.220512068867568,16346,0.292130437165437,16345,-0.071618368297869,1
"7169","1111142",0.836755005024003,136,0.848713954302722,130,-0.0119589492787193,6
"7170","2111142",0.773531832515814,515,0.792339469661899,489,-0.0188076371460849,26
"7171","3111142",0.730417623702311,1090,0.76354563646212,882,-0.0331280127598089,208
"7172","4111142",0.688943293001771,1964,0.721135261340309,1777,-0.0321919683385384,187
"7173","1211142",0.782797227431007,427,0.793409675357016,473,-0.0106124479260091,-46
"7174","2211142",0.719574054922818,1280,0.737035190716193,1372,-0.0174611357933747,-92
"7175","3211142",0.676459846109315,2329,0.708241357516413,2135,-0.0317815114070987,194
"7176","4211142",0.634985515408775,3740,0.665830982394603,3702,-0.0308454669858285,38
"7177","1311142",0.754817757154231,723,0.766359108023718,835,-0.0115413508694874,-112
"7178","2311142",0.691594584646042,1921,0.709984623382895,2085,-0.018390038736853,-164
"7179","3311142",0.648480375832539,3249,0.681190790183116,3086,-0.032710414350577,163
"7180","4311142",0.607006045131999,4930,0.638780415061305,4999,-0.0317743699293067,-69
"7181","1411142",0.715881259169235,1350,0.725729604055612,1652,-0.00984834488637754,-302
"7182","2411142",0.652658086661046,3094,0.669355119414789,3547,-0.0166970327537432,-453
"7183","3411142",0.609543877847543,4821,0.64056128621501,4892,-0.0310174083674672,-71
"7184","4411142",0.568069547147003,6796,0.5981509110932,7173,-0.030081363946197,-377
"7185","1121142",0.768775734157583,567,0.788144642645316,541,-0.0193689084877325,26
"7186","2121142",0.705552561649394,1579,0.731770158004492,1499,-0.0262175963550981,80
"7187","3121142",0.662438352835891,2748,0.702976324804713,2317,-0.0405379719688221,431
"7188","4121142",0.620964022135351,4289,0.660565949682903,3947,-0.0396019275475517,342
"7189","1221142",0.714817956564587,1372,0.73284036369961,1469,-0.0180224071350223,-97
"7190","2221142",0.651594784056398,3136,0.676465879058786,3275,-0.0248710950023879,-139
"7191","3221142",0.608480575242895,4872,0.647672045859007,4521,-0.0391914706161119,351
"7192","4221142",0.567006244542355,6843,0.605261670737196,6757,-0.0382554261948417,86
"7193","1321142",0.686838486287811,2028,0.705789796366312,2222,-0.0189513100785006,-194
"7194","2321142",0.623615313779622,4199,0.649415311725488,4439,-0.0257999979458662,-240
"7195","3321142",0.580501104966119,6173,0.620621478525709,5907,-0.0401203735595902,266
"7196","4321142",0.539026774265579,8277,0.578211103403898,8307,-0.0391843291383199,-30
"7197","1421142",0.647901988302815,3266,0.665160292398206,3740,-0.0172583040953908,-474
"7198","2421142",0.584678815794626,5969,0.608785807757383,6567,-0.0241069919627565,-598
"7199","3421142",0.541564606981123,8142,0.579991974557603,8197,-0.0384273675764805,-55
"7200","4421142",0.500090276280583,10265,0.537581599435793,10605,-0.0374913231552102,-340
"7201","1131142",0.725443211992484,1173,0.749679550197287,1108,-0.0242363382048032,65
"7202","2131142",0.662220039484295,2755,0.693305065556464,2631,-0.0310850260721688,124
"7203","3131142",0.619105830670791,4383,0.664511232356684,3778,-0.0454054016858928,605
"7204","4131142",0.577631499970251,6311,0.622100857234874,5826,-0.0444693572646225,485
"7205","1231142",0.671485434399487,2459,0.694375271251581,2595,-0.0228898368520932,-136
"7206","2231142",0.608262261891299,4883,0.638000786610757,5039,-0.0297385247194588,-156
"7207","3231142",0.565148053077795,6929,0.609206953410978,6540,-0.0440589003331828,389
"7208","4231142",0.523673722377255,9056,0.566796578289168,8951,-0.0431228559119123,105
"7209","1331142",0.643505964122711,3416,0.667324703918283,3635,-0.0238187397955715,-219
"7210","2331142",0.580282791614522,6192,0.610950219277459,6439,-0.0306674276629371,-247
"7211","3331142",0.537168582801019,8365,0.58215638607768,8077,-0.0449878032766611,288
"7212","4331142",0.495694252100479,10464,0.53974601095587,10485,-0.0440517588553906,-21
"7213","1431142",0.604569466137715,5026,0.626695199950177,5585,-0.0221257338124616,-559
"7214","2431142",0.541346293629526,8160,0.570320715309354,8763,-0.0289744216798273,-603
"7215","3431142",0.498232084816023,10355,0.541526882109574,10391,-0.0432947972935513,-36
"7216","4431142",0.456757754115483,12272,0.499116506987764,12544,-0.0423587528722809,-272
"7217","1141142",0.676409647537654,2333,0.709281056070203,2107,-0.0328714085325488,226
"7218","2141142",0.613186475029465,4651,0.65290657142938,4285,-0.0397200963999144,366
"7219","3141142",0.570072266215962,6688,0.6241127382296,5715,-0.0540404720136384,973
"7220","4141142",0.528597935515422,8806,0.58170236310779,8093,-0.0531044275923679,713
"7221","1241142",0.622451869944658,4247,0.653976777124497,4236,-0.0315249071798386,11
"7222","2241142",0.559228697436469,7213,0.597602292483673,7201,-0.0383735950472042,12
"7223","3241142",0.516114488622966,9461,0.568808459283894,8844,-0.0526939706609282,617
"7224","4241142",0.474640157922426,11488,0.526398084162083,11177,-0.0517579262396579,311
"7225","1341142",0.594472399667882,5496,0.626926209791199,5567,-0.0324538101233168,-71
"7226","2341142",0.531249227159693,8669,0.570551725150375,8751,-0.0393024979906824,-82
"7227","3341142",0.488135018346189,10847,0.541757891950596,10372,-0.0536228736044064,475
"7228","4341142",0.446660687645649,12695,0.499347516828786,12529,-0.0526868291831361,166
"7229","1441142",0.555535901682886,7425,0.586296705823093,7820,-0.030760804140207,-395
"7230","2441142",0.492312729174697,10631,0.52992222118227,11006,-0.0376094920075727,-375
"7231","3441142",0.449198520361193,12587,0.50112838798249,12438,-0.0519298676212968,149
"7232","4441142",0.407724189660653,14078,0.45871801286068,14130,-0.0509938232000264,-52
"7233","1112142",0.803670093262314,290,0.81039497277407,334,-0.00672487951175615,-44
"7234","2112142",0.740446920754125,921,0.754020488133247,1024,-0.0135735673791217,-103
"7235","3112142",0.697332711940622,1766,0.725226654933468,1668,-0.0278939429928458,98
"7236","4112142",0.655858381240082,2951,0.682816279811657,3013,-0.0269578985715753,-62
"7237","1212142",0.749712315669318,789,0.755090693828364,1006,-0.00537837815904596,-217
"7238","2212142",0.686489143161129,2046,0.698716209187541,2452,-0.0122270660264115,-406
"7239","3212142",0.643374934347626,3422,0.669922375987761,3513,-0.0265474416401356,-91
"7240","4212142",0.601900603647086,5137,0.627512000865951,5536,-0.0256113972188653,-399
"7241","1312142",0.721732845392542,1239,0.728040126495066,1585,-0.00630728110252421,-346
"7242","2312142",0.658509672884353,2874,0.671665641854243,3451,-0.0131559689698898,-577
"7243","3312142",0.61539546407085,4533,0.642871808654463,4769,-0.0274763445836138,-236
"7244","4312142",0.57392113337031,6483,0.600461433532653,7035,-0.0265403001623435,-552
"7245","1412142",0.682796347407546,2142,0.68741062252696,2837,-0.00461427511941437,-695
"7246","2412142",0.619573174899357,4356,0.631036137886137,5359,-0.0114629629867801,-1003
"7247","3412142",0.576458966085854,6361,0.602242304686358,6921,-0.0257833386005041,-560
"7248","4412142",0.534984635385314,8465,0.559831929564547,9349,-0.0248472941792338,-884
"7249","1122142",0.735690822395894,1000,0.749825661116664,1104,-0.0141348387207694,-104
"7250","2122142",0.672467649887705,2432,0.69345117647584,2625,-0.020983526588135,-193
"7251","3122142",0.629353441074202,3946,0.664657343276061,3765,-0.035303902201859,181
"7252","4122142",0.587879110373662,5779,0.62224696815425,5816,-0.0343678577805885,-37
"7253","1222142",0.681733044802898,2177,0.694521382170957,2590,-0.0127883373680592,-413
"7254","2222142",0.618509872294709,4406,0.638146897530134,5035,-0.0196370252354248,-629
"7255","3222142",0.575395663481206,6406,0.609353064330355,6530,-0.0339574008491488,-124
"7256","4222142",0.533921332780666,8512,0.566942689208544,8942,-0.0330213564278785,-430
"7257","1322142",0.653753574526122,3042,0.66747081483766,3631,-0.0137172403115374,-589
"7258","2322142",0.590530402017933,5662,0.611096330196836,6433,-0.020565928178903,-771
"7259","3322142",0.54741619320443,7817,0.582302496997057,8067,-0.034886303792627,-250
"7260","4322142",0.50594186250389,9950,0.539892121875246,10480,-0.0339502593713568,-530
"7261","1422142",0.614817076541126,4562,0.626841310869554,5572,-0.0120242343284276,-1010
"7262","2422142",0.551593904032937,7619,0.57046682622873,8755,-0.0188729221957933,-1136
"7263","3422142",0.508479695219434,9825,0.541672993028951,10378,-0.0331932978095173,-553
"7264","4422142",0.467005364518894,11813,0.499262617907141,12532,-0.032257253388247,-719
"7265","1132142",0.692358300230795,1898,0.711360568668635,2035,-0.01900226843784,-137
"7266","2132142",0.629135127722606,3958,0.654986084027811,4191,-0.0258509563052056,-233
"7267","3132142",0.586020918909102,5890,0.626192250828032,5607,-0.0401713319189296,283
"7268","4132142",0.544546588208562,7990,0.583781875706222,7961,-0.0392352874976594,29
"7269","1232142",0.638400522637798,3623,0.656056289722929,4141,-0.0176557670851301,-518
"7270","2232142",0.57517735012961,6426,0.599681805082105,7075,-0.0245044549524956,-649
"7271","3232142",0.532063141316106,8621,0.570887971882326,8731,-0.0388248305662197,-110
"7272","4232142",0.490588810615566,10704,0.528477596760515,11077,-0.0378887861449492,-373
"7273","1332142",0.610421052361022,4778,0.629005722389631,5453,-0.0185846700286083,-675
"7274","2332142",0.547197879852833,7839,0.572631237748807,8614,-0.0254333578959739,-775
"7275","3332142",0.50408367103933,10058,0.543837404549028,10247,-0.0397537335096979,-189
"7276","4332142",0.46260934033879,12015,0.501427029427218,12423,-0.0388176890884274,-408
"7277","1432142",0.571484554376026,6615,0.588376218421525,7693,-0.0168916640454985,-1078
"7278","2432142",0.508261381867837,9842,0.532001733780702,10891,-0.0237403519128642,-1049
"7279","3432142",0.465147173054334,11900,0.503207900580922,12337,-0.0380607275265882,-437
"7280","4432142",0.423672842353794,13558,0.460797525459112,14057,-0.0371246831053177,-499
"7281","1142142",0.643324735775965,3425,0.670962074541551,3473,-0.0276373387655856,-48
"7282","2142142",0.580101563267776,6201,0.614587589900727,6231,-0.0344860266329512,-30
"7283","3142142",0.536987354454273,8371,0.585793756700948,7844,-0.0488064022466752,527
"7284","4142142",0.495513023753733,10466,0.543383381579138,10267,-0.0478703578254047,199
"7285","1242142",0.589366958182969,5719,0.615657795595844,6184,-0.0262908374128754,-465
"7286","2242142",0.52614378567478,8954,0.559283310955021,9376,-0.033139525280241,-422
"7287","3242142",0.483029576861277,11093,0.530489477755242,10975,-0.047459900893965,118
"7288","4242142",0.441555246160737,12880,0.488079102633431,13019,-0.0465238564726947,-139
"7289","1342142",0.561387487906193,7096,0.588607228262547,7682,-0.0272197403563537,-586
"7290","2342142",0.498164315398004,10357,0.532232743621723,10880,-0.0340684282237192,-523
"7291","3342142",0.4550501065845,12336,0.503438910421944,12324,-0.0483888038374433,12
"7292","4342142",0.41357577588396,13881,0.461028535300133,14050,-0.0474527594161729,-169
"7293","1442142",0.522450989921197,9124,0.547977724294441,10010,-0.0255267343732438,-886
"7294","2442142",0.459227817413008,12178,0.491603239653618,12863,-0.0323754222406095,-685
"7295","3442142",0.416113608599504,13810,0.462809406453838,13983,-0.0466957978543336,-173
"7296","4442142",0.374639277898965,14949,0.420399031332028,15193,-0.0457597534330632,-244
"7297","1113142",0.764786917689829,613,0.784898382384831,580,-0.0201114646950028,33
"7298","2113142",0.70156374518164,1665,0.728523897744008,1572,-0.0269601525623684,93
"7299","3113142",0.658449536368136,2876,0.699730064544229,2418,-0.0412805281760924,458
"7300","4113142",0.616975205667596,4462,0.657319689422418,4091,-0.0403444837548219,371
"7301","1213142",0.710829140096833,1451,0.729594103439125,1538,-0.0187649633422926,-87
"7302","2213142",0.647605967588644,3281,0.673219618798302,3385,-0.0256136512096582,-104
"7303","3213142",0.60449175877514,5031,0.644425785598522,4677,-0.0399340268233822,354
"7304","4213142",0.5630174280746,7013,0.602015410476712,6931,-0.0389979824021119,82
"7305","1313142",0.682849669820056,2139,0.702543536105827,2336,-0.0196938662857709,-197
"7306","2313142",0.619626497311867,4354,0.646169051465004,4599,-0.0265425541531364,-245
"7307","3313142",0.576512288498364,6359,0.617375218265224,6083,-0.0408629297668605,276
"7308","4313142",0.535037957797824,8462,0.574964843143414,8490,-0.0399268853455902,-28
"7309","1413142",0.64391317183506,3400,0.661914032137721,3890,-0.018000860302661,-490
"7310","2413142",0.580689999326871,6165,0.605539547496898,6732,-0.0248495481700267,-567
"7311","3413142",0.537575790513368,8345,0.576745714297119,8386,-0.0391699237837507,-41
"7312","4413142",0.496101459812828,10451,0.534335339175308,10774,-0.0382338793624805,-323
"7313","1123142",0.696807646823409,1782,0.724329070727425,1692,-0.027521423904016,90
"7314","2123142",0.63358447431522,3792,0.667954586086601,3615,-0.0343701117713816,177
"7315","3123142",0.590470265501716,5667,0.639160752886822,4975,-0.0486904873851056,692
"7316","4123142",0.548995934801176,7746,0.596750377765011,7252,-0.0477544429638351,494
"7317","1223142",0.642849869230413,3448,0.669024791781718,3565,-0.0261749225513058,-117
"7318","2223142",0.579626696722224,6224,0.612650307140895,6354,-0.0330236104186714,-130
"7319","3223142",0.53651248790872,8394,0.583856473941116,7956,-0.0473439860323954,438
"7320","4223142",0.49503815720818,10497,0.541446098819305,10395,-0.0464079416111252,102
"7321","1323142",0.614870398953636,4559,0.64197422444842,4817,-0.0271038254947841,-258
"7322","2323142",0.551647226445448,7618,0.585599739807597,7856,-0.0339525133621497,-238
"7323","3323142",0.508533017631944,9820,0.556805906607818,9521,-0.0482728889758737,299
"7324","4323142",0.467058686931404,11810,0.514395531486007,11813,-0.0473368445546034,-3
"7325","1423142",0.57593390096864,6387,0.601344720480315,6976,-0.0254108195116742,-589
"7326","2423142",0.512710728460452,9642,0.544970235839491,10171,-0.0322595073790399,-529
"7327","3423142",0.469596519646948,11712,0.516176402639712,11707,-0.0465798829927639,5
"7328","4423142",0.428122188946408,13398,0.473766027517902,13611,-0.0456438385714936,-213
"7329","1133142",0.653475124658309,3062,0.685863978279396,2896,-0.0323888536210867,166
"7330","2133142",0.59025195215012,5683,0.629489493638572,5435,-0.0392375414884523,248
"7331","3133142",0.547137743336617,7845,0.600695660438793,7024,-0.0535579171021763,821
"7332","4133142",0.505663412636077,9969,0.558285285316983,9432,-0.052621872680906,537
"7333","1233142",0.599517347065313,5253,0.63055969933369,5377,-0.0310423522683767,-124
"7334","2233142",0.536294174557124,8410,0.574185214692866,8537,-0.0378910401357423,-127
"7335","3233142",0.49317996574362,10591,0.545391381493087,10148,-0.0522114157494663,443
"7336","4233142",0.451705635043081,12471,0.502981006371276,12346,-0.0512753713281958,125
"7337","1333142",0.571537876788537,6608,0.603509132000392,6849,-0.031971255211855,-241
"7338","2333142",0.508314704280348,9840,0.547134647359568,10048,-0.0388199430792205,-208
"7339","3333142",0.465200495466844,11896,0.518340814159789,11595,-0.0531403186929446,301
"7340","4333142",0.423726164766304,13556,0.475930439037978,13511,-0.052204274271674,45
"7341","1433142",0.532601378803541,8593,0.562879628032286,9171,-0.0302782492287451,-578
"7342","2433142",0.469378206295352,11724,0.506505143391463,12184,-0.0371269370961108,-460
"7343","3433142",0.426263997481848,13464,0.477711310191683,13435,-0.0514473127098348,29
"7344","4433142",0.384789666781308,14711,0.435300935069873,14837,-0.0505112682885643,-126
"7345","1143142",0.604441560203479,5035,0.645465484152312,4629,-0.0410239239488323,406
"7346","2143142",0.54121838769529,8164,0.589090999511488,7652,-0.0478726118161978,512
"7347","3143142",0.498104178881787,10360,0.560297166311709,9310,-0.0621929874299219,1050
"7348","4143142",0.456629848181247,12274,0.517886791189899,11618,-0.0612569430086514,656
"7349","1243142",0.550483782610483,7682,0.590161205206605,7593,-0.0396774225961221,89
"7350","2243142",0.487260610102294,10897,0.533786720565782,10803,-0.0465261104634876,94
"7351","3243142",0.444146401288791,12796,0.504992887366003,12245,-0.0608464860772116,551
"7352","4243142",0.402672070588251,14228,0.462582512244192,13993,-0.0599104416559413,235
"7353","1343142",0.522504312333707,9120,0.563110637873308,9156,-0.0406063255396003,-36
"7354","2343142",0.459281139825518,12176,0.506736153232484,12175,-0.0474550134069659,1
"7355","3343142",0.416166931012015,13807,0.477942320032705,13421,-0.0617753890206899,386
"7356","4343142",0.374692600311475,14948,0.435531944910894,14830,-0.0608393445994196,118
"7357","1443142",0.483567814348711,11073,0.522481133905202,11375,-0.0389133195564905,-302
"7358","2443142",0.420344641840522,13679,0.466106649264379,13883,-0.0457620074238561,-204
"7359","3443142",0.377230433027019,14903,0.437312816064599,14775,-0.0600823830375801,128
"7360","4443142",0.335756102326479,15658,0.394902440942789,15660,-0.0591463386163098,-2
"7361","1114142",0.712579845719259,1417,0.740247769011176,1314,-0.0276679232919166,103
"7362","2114142",0.64935667321107,3219,0.683873284370352,2973,-0.0345166111592822,246
"7363","3114142",0.606242464397567,4968,0.655079451170573,4187,-0.0488369867730062,781
"7364","4114142",0.564768133697026,6940,0.612669076048762,6353,-0.0479009423517359,587
"7365","1214142",0.658622068126263,2865,0.684943490065469,2930,-0.0263214219392066,-65
"7366","2214142",0.595398895618074,5454,0.628569005424646,5472,-0.0331701098065722,-18
"7367","3214142",0.55228468680457,7582,0.599775172224867,7067,-0.0474904854202962,515
"7368","4214142",0.51081035610403,9729,0.557364797103056,9486,-0.0465544409990257,243
"7369","1314142",0.630642597849487,3887,0.657892922732171,4058,-0.0272503248826849,-171
"7370","2314142",0.567419425341298,6825,0.601518438091348,6961,-0.0340990127500505,-136
"7371","3314142",0.524305216527794,9033,0.572724604891569,8608,-0.0484193883637745,425
"7372","4314142",0.482830885827254,11103,0.530314229769758,10986,-0.047483343942504,117
"7373","1414142",0.59170609986449,5596,0.617263418764066,6093,-0.025557318899575,-497
"7374","2414142",0.528482927356302,8813,0.560888934123242,9269,-0.0324060067669407,-456
"7375","3414142",0.485368718542798,10981,0.532095100923463,10884,-0.0467263823806647,97
"7376","4414142",0.443894387842258,12806,0.489684725801653,12948,-0.0457903379593943,-142
"7377","1124142",0.644600574852839,3379,0.679678457353769,3154,-0.0350778825009298,225
"7378","2124142",0.58137740234465,6127,0.623303972712945,5765,-0.0419265703682954,362
"7379","3124142",0.538263193531147,8315,0.594510139513166,7370,-0.0562469459820194,945
"7380","4124142",0.496788862830607,10417,0.552099764391356,9792,-0.0553109015607491,625
"7381","1224142",0.590642797259843,5651,0.624374178408063,5700,-0.0337313811482198,-49
"7382","2224142",0.527419624751654,8874,0.567999693767239,8887,-0.0405800690155854,-13
"7383","3224142",0.48430541593815,11025,0.53920586056746,10513,-0.0549004446293094,512
"7384","4224142",0.44283108523761,12835,0.496795485445649,12631,-0.053964400208039,204
"7385","1324142",0.562663326983067,7028,0.597323611074765,7218,-0.0346602840916981,-190
"7386","2324142",0.499440154474878,10295,0.540949126433941,10425,-0.0415089719590637,-130
"7387","3324142",0.456325945661374,12287,0.512155293234162,11924,-0.0558293475727877,363
"7388","4324142",0.414851614960834,13852,0.469744918112352,13773,-0.0548933031515172,79
"7389","1424142",0.523726828998071,9055,0.556694107106659,9532,-0.0329672781085882,-477
"7390","2424142",0.460503656489882,12118,0.500319622465836,12478,-0.0398159659759539,-360
"7391","3424142",0.417389447676378,13772,0.471525789266056,13705,-0.0541363415896779,67
"7392","4424142",0.375915116975838,14926,0.429115414144246,15000,-0.0532002971684075,-74
"7393","1134142",0.601268052687739,5179,0.64121336490574,4862,-0.0399453122180007,317
"7394","2134142",0.53804488017955,8329,0.584838880264917,7895,-0.0467940000853663,434
"7395","3134142",0.494930671366047,10504,0.556045047065137,9570,-0.0611143756990903,934
"7396","4134142",0.453456340665507,12412,0.513634671943327,11849,-0.0601783312778199,563
"7397","1234142",0.547310275094743,7828,0.585909085960034,7840,-0.0385988108652905,-12
"7398","2234142",0.484087102586554,11046,0.52953460131921,11027,-0.0454474987326561,19
"7399","3234142",0.440972893773051,12907,0.500740768119431,12455,-0.0597678743463801,452
"7400","4234142",0.399498563072511,14309,0.458330392997621,14143,-0.0588318299251098,166
"7401","1334142",0.519330804817967,9263,0.558858518626736,9403,-0.0395277138087687,-140
"7402","2334142",0.456107632309778,12304,0.502484033985912,12368,-0.0463764016761343,-64
"7403","3334142",0.412993423496275,13906,0.473690200786133,13614,-0.0606967772898584,292
"7404","4334142",0.371519092795735,15018,0.431279825664323,14953,-0.059760732868588,65
"7405","1434142",0.480394306832971,11203,0.51822901465863,11603,-0.0378347078256589,-400
"7406","2434142",0.417171134324782,13784,0.461854530017807,14019,-0.0446833956930247,-235
"7407","3434142",0.374056925511279,14964,0.433060696818027,14890,-0.0590037713067487,74
"7408","4434142",0.332582594810739,15696,0.390650321696217,15724,-0.0580677268854783,-28
"7409","1144142",0.55223448823291,7588,0.600814870778656,7014,-0.048580382545746,574
"7410","2144142",0.489011315724721,10798,0.544440386137833,10213,-0.0554290704131116,585
"7411","3144142",0.445897106911217,12720,0.515646552938053,11741,-0.0697494460268357,979
"7412","4144142",0.404422776210677,14179,0.473236177816243,13636,-0.0688134016055653,543
"7413","1244142",0.498276710639914,10350,0.54551059183295,10140,-0.0472338811930361,210
"7414","2244142",0.435053538131725,13146,0.489136107192126,12969,-0.0540825690604016,177
"7415","3244142",0.391939329318221,14543,0.460342273992347,14069,-0.0684029446741256,474
"7416","4244142",0.350464998617681,15432,0.417931898870537,15238,-0.0674669002528552,194
"7417","1344142",0.470297240363137,11678,0.518460024499652,11589,-0.0481627841365143,89
"7418","2344142",0.407074067854949,14099,0.462085539858828,14011,-0.0550114720038798,88
"7419","3344142",0.363959859041445,15183,0.433291706659049,14884,-0.0693318476176039,299
"7420","4344142",0.322485528340905,15818,0.390881331537239,15720,-0.0683958031963335,98
"7421","1444142",0.431360742378141,13291,0.477830520531546,13428,-0.0464697781534044,-137
"7422","2444142",0.368137569869953,15097,0.421456035890723,15159,-0.0533184660207701,-62
"7423","3444142",0.325023361056449,15790,0.392662202690943,15688,-0.0676388416344942,102
"7424","4444142",0.283549030355909,16147,0.350251827569133,16133,-0.0667027972132238,14
"7425","1111242",0.790906170875793,371,0.80337910764794,397,-0.0124729367721476,-26
"7426","2111242",0.727682998367604,1121,0.747004623007117,1170,-0.0193216246395131,-49
"7427","3111242",0.684568789554101,2090,0.718210789807338,1854,-0.0336420002532372,236
"7428","4111242",0.643094458853561,3436,0.675800414685527,3297,-0.0327059558319667,139
"7429","1211242",0.736948393282797,978,0.748074828702234,1146,-0.0111264354194374,-168
"7430","2211242",0.673725220774608,2393,0.691700344061411,2684,-0.017975123286803,-291
"7431","3211242",0.630611011961105,3888,0.662906510861632,3844,-0.032295498900527,44
"7432","4211242",0.589136681260565,5727,0.620496135739821,5916,-0.0313594544792567,-189
"7433","1311242",0.708968923006021,1496,0.721024261368936,1779,-0.0120553383629156,-283
"7434","2311242",0.645745750497832,3339,0.664649776728113,3767,-0.0189040262302812,-428
"7435","3311242",0.602631541684328,5105,0.635855943528334,5130,-0.0332244018440052,-25
"7436","4311242",0.561157210983788,7112,0.593445568406523,7435,-0.032288357422735,-323
"7437","1411242",0.670032425021025,2504,0.68039475740083,3119,-0.0103623323798058,-615
"7438","2411242",0.606809252512836,4938,0.624020272760007,5721,-0.0172110202471715,-783
"7439","3411242",0.563695043699332,6972,0.595226439560228,7333,-0.0315313958608955,-361
"7440","4411242",0.522220712998792,9139,0.552816064438418,9759,-0.0305953514396252,-620
"7441","1121242",0.722926900009373,1213,0.742809795990534,1251,-0.0198828959811608,-38
"7442","2121242",0.659703727501184,2821,0.68643531134971,2875,-0.0267315838485264,-54
"7443","3121242",0.616589518687681,4477,0.657641478149931,4073,-0.0410519594622504,404
"7444","4121242",0.575115187987141,6431,0.615231103028121,6200,-0.0401159150409799,231
"7445","1221242",0.668969122416377,2543,0.687505517044828,2831,-0.0185363946284506,-288
"7446","2221242",0.605745949908188,4980,0.631131032404004,5353,-0.0253850824958162,-373
"7447","3221242",0.562631741094685,7029,0.602337199204225,6913,-0.0397054581095402,116
"7448","4221242",0.521157410394145,9191,0.559926824082414,9339,-0.0387694136882699,-148
"7449","1321242",0.640989652139601,3525,0.66045494971153,3950,-0.0194652975719288,-425
"7450","2321242",0.577766479631412,6307,0.604080465070706,6821,-0.0263139854392944,-514
"7451","3321242",0.534652270817908,8480,0.575286631870927,8474,-0.0406343610530184,6
"7452","4321242",0.493177940117368,10592,0.532876256749117,10854,-0.0396983166317482,-262
"7453","1421242",0.602053154154605,5130,0.619825445743424,5947,-0.017772291588819,-817
"7454","2421242",0.538829981646416,8288,0.563450961102601,9132,-0.0246209794561847,-844
"7455","3421242",0.495715772832912,10461,0.534657127902821,10755,-0.0389413550699087,-294
"7456","4421242",0.454241442132372,12378,0.492246752781011,12839,-0.0380053106486384,-461
"7457","1131242",0.679594377844273,2240,0.704344703542505,2267,-0.0247503256982314,-27
"7458","2131242",0.616371205336085,4485,0.647970218901682,4506,-0.031599013565597,-21
"7459","3131242",0.573256996522581,6526,0.619176385701902,5984,-0.045919389179321,542
"7460","4131242",0.531782665822041,8635,0.576766010580092,8384,-0.0449833447580508,251
"7461","1231242",0.625636600251277,4092,0.649040424596799,4456,-0.0234038243455215,-364
"7462","2231242",0.562413427743088,7042,0.592665939955975,7472,-0.030252512212887,-430
"7463","3231242",0.519299218929585,9268,0.563872106756196,9112,-0.0445728878266111,156
"7464","4231242",0.477824888229045,11333,0.521461731634386,11425,-0.0436368434053406,-92
"7465","1331242",0.597657129974501,5341,0.621989857263501,5828,-0.0243327272889997,-487
"7466","2331242",0.534433957466312,8492,0.565615372622677,9008,-0.0311814151563653,-516
"7467","3331242",0.491319748652809,10674,0.536821539422898,10647,-0.0455017907700893,27
"7468","4331242",0.449845417952269,12553,0.494411164301088,12739,-0.0445657463488189,-186
"7469","1431242",0.558720631989505,7237,0.581360353295395,8114,-0.0226397213058899,-877
"7470","2431242",0.495497459481316,10467,0.524985868654572,11248,-0.0294884091732556,-781
"7471","3431242",0.452383250667813,12449,0.496192035454792,12661,-0.0438087847869795,-212
"7472","4431242",0.410908919967273,13966,0.453781660332982,14294,-0.0428727403657091,-328
"7473","1141242",0.630560813389444,3891,0.663946209415421,3801,-0.033385396025977,90
"7474","2141242",0.567337640881255,6827,0.607571724774598,6627,-0.0402340838933426,200
"7475","3141242",0.524223432067751,9036,0.578777891574818,8272,-0.0545544595070666,764
"7476","4141242",0.482749101367212,11105,0.536367516453008,10666,-0.0536184150857961,439
"7477","1241242",0.576603035796448,6356,0.608641930469715,6576,-0.0320388946732668,-220
"7478","2241242",0.513379863288259,9603,0.552267445828891,9782,-0.0388875825406324,-179
"7479","3241242",0.470265654474755,11679,0.523473612629112,11322,-0.0532079581543564,357
"7480","4241242",0.428791323774215,13383,0.481063237507302,13294,-0.0522719137330861,89
"7481","1341242",0.548623565519672,7759,0.581591363136417,8097,-0.0329677976167451,-338
"7482","2341242",0.485400393011483,10980,0.525216878495593,11237,-0.0398164854841107,-257
"7483","3341242",0.442286184197979,12858,0.496423045295814,12651,-0.0541368610978347,207
"7484","4341242",0.400811853497439,14286,0.454012670174004,14286,-0.0532008166765643,0
"7485","1441242",0.509687067534676,9770,0.540961859168311,10424,-0.0312747916336352,-654
"7486","2441242",0.446463895026487,12697,0.484587374527488,13157,-0.038123479501001,-460
"7487","3441242",0.403349686212983,14207,0.455793541327708,14222,-0.052443855114725,-15
"7488","4441242",0.361875355512443,15227,0.413383166205898,15343,-0.0515078106934546,-116
"7489","1112242",0.757821259114104,688,0.765060126119288,856,-0.00723886700518439,-168
"7490","2112242",0.694598086605915,1825,0.708685641478465,2125,-0.01408755487255,-300
"7491","3112242",0.651483877792412,3140,0.679891808278686,3144,-0.028407930486274,-4
"7492","4112242",0.610009547091872,4798,0.637481433156875,5063,-0.0274718860650035,-265
"7493","1212242",0.703863481521108,1613,0.709755847173582,2093,-0.0058923656524742,-480
"7494","2212242",0.640640309012919,3537,0.653381362532759,4268,-0.0127410535198398,-731
"7495","3212242",0.597526100199416,5349,0.62458752933298,5692,-0.0270614291335638,-343
"7496","4212242",0.556051769498876,7397,0.582177154211169,8074,-0.0261253847122935,-677
"7497","1312242",0.675884011244332,2344,0.682705279840284,3017,-0.00682126859595245,-673
"7498","2312242",0.612660838736143,4677,0.626330795199461,5600,-0.013669956463318,-923
"7499","3312242",0.56954662992264,6720,0.597536961999682,7210,-0.027990332077042,-490
"7500","4312242",0.528072299222099,8844,0.555126586877871,9618,-0.0270542876557718,-774
"7501","1412242",0.636947513259336,3675,0.642075775872178,4810,-0.0051282626128426,-1135
"7502","2412242",0.573724340751147,6492,0.585701291231355,7847,-0.0119769504802083,-1355
"7503","3412242",0.530610131937644,8702,0.556907458031576,9515,-0.0262973260939323,-813
"7504","4412242",0.489135801237103,10794,0.514497082909765,11807,-0.025361281672662,-1013
"7505","1122242",0.689841988247684,1949,0.704490814461882,2263,-0.0146488262141976,-314
"7506","2122242",0.626618815739495,4049,0.648116329821058,4497,-0.0214975140815632,-448
"7507","3122242",0.583504606925992,6028,0.619322496621279,5979,-0.0358178896952872,49
"7508","4122242",0.542030276225452,8122,0.576912121499469,8378,-0.0348818452740167,-256
"7509","1222242",0.635884210654688,3716,0.649186535516175,4450,-0.0133023248614874,-734
"7510","2222242",0.572661038146499,6548,0.592812050875352,7467,-0.020151012728853,-919
"7511","3222242",0.529546829332996,8755,0.564018217675573,9106,-0.034471388342577,-351
"7512","4222242",0.488072498632456,10853,0.521607842553762,11416,-0.0335353439213067,-563
"7513","1322242",0.607904740377912,4896,0.622135968182878,5824,-0.0142312278049657,-928
"7514","2322242",0.544681567869723,7983,0.565761483542054,9001,-0.0210799156723313,-1018
"7515","3322242",0.50156735905622,10193,0.536967650342275,10640,-0.0354002912860553,-447
"7516","4322242",0.460093028355679,12137,0.494557275220464,12735,-0.034464246864785,-598
"7517","1422242",0.568968242392916,6737,0.581506464214772,8103,-0.0125382218218558,-1366
"7518","2422242",0.505745069884727,9962,0.525131979573949,11241,-0.0193869096892215,-1279
"7519","3422242",0.462630861071224,12012,0.496338146374169,12656,-0.0337072853029455,-644
"7520","4422242",0.421156530370684,13646,0.453927771252359,14290,-0.0327712408816752,-644
"7521","1132242",0.646509466082585,3319,0.666025722013853,3695,-0.0195162559312683,-376
"7522","2132242",0.583286293574396,6036,0.60965123737303,6513,-0.0263649437986339,-477
"7523","3132242",0.540172084760892,8225,0.58085740417325,8140,-0.0406853194123579,85
"7524","4132242",0.498697754060352,10328,0.53844702905144,10556,-0.0397492749910876,-228
"7525","1232242",0.592551688489588,5568,0.610721443068147,6450,-0.0181697545785583,-882
"7526","2232242",0.529328515981399,8777,0.554346958427323,9662,-0.0250184424459239,-885
"7527","3232242",0.486214307167896,10946,0.525553125227544,11223,-0.0393388180596479,-277
"7528","4232242",0.444739976467356,12770,0.483142750105733,13214,-0.0384027736383775,-444
"7529","1332242",0.564572218212812,6946,0.583670875734849,7970,-0.0190986575220365,-1024
"7530","2332242",0.501349045704623,10207,0.527296391094025,11129,-0.0259473453894021,-922
"7531","3332242",0.45823483689112,12222,0.498502557894246,12565,-0.0402677210031261,-343
"7532","4332242",0.41676050619058,13790,0.456092182772436,14207,-0.0393316765818557,-417
"7533","1432242",0.525635720227816,8971,0.543041371766743,10284,-0.0174056515389267,-1313
"7534","2432242",0.462412547719627,12023,0.48666688712592,13068,-0.0242543394062924,-1045
"7535","3432242",0.419298338906124,13719,0.45787305392614,14154,-0.0385747150200164,-435
"7536","4432242",0.377824008205584,14890,0.41546267880433,15293,-0.037638670598746,-403
"7537","1142242",0.597475901627755,5352,0.625627227886769,5633,-0.0281513262590138,-281
"7538","2142242",0.534252729119566,8499,0.569252743245945,8816,-0.0350000141263794,-317
"7539","3142242",0.491138520306063,10684,0.540458910046166,10454,-0.0493203897401034,230
"7540","4142242",0.449664189605523,12562,0.498048534924356,12580,-0.048384345318833,-18
"7541","1242242",0.543518124034759,8040,0.570322948941063,8762,-0.0268048249063036,-722
"7542","2242242",0.48029495152657,11206,0.513948464300239,11834,-0.0336535127736692,-628
"7543","3242242",0.437180742713066,13049,0.48515463110046,13133,-0.0479738883873933,-84
"7544","4242242",0.395706412012526,14423,0.442744255978649,14641,-0.0470378439661229,-218
"7545","1342242",0.515538653757983,9495,0.543272381607765,10273,-0.0277337278497819,-778
"7546","2342242",0.452315481249794,12452,0.486897896966941,13055,-0.0345824157171475,-603
"7547","3342242",0.40920127243629,14025,0.458104063767162,14149,-0.0489027913308716,-124
"7548","4342242",0.36772694173575,15105,0.415693688645352,15284,-0.0479667469096012,-179
"7549","1442242",0.476602155772987,11396,0.502642877639659,12361,-0.0260407218666721,-965
"7550","2442242",0.413378983264798,13889,0.446268392998836,14534,-0.0328894097340378,-645
"7551","3442242",0.370264774451294,15046,0.417474559799056,15250,-0.0472097853477618,-204
"7552","4442242",0.328790443750754,15747,0.375064184677246,15925,-0.0462737409264914,-178
"7553","1113242",0.718938083541618,1288,0.739563535730049,1328,-0.020625452188431,-40
"7554","2113242",0.65571491103343,2955,0.683189051089226,3002,-0.0274741400557966,-47
"7555","3113242",0.612600702219926,4679,0.654395217889447,4220,-0.0417945156695206,459
"7556","4113242",0.571126371519386,6633,0.611984842767636,6396,-0.0408584712482501,237
"7557","1213242",0.664980305948622,2661,0.684259256784343,2959,-0.0192789508357208,-298
"7558","2213242",0.601757133440433,5142,0.62788477214352,5512,-0.0261276387030864,-370
"7559","3213242",0.55864292462693,7244,0.59909093894374,7111,-0.0404480143168104,133
"7560","4213242",0.51716859392639,9404,0.55668056382193,9533,-0.0395119698955402,-129
"7561","1313242",0.637000835671846,3673,0.657208689451045,4095,-0.0202078537791991,-422
"7562","2313242",0.573777663163657,6490,0.600834204810222,7012,-0.0270565416465647,-522
"7563","3313242",0.530663454350154,8701,0.572040371610443,8655,-0.0413769172602887,46
"7564","4313242",0.489189123649614,10790,0.529629996488632,11022,-0.0404408728390184,-232
"7565","1413242",0.59806433768685,5319,0.61657918548294,6135,-0.0185148477960893,-816
"7566","2413242",0.534841165178661,8468,0.560204700842116,9316,-0.025363535663455,-848
"7567","3413242",0.491726956365158,10656,0.531410867642337,10921,-0.039683911277179,-265
"7568","4413242",0.450252625664618,12535,0.489000492520526,12982,-0.0387478668559086,-447
"7569","1123242",0.650958812675198,3155,0.678994224072643,3176,-0.0280354113974443,-21
"7570","2123242",0.58773564016701,5786,0.622619739431819,5802,-0.0348840992648098,-16
"7571","3123242",0.544621431353506,7987,0.59382590623204,7417,-0.0492044748785339,570
"7572","4123242",0.503147100652966,10114,0.55141553111023,9822,-0.0482684304572634,292
"7573","1223242",0.597001035082202,5372,0.623689945126936,5743,-0.0266889100447341,-371
"7574","2223242",0.533777862574013,8520,0.567315460486113,8921,-0.0335375979120996,-401
"7575","3223242",0.49066365376051,10702,0.538521627286334,10549,-0.0478579735258237,153
"7576","4223242",0.44918932305997,12588,0.496111252164523,12664,-0.0469219291045533,-76
"7577","1323242",0.569021564805426,6734,0.596639377793639,7258,-0.0276178129882123,-524
"7578","2323242",0.505798392297237,9958,0.540264893152815,10462,-0.0344665008555779,-504
"7579","3323242",0.462684183483734,12011,0.511471059953036,11963,-0.0487868764693019,48
"7580","4323242",0.421209852783194,13643,0.469060684831225,13792,-0.0478508320480316,-149
"7581","1423242",0.53008506682043,8730,0.556009873825533,9576,-0.0259248070051025,-846
"7582","2423242",0.466861894312241,11819,0.49963538918471,12513,-0.0327734948724682,-694
"7583","3423242",0.423747685498738,13553,0.47084155598493,13730,-0.0470938704861921,-177
"7584","4423242",0.382273354798198,14776,0.42843118086312,15015,-0.0461578260649219,-239
"7585","1133242",0.607626290510099,4909,0.640529131624614,4893,-0.0329028411145149,16
"7586","2133242",0.54440311800191,7992,0.58415464698379,7940,-0.0397515289818805,52
"7587","3133242",0.501288909188407,10209,0.555360813784011,9610,-0.0540719045956045,599
"7588","4133242",0.459814578487866,12150,0.512950438662201,11880,-0.0531358601743342,270
"7589","1233242",0.553668512917103,7513,0.585224852678908,7873,-0.0315563397618049,-360
"7590","2233242",0.490445340408914,10715,0.528850368038084,11059,-0.0384050276291705,-344
"7591","3233242",0.44733113159541,12665,0.500056534838305,12494,-0.0527254032428945,171
"7592","4233242",0.40585680089487,14140,0.457646159716494,14159,-0.051789358821624,-19
"7593","1333242",0.525689042640326,8966,0.55817428534561,9435,-0.0324852427052832,-469
"7594","2333242",0.462465870132138,12021,0.501799800704786,12407,-0.0393339305726488,-386
"7595","3333242",0.419351661318634,13717,0.473005967505007,13648,-0.0536543061863727,69
"7596","4333242",0.377877330618094,14888,0.430595592383197,14962,-0.0527182617651022,-74
"7597","1433242",0.48675254465533,10918,0.517544781377504,11636,-0.0307922367221733,-718
"7598","2433242",0.423529372147142,13559,0.461170296736681,14044,-0.037640924589539,-485
"7599","3433242",0.380415163333638,14826,0.432376463536901,14920,-0.051961300203263,-94
"7600","4433242",0.338940832633098,15615,0.389966088415091,15732,-0.0510252557819925,-117
"7601","1143242",0.558592726055269,7249,0.60013063749753,7049,-0.0415379114422605,200
"7602","2143242",0.49536955354708,10472,0.543756152856706,10249,-0.0483865993096261,223
"7603","3143242",0.452255344733577,12453,0.514962319656927,11780,-0.06270697492335,673
"7604","4143242",0.410781014033037,13974,0.472551944535117,13664,-0.0617709305020795,310
"7605","1243242",0.504634948462273,10026,0.544826358551823,10183,-0.0401914100895503,-157
"7606","2243242",0.441411775954084,12885,0.488451873911,12999,-0.0470400979569158,-114
"7607","3243242",0.398297567140581,14342,0.459658040711221,14094,-0.0613604735706398,248
"7608","4243242",0.356823236440041,15316,0.41724766558941,15254,-0.0604244291493696,62
"7609","1343242",0.476655478185497,11392,0.517775791218526,11625,-0.0411203130330285,-233
"7610","2343242",0.413432305677308,13886,0.461401306577702,14037,-0.0479690009003941,-151
"7611","3343242",0.370318096863805,15044,0.432607473377923,14912,-0.0622893765141181,132
"7612","4343242",0.328843766163265,15744,0.390197098256112,15730,-0.0613533320928478,14
"7613","1443242",0.437718980200501,13030,0.47714628725042,13464,-0.0394273070499186,-434
"7614","2443242",0.374495807692312,14951,0.420771802609597,15182,-0.0462759949172843,-231
"7615","3443242",0.331381598878809,15712,0.391977969409817,15703,-0.0605963705310084,9
"7616","4443242",0.289907268178269,16101,0.349567594288007,16140,-0.059660326109738,-39
"7617","1114242",0.666731011571049,2605,0.694912922356394,2583,-0.0281819107853448,22
"7618","2114242",0.60350783906286,5062,0.63853843771557,5015,-0.0350305986527104,47
"7619","3114242",0.560393630249356,7157,0.609744604515791,6507,-0.0493509742664344,650
"7620","4114242",0.518919299548816,9290,0.56733422939398,8919,-0.0484149298451642,371
"7621","1214242",0.612773233978053,4668,0.639608643410687,4946,-0.0268354094326348,-278
"7622","2214242",0.549550061469864,7718,0.583234158769864,7998,-0.0336840973000004,-280
"7623","3214242",0.50643585265636,9929,0.554440325570085,9657,-0.0480044729137244,272
"7624","4214242",0.46496152195582,11908,0.512029950448274,11931,-0.047068428492454,-23
"7625","1314242",0.584793763701276,5960,0.612558076077389,6359,-0.0277643123761131,-399
"7626","2314242",0.521570591193087,9167,0.556183591436566,9561,-0.0346130002434787,-394
"7627","3314242",0.478456382379584,11300,0.527389758236787,11126,-0.0489333758572027,174
"7628","4314242",0.436982051679044,13061,0.484979383114976,13138,-0.0479973314359323,-77
"7629","1414242",0.54585726571628,7915,0.571928572109284,8662,-0.0260713063930033,-747
"7630","2414242",0.482634093208091,11110,0.51555408746846,11745,-0.032919994260369,-635
"7631","3414242",0.439519884394588,12960,0.486760254268681,13062,-0.0472403698740929,-102
"7632","4414242",0.398045553694048,14354,0.444349879146871,14591,-0.0463043254528225,-237
"7633","1124242",0.598751740704629,5287,0.634343610698987,5219,-0.035591869994358,68
"7634","2124242",0.53552856819644,8439,0.577969126058164,8323,-0.0424405578617236,116
"7635","3124242",0.492414359382936,10626,0.549175292858384,9943,-0.0567609334754476,683
"7636","4124242",0.450940028682396,12510,0.506764917736574,12174,-0.0558248890541773,336
"7637","1224242",0.544793963111633,7974,0.579039331753281,8258,-0.0342453686416481,-284
"7638","2224242",0.481570790603444,11151,0.522664847112457,11363,-0.0410940565090137,-212
"7639","3224242",0.43845658178994,12994,0.493871013912678,12762,-0.0554144321227376,232
"7640","4224242",0.3969822510894,14385,0.451460638790868,14365,-0.0544783877014672,20
"7641","1324242",0.516814492834856,9419,0.551988764419983,9795,-0.0351742715851263,-376
"7642","2324242",0.453591320326668,12405,0.495614279779159,12686,-0.0420229594524918,-281
"7643","3324242",0.410477111513164,13981,0.46682044657938,13856,-0.0563433350662159,125
"7644","4324242",0.369002780812624,15075,0.42441007145757,15099,-0.0554072906449455,-24
"7645","1424242",0.47787799484986,11326,0.511359260451877,11969,-0.0334812656020165,-643
"7646","2424242",0.414654822341672,13858,0.454984775811054,14247,-0.0403299534693821,-389
"7647","3424242",0.371540613528168,15015,0.426190942611274,15055,-0.0546503290831061,-40
"7648","4424242",0.330066282827628,15726,0.383780567489464,15810,-0.0537142846618358,-84
"7649","1134242",0.555419218539529,7432,0.595878518250958,7301,-0.0404592997114289,131
"7650","2134242",0.49219604603134,10633,0.539504033610135,10500,-0.0473079875787945,133
"7651","3134242",0.449081837217837,12593,0.510710200410355,11999,-0.0616283631925185,594
"7652","4134242",0.407607506517297,14081,0.468299825288545,13814,-0.0606923187712481,267
"7653","1234242",0.501461440946533,10200,0.540574239305252,10449,-0.0391127983587187,-249
"7654","2234242",0.438238268438344,13006,0.484199754664428,13174,-0.0459614862260844,-168
"7655","3234242",0.395124059624841,14445,0.455405921464649,14232,-0.0602818618398084,213
"7656","4234242",0.353649728924301,15372,0.412995546342839,15350,-0.059345817418538,22
"7657","1334242",0.473481970669757,11543,0.513523671971954,11856,-0.040041701302197,-313
"7658","2334242",0.410258798161568,13988,0.45714918733113,14175,-0.0468903891695626,-187
"7659","3334242",0.367144589348064,15118,0.428355354131351,15018,-0.0612107647832866,100
"7660","4334242",0.325670258647524,15781,0.385944979009541,15780,-0.0602747203620163,1
"7661","1434242",0.434545472684761,13164,0.472894168003848,13652,-0.0383486953190872,-488
"7662","2434242",0.371322300176572,15020,0.416519683363025,15270,-0.0451973831864529,-250
"7663","3434242",0.328208091363068,15754,0.387725850163245,15759,-0.0595177588001769,-5
"7664","4434242",0.286733760662528,16126,0.345315475041435,16165,-0.0585817143789066,-39
"7665","1144242",0.5063856540847,9934,0.555480024123874,9604,-0.0490943700391743,330
"7666","2144242",0.443162481576511,12820,0.499105539483051,12545,-0.0559430579065399,275
"7667","3144242",0.400048272763007,14299,0.470311706283271,13755,-0.0702634335202639,544
"7668","4144242",0.358573942062467,15282,0.427901331161461,15026,-0.0693273890989936,256
"7669","1244242",0.452427876491703,12442,0.500175745178168,12488,-0.0477478686864642,-46
"7670","2244242",0.389204703983515,14605,0.443801260537344,14609,-0.0545965565538298,-4
"7671","3244242",0.346090495170011,15489,0.415007427337565,15300,-0.0689169321675538,189
"7672","4244242",0.304616164469471,15998,0.372597052215755,15952,-0.0679808877462835,46
"7673","1344242",0.424448406214927,13530,0.47312517784487,13641,-0.0486767716299425,-111
"7674","2344242",0.361225233706738,15236,0.416750693204046,15264,-0.0555254594973081,-28
"7675","3344242",0.318111024893235,15860,0.387956860004267,15757,-0.0698458351110321,103
"7676","4344242",0.276636694192695,16184,0.345546484882457,16162,-0.0689097906897618,22
"7677","1444242",0.385511908229931,14693,0.432495673876764,14916,-0.0469837656468327,-223
"7678","2444242",0.322288735721742,15820,0.376121189235941,15911,-0.0538324535141984,-91
"7679","3444242",0.279174526908239,16170,0.347327356036161,16150,-0.0681528291279224,20
"7680","4444242",0.237700196207699,16317,0.304916980914351,16324,-0.067216784706652,-7
"7681","1111342",0.768452191870485,569,0.785329117720266,577,-0.016876925849781,-8
"7682","2111342",0.705229019362296,1585,0.728954633079443,1561,-0.0237256137171465,24
"7683","3111342",0.662114810548793,2757,0.700160799879663,2401,-0.0380459893308706,356
"7684","4111342",0.620640479848253,4304,0.657750424757853,4065,-0.0371099449096003,239
"7685","1211342",0.714494414277489,1380,0.73002483877456,1529,-0.015530424497071,-149
"7686","2211342",0.6512712417693,3148,0.673650354133736,3364,-0.0223791123644366,-216
"7687","3211342",0.608157032955796,4887,0.644856520933957,4660,-0.0366994879781606,227
"7688","4211342",0.566682702255257,6853,0.602446145812147,6904,-0.0357634435568901,-51
"7689","1311342",0.686514944000713,2043,0.702974271441262,2318,-0.0164593274405492,-275
"7690","2311342",0.623291771492524,4212,0.646599786800439,4578,-0.0233080153079148,-366
"7691","3311342",0.58017756267902,6198,0.617805953600659,6058,-0.0376283909216388,140
"7692","4311342",0.53870323197848,8293,0.575395578478849,8464,-0.0366923465003683,-171
"7693","1411342",0.647578446015717,3284,0.662344767473156,3865,-0.0147663214574394,-581
"7694","2411342",0.584355273507528,5987,0.605970282832333,6700,-0.0216150093248051,-713
"7695","3411342",0.541241064694024,8163,0.577176449632553,8365,-0.0359353849385291,-202
"7696","4411342",0.499766733993484,10277,0.534766074510743,10750,-0.0349993405172586,-473
"7697","1121342",0.700472921004065,1683,0.724759806062859,1679,-0.0242868850587942,4
"7698","2121342",0.637249748495876,3666,0.668385321422036,3598,-0.0311355729261598,68
"7699","3121342",0.594135539682373,5509,0.639591488222256,4947,-0.0454559485398838,562
"7700","4121342",0.552661208981833,7553,0.597181113100446,7223,-0.0445199041186135,330
"7701","1221342",0.646515143411069,3318,0.669455527117153,3540,-0.0229403837060842,-222
"7702","2221342",0.58329197090288,6035,0.61308104247633,6320,-0.0297890715734498,-285
"7703","3221342",0.540177762089376,8224,0.58428720927655,7932,-0.0441094471871738,292
"7704","4221342",0.498703431388837,10326,0.54187683415474,10362,-0.0431734027659033,-36
"7705","1321342",0.618535673134293,4403,0.642404959783855,4791,-0.0238692866495624,-388
"7706","2321342",0.555312500626104,7440,0.586030475143032,7830,-0.030717974516928,-390
"7707","3321342",0.5121982918126,9663,0.557236641943252,9497,-0.045038350130652,166
"7708","4321342",0.47072396111206,11660,0.514826266821442,11787,-0.0441023057093816,-127
"7709","1421342",0.579599175149297,6228,0.601775455815749,6944,-0.0221762806664526,-716
"7710","2421342",0.516376002641108,9446,0.545400971174926,10145,-0.0290249685338183,-699
"7711","3421342",0.473261793827604,11556,0.516607137975147,11686,-0.0433453441475423,-130
"7712","4421342",0.431787463127064,13279,0.474196762853336,13587,-0.0424092997262718,-308
"7713","1131342",0.657140398838965,2919,0.68629471361483,2882,-0.0291543147758651,37
"7714","2131342",0.593917226330776,5513,0.629920228974007,5413,-0.0360030026432306,100
"7715","3131342",0.550803017517273,7662,0.601126395774228,6992,-0.0503233782569547,670
"7716","4131342",0.509328686816733,9783,0.558716020652417,9413,-0.0493873338356842,370
"7717","1231342",0.603182621245969,5083,0.630990434669124,5362,-0.0278078134231549,-279
"7718","2231342",0.53995944873778,8232,0.574615950028301,8513,-0.0346565012905204,-281
"7719","3231342",0.496845239924277,10416,0.545822116828521,10123,-0.0489768769042445,293
"7720","4231342",0.455370909223737,12323,0.503411741706711,12327,-0.0480408324829741,-4
"7721","1331342",0.575203150969193,6424,0.603939867335826,6828,-0.0287367163666331,-404
"7722","2331342",0.511979978461004,9674,0.547565382695003,10028,-0.0355854042339987,-354
"7723","3331342",0.468865769647501,11746,0.518771549495223,11569,-0.0499057798477227,177
"7724","4331342",0.427391438946961,13417,0.476361174373413,13496,-0.0489697354264524,-79
"7725","1431342",0.536266652984197,8413,0.56331036336772,9144,-0.0270437103835233,-731
"7726","2431342",0.473043480476008,11563,0.506935878726897,12165,-0.033892398250889,-602
"7727","3431342",0.429929271662505,13346,0.478142045527118,13414,-0.0482127738646129,-68
"7728","4431342",0.388454940961965,14623,0.435731670405307,14826,-0.0472767294433427,-203
"7729","1141342",0.608106834384136,4889,0.645896219487746,4615,-0.0377893851036104,274
"7730","2141342",0.544883661875947,7968,0.589521734846923,7633,-0.044638072970976,335
"7731","3141342",0.501769453062443,10179,0.560727901647143,9283,-0.0589584485847,896
"7732","4141342",0.460295122361903,12123,0.518317526525333,11596,-0.0580224041634297,527
"7733","1241342",0.55414905679114,7498,0.59059194054204,7568,-0.0364428837509004,-70
"7734","2241342",0.490925884282951,10692,0.534217455901217,10777,-0.043291571618266,-85
"7735","3241342",0.447811675469447,12645,0.505423622701437,12229,-0.05761194723199,416
"7736","4241342",0.406337344768907,14122,0.463013247579627,13976,-0.0566759028107195,146
"7737","1341342",0.526169586514363,8953,0.563541373208742,9126,-0.0373717866943787,-173
"7738","2341342",0.462946414006175,12003,0.507166888567919,12154,-0.0442204745617443,-151
"7739","3341342",0.419832205192671,13703,0.478373055368139,13402,-0.0585408501754682,301
"7740","4341342",0.378357874492131,14877,0.435962680246329,14821,-0.0576048057541977,56
"7741","1441342",0.487233088529367,10901,0.522911869240636,11352,-0.0356787807112688,-451
"7742","2441342",0.424009916021179,13545,0.466537384599813,13866,-0.0425274685786345,-321
"7743","3441342",0.380895707207675,14813,0.437743551400034,14768,-0.0568478441923585,45
"7744","4441342",0.339421376507135,15609,0.395333176278223,15654,-0.055911799771088,-45
"7745","1112342",0.735367280108796,1008,0.747010136191614,1169,-0.0116428560828178,-161
"7746","2112342",0.672144107600607,2442,0.69063565155079,2721,-0.0184915439501834,-279
"7747","3112342",0.629029898787104,3962,0.661841818351011,3894,-0.0328119195639074,68
"7748","4112342",0.587555568086564,5801,0.619431443229201,5970,-0.0318758751426371,-169
"7749","1212342",0.6814095025158,2189,0.691705857245908,2682,-0.0102963547301078,-493
"7750","2212342",0.618186330007611,4421,0.635331372605084,5159,-0.0171450425974734,-738
"7751","3212342",0.575072121194107,6433,0.606537539405305,6672,-0.0314654182111974,-239
"7752","4212342",0.533597790493568,8532,0.564127164283495,9095,-0.0305293737899269,-563
"7753","1312342",0.653430032239024,3064,0.66465528991261,3766,-0.0112252576735861,-702
"7754","2312342",0.590206859730835,5685,0.608280805271786,6591,-0.0180739455409517,-906
"7755","3312342",0.547092650917331,7849,0.579486972072007,8226,-0.0323943211546757,-377
"7756","4312342",0.505618320216791,9971,0.537076596950197,10631,-0.0314582767334052,-660
"7757","1412342",0.614493534254028,4583,0.624025785944504,5719,-0.00953225169047622,-1136
"7758","2412342",0.551270361745839,7639,0.567651301303681,8903,-0.0163809395578419,-1264
"7759","3412342",0.508156152932335,9850,0.538857468103901,10529,-0.0307013151715659,-679
"7760","4412342",0.466681822231795,11829,0.496447092982091,12647,-0.0297652707502954,-818
"7761","1122342",0.667388009242376,2588,0.686440824534207,2874,-0.019052815291831,-286
"7762","2122342",0.604164836734187,5044,0.630066339893384,5407,-0.0259015031591966,-363
"7763","3122342",0.561050627920684,7118,0.601272506693604,6982,-0.0402218787729206,136
"7764","4122342",0.519576297220144,9246,0.558862131571794,9402,-0.0392858343516503,-156
"7765","1222342",0.61343023164938,4641,0.631136545588501,5352,-0.017706313939121,-711
"7766","2222342",0.550207059141191,7696,0.574762060947678,8506,-0.0245550018064866,-810
"7767","3222342",0.507092850327687,9898,0.545968227747898,10117,-0.0388753774202106,-219
"7768","4222342",0.465618519627148,11870,0.503557852626088,12317,-0.0379393329989401,-447
"7769","1322342",0.585450761372604,5928,0.604085978255203,6820,-0.0186352168825993,-892
"7770","2322342",0.522227588864415,9138,0.54771149361438,10024,-0.0254839047499649,-886
"7771","3322342",0.479113380050911,11271,0.5189176604146,11562,-0.0398042803636889,-291
"7772","4322342",0.437639049350372,13034,0.47650728529279,13491,-0.0388682359424183,-457
"7773","1422342",0.546514263387608,7870,0.563456474287097,9131,-0.0169422108994894,-1261
"7774","2422342",0.483291090879419,11082,0.507081989646274,12161,-0.0237908987668551,-1079
"7775","3422342",0.440176882065915,12937,0.478288156446494,13409,-0.0381112743805791,-472
"7776","4422342",0.398702551365376,14331,0.435877781324684,14823,-0.0371752299593086,-492
"7777","1132342",0.624055487077276,4177,0.647975732086178,4505,-0.0239202450089019,-328
"7778","2132342",0.560832314569087,7127,0.591601247445355,7522,-0.0307689328762675,-395
"7779","3132342",0.517718105755584,9364,0.562807414245575,9177,-0.0450893084899915,187
"7780","4132342",0.476243775055044,11410,0.520397039123765,11476,-0.044153264068721,-66
"7781","1232342",0.57009770948428,6684,0.592671453140472,7471,-0.0225737436561917,-787
"7782","2232342",0.506874536976091,9912,0.536296968499649,10670,-0.0294224315235573,-758
"7783","3232342",0.463760328162588,11968,0.507503135299869,12137,-0.0437428071372813,-169
"7784","4232342",0.422285997462048,13602,0.465092760178059,13920,-0.042806762716011,-318
"7785","1332342",0.542118239207504,8118,0.565620885807174,9006,-0.0235026465996699,-888
"7786","2332342",0.478895066699315,11281,0.509246401166351,12053,-0.0303513344670355,-772
"7787","3332342",0.435780857885812,13114,0.480452567966571,13320,-0.0446717100807595,-206
"7788","4332342",0.394306527185272,14468,0.438042192844761,14758,-0.0437356656594892,-290
"7789","1432342",0.503181741222508,10109,0.524991381839068,11247,-0.0218096406165601,-1138
"7790","2432342",0.439958568714319,12944,0.468616897198245,13804,-0.0286583284839257,-860
"7791","3432342",0.396844359900816,14394,0.439823063998466,14716,-0.0429787040976498,-322
"7792","4432342",0.355370029200276,15343,0.397412688876655,15628,-0.0420426596763795,-285
"7793","1142342",0.575021922622447,6436,0.607577237959094,6626,-0.0325553153366472,-190
"7794","2142342",0.511798750114258,9680,0.551202753318271,9835,-0.0394040032040128,-155
"7795","3142342",0.468684541300755,11750,0.522408920118491,11378,-0.0537243788177368,372
"7796","4142342",0.427210210600215,13424,0.479998544996681,13338,-0.0527883343964665,86
"7797","1242342",0.521064145029451,9195,0.552272959013388,9781,-0.0312088139839373,-586
"7798","2242342",0.457840972521262,12234,0.495898474372565,12675,-0.0380575018513029,-441
"7799","3242342",0.414726763707758,13856,0.467104641172785,13847,-0.0523778774650268,9
"7800","4242342",0.373252433007218,14978,0.424694266050975,15092,-0.0514418330437563,-114
"7801","1342342",0.493084674752674,10599,0.52522239168009,11236,-0.0321377169274155,-637
"7802","2342342",0.429861502244486,13348,0.468847907039267,13797,-0.038986404794781,-449
"7803","3342342",0.386747293430982,14663,0.440054073839487,14713,-0.0533067804085051,-50
"7804","4342342",0.345272962730442,15505,0.397643698717677,15623,-0.0523707359872346,-118
"7805","1442342",0.454148176767679,12384,0.484592887711984,13156,-0.0304447109443056,-772
"7806","2442342",0.39092500425949,14565,0.428218403071161,15021,-0.0372933988116713,-456
"7807","3442342",0.347810795445986,15469,0.399424569871382,15594,-0.0516137744253953,-125
"7808","4442342",0.306336464745446,15984,0.357014194749571,16083,-0.0506777300041249,-99
"7809","1113342",0.69648410453631,1786,0.721513545802375,1769,-0.0250294412660644,17
"7810","2113342",0.633260932028122,3801,0.665139061161552,3743,-0.03187812913343,58
"7811","3113342",0.590146723214618,5687,0.636345227961772,5106,-0.046198504747154,581
"7812","4113342",0.548672392514078,7757,0.593934852839962,7409,-0.0452624603258835,348
"7813","1213342",0.642526326943314,3461,0.666209266856669,3684,-0.0236829399133542,-223
"7814","2213342",0.579303154435125,6242,0.609834782215845,6496,-0.0305316277807198,-254
"7815","3213342",0.536188945621622,8417,0.581040949016066,8129,-0.0448520033944438,288
"7816","4213342",0.494714614921082,10511,0.538630573894256,10541,-0.0439159589731736,-30
"7817","1313342",0.614546856666538,4579,0.639158699523371,4976,-0.0246118428568325,-397
"7818","2313342",0.551323684158349,7636,0.582784214882547,8032,-0.0314605307241981,-396
"7819","3313342",0.508209475344846,9846,0.553990381682768,9684,-0.0457809063379221,162
"7820","4313342",0.466735144644306,11826,0.511580006560958,11954,-0.0448448619166518,-128
"7821","1413342",0.575610358681542,6395,0.598529195555265,7140,-0.0229188368737226,-745
"7822","2413342",0.512387186173353,9649,0.542154710914442,10343,-0.0297675247410883,-694
"7823","3413342",0.46927297735985,11729,0.513360877714662,11863,-0.0440879003548124,-134
"7824","4413342",0.42779864665931,13405,0.470950502592852,13726,-0.043151855933542,-321
"7825","1123342",0.62850483366989,3982,0.660944234144968,3936,-0.0324394004750777,46
"7826","2123342",0.565281661161702,6923,0.604569749504145,6803,-0.0392880883424432,120
"7827","3123342",0.522167452348198,9142,0.575775916304365,8443,-0.0536084639561673,699
"7828","4123342",0.480693121647658,11192,0.533365541182555,10825,-0.0526724195348968,367
"7829","1223342",0.574547056076894,6455,0.605639955199262,6728,-0.0310928991223675,-273
"7830","2223342",0.511323883568706,9700,0.549265470558439,9937,-0.037941586989733,-237
"7831","3223342",0.468209674755202,11770,0.520471637358659,11471,-0.0522619626034571,299
"7832","4223342",0.426735344054662,13447,0.478061262236849,13418,-0.0513259181821867,29
"7833","1323342",0.546567585800118,7867,0.578589387865964,8284,-0.0320218020658457,-417
"7834","2323342",0.483344413291929,11081,0.522214903225141,11392,-0.0388704899332113,-311
"7835","3323342",0.440230204478426,12935,0.493421070025361,12783,-0.0531908655469353,152
"7836","4323342",0.398755873777886,14330,0.451010694903551,14379,-0.052254821125665,-49
"7837","1423342",0.507631087815122,9871,0.537959883897858,10582,-0.0303287960827359,-711
"7838","2423342",0.444407915306933,12779,0.481585399257035,13273,-0.0371774839501015,-494
"7839","3423342",0.40129370649343,14271,0.452791566057255,14320,-0.0514978595638255,-49
"7840","4423342",0.35981937579289,15262,0.410381190935445,15392,-0.0505618151425553,-130
"7841","1133342",0.585172311504791,5944,0.622479141696939,5810,-0.0373068301921483,134
"7842","2133342",0.521949138996602,9149,0.566104657056116,8985,-0.0441555180595139,164
"7843","3133342",0.478834930183099,11284,0.537310823856336,10622,-0.0584758936732379,662
"7844","4133342",0.437360599482559,13042,0.494900448734526,12721,-0.0575398492519676,321
"7845","1233342",0.531214533911795,8672,0.567174862751233,8930,-0.0359603288394383,-258
"7846","2233342",0.467991361403606,11778,0.51080037811041,11994,-0.0428090167068039,-216
"7847","3233342",0.424877152590102,13519,0.48200654491063,13251,-0.0571293923205279,268
"7848","4233342",0.383402821889562,14748,0.43959616978882,14720,-0.0561933478992574,28
"7849","1333342",0.503235063635018,10106,0.540124295417935,10468,-0.0368892317829166,-362
"7850","2333342",0.44001189112683,12943,0.483749810777112,13191,-0.0437379196502821,-248
"7851","3333342",0.396897682313326,14390,0.454955977577332,14250,-0.0580582952640061,140
"7852","4333342",0.355423351612786,15342,0.412545602455522,15352,-0.0571222508427356,-10
"7853","1433342",0.464298565650022,11941,0.499494791449829,12522,-0.0351962257998067,-581
"7854","2433342",0.401075393141834,14275,0.443120306809006,14633,-0.0420449136671724,-358
"7855","3433342",0.35796118432833,15293,0.414326473609227,15319,-0.0563652892808964,-26
"7856","4433342",0.31648685362779,15883,0.371916098487416,15957,-0.055429244859626,-74
"7857","1143342",0.536138747049961,8419,0.582080647569855,8080,-0.0459419005198939,339
"7858","2143342",0.472915574541772,11569,0.525706162929032,11217,-0.0527905883872595,352
"7859","3143342",0.429801365728269,13350,0.496912329729252,12624,-0.0671109640009834,726
"7860","4143342",0.388327035027729,14625,0.454501954607442,14268,-0.0661749195797129,357
"7861","1243342",0.482180969456965,11133,0.526776368624149,11156,-0.0445953991671837,-23
"7862","2243342",0.418957796948776,13727,0.470401883983326,13747,-0.0514440870345492,-20
"7863","3243342",0.375843588135273,14928,0.441608050783546,14668,-0.0657644626482732,260
"7864","4243342",0.334369257434733,15675,0.399197675661736,15596,-0.064828418227003,79
"7865","1343342",0.454201499180189,12380,0.499725801290851,12511,-0.0455243021106619,-131
"7866","2343342",0.390978326672,14564,0.443351316650028,14624,-0.0523729899780275,-60
"7867","3343342",0.347864117858497,15468,0.414557483450248,15313,-0.0666933655917515,155
"7868","4343342",0.306389787157957,15983,0.372147108328438,15956,-0.0657573211704813,27
"7869","1443342",0.415265001195193,13840,0.459096297322745,14118,-0.043831296127552,-278
"7870","2443342",0.352041828687004,15404,0.402721812681922,15552,-0.0506799839949177,-148
"7871","3443342",0.308927619873501,15966,0.373927979482143,15935,-0.0650003596086418,31
"7872","4443342",0.267453289172961,16229,0.331517604360332,16240,-0.0640643151873715,-11
"7873","1114342",0.64427703256574,3393,0.676862932428719,3258,-0.0325858998629784,135
"7874","2114342",0.581053860057552,6145,0.620488447787896,5917,-0.039434587730344,228
"7875","3114342",0.537939651244048,8333,0.591694614588116,7516,-0.053754963344068,817
"7876","4114342",0.496465320543508,10434,0.549284239466306,9933,-0.0528189189227976,501
"7877","1214342",0.590319254972745,5678,0.621558653483013,5853,-0.0312393985102682,-175
"7878","2214342",0.527096082464556,8899,0.56518416884219,9028,-0.0380880863776338,-129
"7879","3214342",0.483981873651052,11054,0.53639033564241,10664,-0.0524084619913578,390
"7880","4214342",0.442507542950512,12851,0.4939799605206,12755,-0.0514724175700875,96
"7881","1314342",0.562339784695968,7049,0.594508086149715,7371,-0.0321683014537465,-322
"7882","2314342",0.49911661218778,10312,0.538133601508892,10568,-0.0390169893211121,-256
"7883","3314342",0.456002403374276,12308,0.509339768309112,12048,-0.0533373649348361,260
"7884","4314342",0.414528072673736,13863,0.466929393187302,13850,-0.0524013205135658,13
"7885","1414342",0.523403286710972,9066,0.553878582181609,9693,-0.0304752954706367,-627
"7886","2414342",0.460180114202783,12132,0.497504097540786,12599,-0.0373239833380024,-467
"7887","3414342",0.41706590538928,13786,0.468710264341006,13801,-0.0516443589517263,-15
"7888","4414342",0.37559157468874,14931,0.426299889219196,15052,-0.050708314530456,-121
"7889","1124342",0.576297761699321,6370,0.616293620771312,6155,-0.0399958590719917,215
"7890","2124342",0.513074589191132,9622,0.559919136130489,9340,-0.0468445469393572,282
"7891","3124342",0.469960380377628,11696,0.53112530293071,10935,-0.0611649225530813,761
"7892","4124342",0.428486049677088,13387,0.488714927808899,12990,-0.0602288781318107,397
"7893","1224342",0.522339984106325,9129,0.560989341825606,9264,-0.0386493577192815,-135
"7894","2224342",0.459116811598136,12183,0.504614857184783,12264,-0.045498045586647,-81
"7895","3224342",0.416002602784632,13814,0.475821023985003,13516,-0.059818421200371,298
"7896","4224342",0.374528272084092,14950,0.433410648863193,14882,-0.0588823767791007,68
"7897","1324342",0.494360513829548,10527,0.533938774492308,10793,-0.0395782606627597,-266
"7898","2324342",0.43113734132136,13301,0.477564289851485,13442,-0.0464269485301252,-141
"7899","3324342",0.388023132507856,14635,0.448770456651705,14453,-0.0607473241438493,182
"7900","4324342",0.346548801807316,15483,0.406360081529895,15477,-0.059811279722579,6
"7901","1424342",0.455424015844552,12320,0.493309270524202,12789,-0.0378852546796498,-469
"7902","2424342",0.392200843336364,14531,0.436934785883379,14789,-0.0447339425470155,-258
"7903","3424342",0.34908663452286,15451,0.4081409526836,15440,-0.0590543181607395,11
"7904","4424342",0.30761230382232,15974,0.365730577561789,16009,-0.0581182737394692,-35
"7905","1134342",0.532965239534221,8578,0.577828528323283,8335,-0.0448632887890623,243
"7906","2134342",0.469742067026032,11704,0.52145404368246,11426,-0.0517119766564279,278
"7907","3134342",0.426627858212529,13450,0.492660210482681,12817,-0.0660323522701519,633
"7908","4134342",0.385153527511989,14703,0.45024983536087,14412,-0.0650963078488816,291
"7909","1234342",0.479007461941225,11275,0.522524249377577,11372,-0.0435167874363523,-97
"7910","2234342",0.415784289433036,13822,0.466149764736754,13881,-0.0503654753037179,-59
"7911","3234342",0.372670080619532,14996,0.437355931536974,14774,-0.0646858509174419,222
"7912","4234342",0.331195749918993,15714,0.394945556415164,15658,-0.0637498064961715,56
"7913","1334342",0.451027991664449,12507,0.495473682044279,12697,-0.0444456903798305,-190
"7914","2334342",0.38780481915626,14639,0.439099197403456,14732,-0.0512943782471961,-93
"7915","3334342",0.344690610342756,15517,0.410305364203676,15395,-0.0656147538609201,122
"7916","4334342",0.303216279642216,16010,0.367894989081866,15993,-0.0646787094396497,17
"7917","1434342",0.412091493679453,13936,0.454844178076173,14258,-0.0427526843967207,-322
"7918","2434342",0.348868321171264,15456,0.39846969343535,15611,-0.0496013722640864,-155
"7919","3434342",0.30575411235776,15991,0.369675860235571,15972,-0.0639217478778104,19
"7920","4434342",0.26427978165722,16240,0.32726548511376,16253,-0.06298570345654,-13
"7921","1144342",0.483931675079391,11057,0.537430034196199,10617,-0.0534983591168079,440
"7922","2144342",0.420708502571203,13662,0.481055549555376,13295,-0.0603470469841734,367
"7923","3144342",0.377594293757699,14893,0.452261716355597,14337,-0.0746674225978974,556
"7924","4144342",0.336119963057159,15650,0.409851341233786,15407,-0.073731378176627,243
"7925","1244342",0.429973897486395,13344,0.482125755250493,13248,-0.0521518577640976,96
"7926","2244342",0.366750724978207,15129,0.42575127060967,15063,-0.0590005456314632,66
"7927","3244342",0.323636516164703,15807,0.39695743740989,15631,-0.0733209212451873,176
"7928","4244342",0.282162185464163,16155,0.35454706228808,16095,-0.0723848768239169,60
"7929","1344342",0.401994427209619,14254,0.455075187917195,14245,-0.0530807607075759,9
"7930","2344342",0.33877125470143,15618,0.398700703276372,15602,-0.0599294485749415,16
"7931","3344342",0.295657045887927,16070,0.369906870076592,15970,-0.0742498241886655,100
"7932","4344342",0.254182715187387,16274,0.327496494954782,16251,-0.0733137797673952,23
"7933","1444342",0.363057929224623,15206,0.414445683949089,15317,-0.051387754724466,-111
"7934","2444342",0.299834756716434,16042,0.358071199308266,16073,-0.0582364425918318,-31
"7935","3444342",0.256720547902931,16268,0.329277366108487,16244,-0.0725568182055559,24
"7936","4444342",0.215246217202391,16355,0.286866990986676,16348,-0.0716207737842855,7
"7937","1111442",0.738660174858337,946,0.751203977883151,1078,-0.0125438030248132,-132
"7938","2111442",0.675437002350149,2354,0.694829493242327,2585,-0.0193924908921788,-231
"7939","3111442",0.632322793536645,3833,0.666035660042548,3694,-0.0337128665059028,139
"7940","4111442",0.590848462836105,5636,0.623625284920738,5750,-0.0327768220846323,-114
"7941","1211442",0.684702397265341,2087,0.695899698937444,2542,-0.011197301672103,-455
"7942","2211442",0.621479224757153,4273,0.639525214296621,4951,-0.0180459895394686,-678
"7943","3211442",0.578365015943649,6281,0.610731381096842,6449,-0.0323663651531926,-168
"7944","4211442",0.536890685243109,8374,0.568321005975031,8869,-0.0314303207319223,-495
"7945","1311442",0.656722926988565,2932,0.668849131604146,3573,-0.0121262046155812,-641
"7946","2311442",0.593499754480376,5532,0.612474646963323,6363,-0.0189748924829468,-831
"7947","3311442",0.550385545666873,7688,0.583680813763544,7968,-0.0332952680966708,-280
"7948","4311442",0.508911214966333,9807,0.541270438641733,10405,-0.0323592236754006,-598
"7949","1411442",0.617786429003569,4433,0.628219627636041,5491,-0.0104331986324714,-1058
"7950","2411442",0.55456325649538,7470,0.571845142995217,8666,-0.0172818864998371,-1196
"7951","3411442",0.511449047681877,9694,0.543051309795438,10283,-0.0316022621135611,-589
"7952","4411442",0.469974716981337,11694,0.500640934673628,12464,-0.0306662176922908,-770
"7953","1121442",0.670680903991917,2484,0.690634666225744,2722,-0.0199537622338264,-238
"7954","2121442",0.607457731483729,4913,0.634260181584921,5221,-0.026802450101192,-308
"7955","3121442",0.564343522670225,6957,0.605466348385141,6740,-0.041122825714916,217
"7956","4121442",0.522869191969685,9099,0.563055973263331,9158,-0.0401867812936455,-59
"7957","1221442",0.616723126398921,4471,0.635330387280038,5160,-0.0186072608811162,-689
"7958","2221442",0.553499953890733,7518,0.578955902639214,8261,-0.0254559487484818,-743
"7959","3221442",0.510385745077229,9743,0.550162069439435,9887,-0.0397763243622058,-144
"7960","4221442",0.468911414376689,11744,0.507751694317625,12129,-0.0388402799409355,-385
"7961","1321442",0.588743656122145,5743,0.60827981994674,6592,-0.0195361638245944,-849
"7962","2321442",0.525520483613956,8977,0.551905335305916,9798,-0.02638485169196,-821
"7963","3321442",0.482406274800453,11120,0.523111502106137,11343,-0.040705227305684,-223
"7964","4321442",0.440931944099913,12910,0.480701126984327,13312,-0.0397691828844137,-402
"7965","1421442",0.549807158137149,7710,0.567650315978634,8904,-0.0178431578414846,-1194
"7966","2421442",0.48658398562896,10927,0.511275831337811,11972,-0.0246918457088503,-1045
"7967","3421442",0.443469776815457,12815,0.482481998138031,13234,-0.0390122213225744,-419
"7968","4421442",0.401995446114917,14253,0.440071623016221,14710,-0.038076176901304,-457
"7969","1131442",0.627348381826818,4027,0.652169573777715,4315,-0.024821191950897,-288
"7970","2131442",0.564125209318629,6963,0.595795089136892,7305,-0.0316698798182626,-342
"7971","3131442",0.521011000505126,9197,0.567001255937112,8940,-0.0459902554319866,257
"7972","4131442",0.479536669804586,11237,0.524590880815302,11271,-0.0450542110107164,-34
"7973","1231442",0.573390604233822,6514,0.596865294832009,7245,-0.0234746905981871,-731
"7974","2231442",0.510167431725633,9752,0.540490810191186,10453,-0.0303233784655527,-701
"7975","3231442",0.467053222912129,11811,0.511696976991406,11947,-0.0446437540792767,-136
"7976","4231442",0.425578892211589,13489,0.469286601869596,13788,-0.0437077096580062,-299
"7977","1331442",0.545411133957046,7944,0.569814727498711,8785,-0.0244035935416653,-841
"7978","2331442",0.482187961448857,11131,0.513440242857888,11860,-0.0312522814090309,-729
"7979","3331442",0.439073752635353,12976,0.484646409658108,13154,-0.0455726570227549,-178
"7980","4331442",0.397599421934813,14365,0.442236034536298,14653,-0.0446366126014845,-288
"7981","1431442",0.50647463597205,9928,0.529185223530605,11043,-0.0227105875585555,-1115
"7982","2431442",0.443251463463861,12818,0.472810738889782,13655,-0.0295592754259211,-837
"7983","3431442",0.400137254650357,14297,0.444016905690002,14602,-0.0438796510396451,-305
"7984","4431442",0.358662923949817,15280,0.401606530568192,15574,-0.0429436066183748,-294
"7985","1141442",0.578314817371988,6284,0.611771079650631,6410,-0.0334562622786426,-126
"7986","2141442",0.515091644863799,9513,0.555396595009808,9609,-0.0403049501460082,-96
"7987","3141442",0.471977436050296,11618,0.526602761810028,11165,-0.0546253257597322,453
"7988","4141442",0.430503105349756,13320,0.484192386688218,13175,-0.0536892813384618,145
"7989","1241442",0.524357039778992,9030,0.556466800704925,9544,-0.0321097609259324,-514
"7990","2241442",0.461133867270803,12091,0.500092316064101,12492,-0.038958448793298,-401
"7991","3241442",0.4180196584573,13754,0.471298482864322,13710,-0.0532788244070221,44
"7992","4241442",0.37654532775676,14916,0.428888107742512,15004,-0.0523427799857517,-88
"7993","1341442",0.496377569502216,10439,0.529416233371627,11031,-0.0330386638694107,-592
"7994","2341442",0.433154396994027,13226,0.473041748730804,13646,-0.0398873517367763,-420
"7995","3341442",0.390040188180524,14591,0.444247915531024,14596,-0.0542077273505003,-5
"7996","4341442",0.348565857479984,15463,0.401837540409214,15571,-0.05327168292923,-108
"7997","1441442",0.45744107151722,12244,0.488786729403521,12987,-0.0313456578863008,-743
"7998","2441442",0.394217899009031,14471,0.432412244762698,14918,-0.0381943457536666,-447
"7999","3441442",0.351103690195528,15419,0.403618411562918,15527,-0.0525147213673906,-108
"8000","4441442",0.309629359494988,15961,0.361208036441108,16058,-0.0515786769461202,-97
"8001","1112442",0.705575263096649,1577,0.712884996354499,1987,-0.00730973325785,-410
"8002","2112442",0.64235209058846,3471,0.656510511713675,4128,-0.0141584211252156,-657
"8003","3112442",0.599237881774956,5267,0.627716678513896,5526,-0.0284787967389396,-259
"8004","4112442",0.557763551074416,7285,0.585306303392085,7869,-0.0275427523176691,-584
"8005","1212442",0.651617485503653,3135,0.657580717408792,4077,-0.00596323190513981,-942
"8006","2212442",0.588394312995464,5764,0.601206232767969,6987,-0.0128119197725054,-1223
"8007","3212442",0.54528010418196,7950,0.57241239956819,8629,-0.0271322953862294,-679
"8008","4212442",0.50380577348142,10075,0.530002024446379,11002,-0.0261962509649591,-927
"8009","1312442",0.623638015226876,4197,0.630530150075494,5382,-0.00689213484861806,-1185
"8010","2312442",0.560414842718687,7156,0.574155665434671,8539,-0.0137408227159836,-1383
"8011","3312442",0.517300633905184,9396,0.545361832234892,10153,-0.0280611983297077,-757
"8012","4312442",0.475826303204644,11436,0.502951457113081,12350,-0.0271251539084374,-914
"8013","1412442",0.58470151724188,5968,0.589900646107389,7608,-0.00519912886550822,-1640
"8014","2412442",0.521478344733691,9172,0.533526161466565,10819,-0.0120478167328739,-1647
"8015","3412442",0.478364135920188,11304,0.504732328266786,12259,-0.0263681923465979,-955
"8016","4412442",0.436889805219648,13067,0.462321953144976,14006,-0.0254321479253276,-939
"8017","1122442",0.637595992230229,3653,0.652315684697092,4311,-0.0147196924668632,-658
"8018","2122442",0.57437281972204,6463,0.595941200056268,7297,-0.0215683803342288,-834
"8019","3122442",0.531258610908536,8668,0.567147366856489,8932,-0.0358887559479528,-264
"8020","4122442",0.489784280207996,10756,0.524736991734679,11263,-0.0349527115266823,-507
"8021","1222442",0.583638214637233,6021,0.597011405751386,7236,-0.013373191114153,-1215
"8022","2222442",0.520415042129044,9218,0.540636921110562,10443,-0.0202218789815186,-1225
"8023","3222442",0.47730083331554,11356,0.511843087910783,11943,-0.0345422545952426,-587
"8024","4222442",0.435826502615,13110,0.469432712788972,13781,-0.0336062101739723,-671
"8025","1322442",0.555658744360456,7418,0.569960838418088,8777,-0.0143020940576313,-1359
"8026","2322442",0.492435571852267,10624,0.513586353777264,11851,-0.0211507819249969,-1227
"8027","3322442",0.449321363038764,12581,0.484792520577485,13149,-0.0354711575387209,-568
"8028","4322442",0.407847032338224,14074,0.442382145455675,14651,-0.0345351131174506,-577
"8029","1422442",0.51672224637546,9428,0.529331334449982,11036,-0.0126090880745214,-1608
"8030","2422442",0.453499073867271,12409,0.472956849809159,13650,-0.0194577759418872,-1241
"8031","3422442",0.410384865053768,13984,0.444163016609379,14600,-0.0337781515556112,-616
"8032","4422442",0.368910534353228,15079,0.401752641487569,15573,-0.0328421071343408,-494
"8033","1132442",0.594263470065129,5503,0.613850592249063,6280,-0.0195871221839339,-777
"8034","2132442",0.53104029755694,8680,0.55747610760824,9479,-0.0264358100512995,-799
"8035","3132442",0.487926088743437,10860,0.52868227440846,11069,-0.0407561856650235,-209
"8036","4132442",0.446451758042897,12698,0.48627189928665,13083,-0.0398201412437532,-385
"8037","1232442",0.540305692472133,8219,0.558546313303357,9421,-0.0182406208312239,-1202
"8038","2232442",0.477082519963944,11374,0.502171828662533,12387,-0.0250893086985895,-1013
"8039","3232442",0.43396831115044,13187,0.473377995462754,13628,-0.0394096843123135,-441
"8040","4232442",0.3924939804499,14521,0.430967620340944,14958,-0.0384736398910431,-437
"8041","1332442",0.512326222195357,9655,0.531495745970059,10918,-0.0191695237747022,-1263
"8042","2332442",0.449103049687168,12591,0.475121261329235,13545,-0.0260182116420677,-954
"8043","3332442",0.405988840873664,14132,0.446327428129456,14533,-0.0403385872557917,-401
"8044","4332442",0.364514510173124,15172,0.403917053007646,15523,-0.0394025428345213,-351
"8045","1432442",0.473389724210361,11552,0.490866242001953,12896,-0.0174765177915923,-1344
"8046","2432442",0.410166551702172,13991,0.43449175736113,14854,-0.024325205658958,-863
"8047","3432442",0.367052342888668,15123,0.40569792416135,15489,-0.038645581272682,-366
"8048","4432442",0.325578012188128,15783,0.36328754903954,16037,-0.0377095368514115,-254
"8049","1142442",0.545229905610299,7952,0.573452098121979,8578,-0.0282221925116795,-626
"8050","2142442",0.48200673310211,11138,0.517077613481156,11662,-0.035070880379045,-524
"8051","3142442",0.438892524288607,12980,0.488283780281376,13009,-0.049391255992769,-29
"8052","4142442",0.397418193588067,14369,0.445873405159566,14545,-0.0484552115714986,-176
"8053","1242442",0.491272128017303,10679,0.518147819176273,11609,-0.0268756911589693,-930
"8054","2242442",0.428048955509114,13401,0.461773334535449,14022,-0.0337243790263349,-621
"8055","3242442",0.384934746695611,14707,0.43297950133567,14896,-0.0480447546400589,-189
"8056","4242442",0.343460415995071,15535,0.39056912621386,15725,-0.0471087102187885,-190
"8057","1342442",0.463292657740527,11986,0.491097251842975,12888,-0.0278045941024475,-902
"8058","2342442",0.400069485232338,14298,0.434722767202151,14849,-0.0346532819698132,-551
"8059","3342442",0.356955276418835,15313,0.405928934002372,15486,-0.0489736575835372,-173
"8060","4342442",0.315480945718295,15894,0.363518558880562,16035,-0.0480376131622667,-141
"8061","1442442",0.424356159755531,13536,0.450467747874869,14403,-0.0261115881193377,-867
"8062","2442442",0.361132987247342,15238,0.394093263234046,15669,-0.0329602759867034,-431
"8063","3442442",0.318018778433839,15862,0.365299430034266,16015,-0.0472806516004274,-153
"8064","4442442",0.276544447733299,16187,0.322889054912456,16271,-0.046344607179157,-84
"8065","1113442",0.666692087524163,2607,0.68738840596526,2839,-0.0206963184410967,-232
"8066","2113442",0.603468915015974,5065,0.631013921324436,5361,-0.0275450063084622,-296
"8067","3113442",0.56035470620247,7159,0.602220088124657,6923,-0.0418653819221863,236
"8068","4113442",0.518880375501931,9292,0.559809713002846,9352,-0.0409293375009158,-60
"8069","1213442",0.612734309931167,4673,0.632084127019553,5311,-0.0193498170883865,-638
"8070","2213442",0.549511137422978,7720,0.57570964237873,8447,-0.026198504955752,-727
"8071","3213442",0.506396928609474,9932,0.546915809178951,10060,-0.0405188805694761,-128
"8072","4213442",0.464922597908934,11911,0.50450543405714,12271,-0.0395828361482058,-360
"8073","1313442",0.584754839654391,5965,0.605033559686255,6771,-0.0202787200318647,-806
"8074","2313442",0.521531667146202,9170,0.548659075045432,9970,-0.0271274078992303,-800
"8075","3313442",0.478417458332698,11302,0.519865241845653,11505,-0.0414477835129543,-203
"8076","4313442",0.436943127632158,13065,0.477454866723842,13451,-0.040511739091684,-386
"8077","1413442",0.545818341669395,7920,0.56440405571815,9077,-0.0185857140487549,-1157
"8078","2413442",0.482595169161206,11111,0.508029571077326,12113,-0.0254344019161206,-1002
"8079","3413442",0.439480960347702,12962,0.479235737877547,13365,-0.0397547775298445,-403
"8080","4413442",0.398006629647162,14356,0.436825362755737,14796,-0.0388187331085743,-440
"8081","1123442",0.598712816657743,5290,0.626819094307853,5575,-0.0281062776501099,-285
"8082","2123442",0.535489644149554,8440,0.57044460966703,8757,-0.0349549655174755,-317
"8083","3123442",0.492375435336051,10629,0.54165077646725,10380,-0.0492753411311995,249
"8084","4123442",0.450901104635511,12511,0.49924040134544,12535,-0.0483392967099289,-24
"8085","1223442",0.544755039064747,7979,0.571514815362147,8691,-0.0267597762973997,-712
"8086","2223442",0.481531866556558,11154,0.515140330721323,11771,-0.0336084641647653,-617
"8087","3223442",0.438417657743055,12996,0.486346497521544,13079,-0.0479288397784892,-83
"8088","4223442",0.396943327042515,14387,0.443936122399733,14605,-0.046992795357219,-218
"8089","1323442",0.516775568787971,9422,0.544464248028849,10211,-0.0276886792408779,-789
"8090","2323442",0.453552396279782,12406,0.488089763388025,13017,-0.0345373671082435,-611
"8091","3323442",0.410438187466278,13982,0.459295930188246,14113,-0.0488577427219675,-131
"8092","4323442",0.368963856765738,15077,0.416885555066436,15260,-0.0479216983006972,-183
"8093","1423442",0.477839070802975,11331,0.503834744060743,12308,-0.0259956732577681,-977
"8094","2423442",0.414615898294786,13859,0.44746025941992,14502,-0.0328443611251337,-643
"8095","3423442",0.371501689481282,15019,0.41866642622014,15225,-0.0471647367388577,-206
"8096","4423442",0.330027358780742,15727,0.37625605109833,15908,-0.0462286923175874,-181
"8097","1133442",0.555380294492643,7436,0.588354001859824,7694,-0.0329737073671805,-258
"8098","2133442",0.492157121984454,10635,0.531979517219001,10892,-0.0398223952345461,-257
"8099","3133442",0.449042913170951,12595,0.503185684019221,12340,-0.0541427708482701,255
"8100","4133442",0.407568582470411,14082,0.460775308897411,14058,-0.0532067264269998,24
"8101","1233442",0.501422516899647,10206,0.533049722914118,10844,-0.0316272060144706,-638
"8102","2233442",0.438199344391458,13009,0.476675238273294,13486,-0.0384758938818361,-477
"8103","3233442",0.395085135577955,14448,0.447881405073515,14485,-0.0527962694955601,-37
"8104","4233442",0.353610804877415,15374,0.405471029951705,15495,-0.0518602250742896,-121
"8105","1333442",0.473443046622871,11547,0.50599915558082,12204,-0.0325561089579488,-657
"8106","2333442",0.410219874114682,13989,0.449624670939996,14432,-0.0394047968253143,-443
"8107","3333442",0.367105665301179,15120,0.420830837740217,15180,-0.0537251724390383,-60
"8108","4333442",0.325631334600639,15782,0.378420462618407,15881,-0.0527891280177678,-99
"8109","1433442",0.434506548637875,13168,0.465369651612714,13912,-0.0308631029748389,-744
"8110","2433442",0.371283376129686,15021,0.408995166971891,15426,-0.0377117908422046,-405
"8111","3433442",0.328169167316183,15757,0.380201333772111,15863,-0.0520321664559286,-106
"8112","4433442",0.286694836615643,16127,0.337790958650301,16208,-0.051096122034658,-81
"8113","1143442",0.506346730037814,9937,0.54795550773274,10011,-0.0416087776949261,-74
"8114","2143442",0.443123557529625,12822,0.491581023091917,12864,-0.0484574655622916,-42
"8115","3143442",0.400009348716121,14300,0.462787189892137,13986,-0.0627778411760156,314
"8116","4143442",0.358535018015582,15283,0.420376814770327,15194,-0.0618417967547452,89
"8117","1243442",0.452388952444818,12447,0.492651228787034,12818,-0.0402622763422159,-371
"8118","2243442",0.389165779936629,14607,0.43627674414621,14809,-0.0471109642095814,-202
"8119","3243442",0.346051571123125,15491,0.407482910946431,15452,-0.0614313398233055,39
"8120","4243442",0.304577240422585,16000,0.36507253582462,16017,-0.0604952954020351,-17
"8121","1343442",0.424409482168042,13533,0.465600661453736,13906,-0.0411911792856941,-373
"8122","2343442",0.361186309659853,15237,0.409226176812912,15421,-0.0480398671530597,-184
"8123","3343442",0.318072100846349,15861,0.380432343613133,15858,-0.0623602427667836,3
"8124","4343442",0.276597770145809,16186,0.338021968491323,16207,-0.0614241983455133,-21
"8125","1443442",0.385472984183046,14698,0.42497115748563,15086,-0.0394981733025843,-388
"8126","2443442",0.322249811674857,15821,0.368596672844807,15987,-0.0463468611699499,-166
"8127","3443442",0.279135602861353,16172,0.339802839645027,16195,-0.0606672367836739,-23
"8128","4443442",0.237661272160813,16318,0.297392464523217,16335,-0.0597311923624035,-17
"8129","1114442",0.614485015553593,4585,0.642737792591604,4779,-0.0282527770380104,-194
"8130","2114442",0.551261843045404,7641,0.58636330795078,7815,-0.035101464905376,-174
"8131","3114442",0.508147634231901,9851,0.557569474751001,9475,-0.0494218405191,376
"8132","4114442",0.466673303531361,11830,0.515159099629191,11770,-0.0484857960978298,60
"8133","1214442",0.560527237960597,7147,0.587433513645897,7746,-0.0269062756853005,-599
"8134","2214442",0.497304065452408,10399,0.531059029005074,10938,-0.033754963552666,-539
"8135","3214442",0.454189856638905,12381,0.502265195805295,12382,-0.04807533916639,-1
"8136","4214442",0.412715525938365,13915,0.459854820683484,14087,-0.0471392947451196,-172
"8137","1314442",0.532547767683821,8596,0.5603829463126,9304,-0.0278351786287787,-708
"8138","2314442",0.469324595175632,11727,0.504008461671776,12300,-0.0346838664961443,-573
"8139","3314442",0.426210386362129,13467,0.475214628471997,13543,-0.0490042421098683,-76
"8140","4314442",0.384736055661589,14714,0.432804253350186,14902,-0.0480681976885979,-188
"8141","1414442",0.493611269698825,10566,0.519753442344494,11511,-0.0261421726456689,-945
"8142","2414442",0.430388097190636,13326,0.463378957703671,13966,-0.0329908605130345,-640
"8143","3414442",0.387273888377133,14651,0.434585124503891,14853,-0.0473112361267585,-202
"8144","4414442",0.345799557676593,15496,0.392174749382081,15699,-0.0463751917054882,-203
"8145","1124442",0.546505744687173,7874,0.582168480934197,8075,-0.0356627362470237,-201
"8146","2124442",0.483282572178984,11083,0.525793996293374,11212,-0.0425114241143892,-129
"8147","3124442",0.440168363365481,12938,0.497000163093594,12620,-0.0568317997281133,318
"8148","4124442",0.398694032664941,14332,0.454589787971784,14264,-0.0558957553068429,68
"8149","1224442",0.492547967094177,10618,0.526864201988491,11150,-0.0343162348943137,-532
"8150","2224442",0.429324794585988,13364,0.470489717347667,13744,-0.0411649227616792,-380
"8151","3224442",0.386210585772485,14672,0.441695884147888,14665,-0.0554852983754032,7
"8152","4224442",0.344736255071945,15515,0.399285509026078,15595,-0.0545492539541328,-80
"8153","1324442",0.464568496817401,11930,0.499813634655193,12506,-0.0352451378377919,-576
"8154","2324442",0.401345324309212,14269,0.44343915001437,14620,-0.0420938257051575,-351
"8155","3324442",0.358231115495709,15289,0.41464531681459,15310,-0.0564142013188815,-21
"8156","4324442",0.316756784795169,15881,0.37223494169278,15955,-0.055478156897611,-74
"8157","1424442",0.425631998832405,13488,0.459184130687087,14115,-0.033552131854682,-627
"8158","2424442",0.362408826324216,15218,0.402809646046264,15549,-0.0404008197220477,-331
"8159","3424442",0.319294617510713,15848,0.374015812846484,15934,-0.0547211953357717,-86
"8160","4424442",0.277820286810173,16177,0.331605437724674,16239,-0.0537851509145013,-62
"8161","1134442",0.503173222522074,10111,0.543703388486168,10255,-0.0405301659640945,-144
"8162","2134442",0.439950050013885,12946,0.487328903845345,13040,-0.0473788538314601,-94
"8163","3134442",0.396835841200381,14395,0.458535070645565,14134,-0.0616992294451841,261
"8164","4134442",0.355361510499841,15344,0.416124695523755,15278,-0.0607631850239137,66
"8165","1234442",0.449215444929077,12586,0.488399109540462,13005,-0.0391836646113844,-419
"8166","2234442",0.385992272420889,14679,0.432024624899639,14931,-0.04603235247875,-252
"8167","3234442",0.342878063607385,15548,0.403230791699859,15534,-0.060352728092474,14
"8168","4234442",0.301403732906845,16025,0.360820416578049,16060,-0.0594166836712036,-35
"8169","1334442",0.421235974652301,13640,0.461348542207164,14039,-0.0401125675548626,-399
"8170","2334442",0.358012802144112,15291,0.404974057566341,15505,-0.0469612554222282,-214
"8171","3334442",0.314898593330609,15898,0.376180224366561,15910,-0.0612816310359522,-12
"8172","4334442",0.273424262630069,16200,0.333769849244751,16229,-0.0603455866146818,-29
"8173","1434442",0.382299476667305,14775,0.420719038239058,15185,-0.0384195615717528,-410
"8174","2434442",0.319076304159116,15849,0.364344553598235,16027,-0.0452682494391184,-178
"8175","3434442",0.275962095345613,16190,0.335550720398455,16219,-0.0595886250528424,-29
"8176","4434442",0.234487764645073,16323,0.293140345276645,16343,-0.0586525806315721,-20
"8177","1144442",0.454139658067244,12386,0.503304894359084,12333,-0.0491652362918399,53
"8178","2144442",0.390916485559055,14566,0.446930409718261,14518,-0.0560139241592055,48
"8179","3144442",0.347802276745552,15470,0.418136576518481,15234,-0.0703342997729295,236
"8180","4144442",0.306327946045012,15985,0.375726201396671,15916,-0.0693982553516591,69
"8181","1244442",0.400181880474248,14295,0.448000615413378,14483,-0.0478187349391299,-188
"8182","2244442",0.336958707966059,15643,0.391626130772554,15707,-0.0546674228064954,-64
"8183","3244442",0.293844499152556,16079,0.362832297572775,16040,-0.0689877984202194,39
"8184","4244442",0.252370168452016,16278,0.320421922450965,16277,-0.068051753998949,1
"8185","1344442",0.372202410197472,15004,0.42095004808008,15176,-0.0487476378826081,-172
"8186","2344442",0.308979237689283,15965,0.364575563439257,16024,-0.0555963257499736,-59
"8187","3344442",0.265865028875779,16232,0.335781730239477,16218,-0.0699167013636976,14
"8188","4344442",0.224390698175239,16339,0.293371355117667,16342,-0.0689806569424273,-3
"8189","1444442",0.333265912212476,15689,0.380320544111974,15861,-0.0470546318994982,-172
"8190","2444442",0.270042739704287,16220,0.323946059471151,16264,-0.0539033197668639,-44
"8191","3444442",0.226928530890783,16335,0.295152226271371,16337,-0.0682236953805879,-2
"8192","4444442",0.185454200190243,16375,0.252741851149561,16376,-0.0672876509593175,-1
"8193","1111113",0.926786620877685,11,0.936223693543372,10,-0.00943707266568683,1
"8194","2111113",0.863563448369497,70,0.879849208902549,57,-0.0162857605330524,13
"8195","3111113",0.820449239555993,194,0.85105537570277,122,-0.0306061361467764,72
"8196","4111113",0.778974908855453,460,0.808645000580959,351,-0.0296700917255061,109
"8197","1211113",0.872828843284689,55,0.880919414597666,54,-0.00809057131297675,1
"8198","2211113",0.8096056707765,250,0.824544929956843,246,-0.0149392591803423,4
"8199","3211113",0.766491461962997,590,0.795751096757063,458,-0.0292596347940663,132
"8200","4211113",0.725017131262457,1176,0.753340721635253,1037,-0.028323590372796,139
"8201","1311113",0.844849373007913,112,0.853868847264368,110,-0.009019474256455,2
"8202","2311113",0.781626200499724,436,0.797494362623545,434,-0.0158681621238206,2
"8203","3311113",0.738511991686221,950,0.768700529423765,788,-0.0301885377375446,162
"8204","4311113",0.697037660985681,1774,0.726290154301955,1631,-0.0292524933162742,143
"8205","1411113",0.805912875022917,272,0.813239343296262,310,-0.00732646827334515,-38
"8206","2411113",0.742689702514728,888,0.756864858655439,979,-0.0141751561407109,-91
"8207","3411113",0.699575493701225,1703,0.72807102545566,1583,-0.0284955317544349,120
"8208","4411113",0.658101163000685,2887,0.685660650333849,2902,-0.0275594873331645,-15
"8209","1121113",0.858807350011265,77,0.875654381885965,64,-0.0168470318747,13
"8210","2121113",0.795584177503077,336,0.819279897245142,276,-0.0236957197420656,60
"8211","3121113",0.752469968689573,752,0.790486064045363,510,-0.0380160953557896,242
"8212","4121113",0.710995637989033,1447,0.748075688923552,1145,-0.0370800509345193,302
"8213","1221113",0.804849572418269,279,0.820350102940259,269,-0.01550053052199,10
"8214","2221113",0.74162639991008,895,0.763975618299436,871,-0.0223492183893556,24
"8215","3221113",0.698512191096577,1729,0.735181785099656,1417,-0.0366695940030796,312
"8216","4221113",0.657037860396037,2921,0.692771409977846,2650,-0.0357335495818092,271
"8217","1321113",0.776870102141493,478,0.793299535606961,477,-0.0164294334654682,1
"8218","2321113",0.713646929633304,1393,0.736925050966138,1376,-0.0232781213328338,17
"8219","3321113",0.670532720819801,2488,0.708131217766359,2139,-0.0375984969465578,349
"8220","4321113",0.629058390119261,3961,0.665720842644548,3708,-0.0366624525252874,253
"8221","1421113",0.737933604156497,958,0.752670031638855,1044,-0.0147364274823584,-86
"8222","2421113",0.674710431648308,2375,0.696295546998032,2527,-0.0215851153497241,-152
"8223","3421113",0.631596222834805,3856,0.667501713798253,3629,-0.0359054909634481,227
"8224","4421113",0.590121892134265,5688,0.625091338676443,5662,-0.0349694465421777,26
"8225","1131113",0.815474827846166,219,0.837189289437937,179,-0.0217144615917708,40
"8226","2131113",0.752251655337977,755,0.780814804797113,630,-0.0285631494591364,125
"8227","3131113",0.709137446524473,1492,0.752020971597334,1064,-0.0428835250728604,428
"8228","4131113",0.667663115823933,2583,0.709610596475523,2095,-0.04194748065159,488
"8229","1231113",0.76151705025317,650,0.78188501049223,613,-0.0203679602390607,37
"8230","2231113",0.698293877744981,1734,0.725510525851407,1658,-0.0272166481064263,76
"8231","3231113",0.655179668931477,2984,0.696716692651628,2515,-0.0415370237201503,469
"8232","4231113",0.613705338230937,4629,0.654306317529817,4223,-0.04060097929888,406
"8233","1331113",0.733537579976393,1034,0.754834443158932,1012,-0.021296863182539,22
"8234","2331113",0.670314407468205,2497,0.698459958518109,2461,-0.0281455510499046,36
"8235","3331113",0.627200198654701,4031,0.66966612531833,3528,-0.0424659266636286,503
"8236","4331113",0.585725867954161,5904,0.627255750196519,5546,-0.0415298822423582,358
"8237","1431113",0.694601081991397,1824,0.714204939190827,1957,-0.0196038571994291,-133
"8238","2431113",0.631377909483209,3867,0.657830454550003,4060,-0.0264525450667948,-193
"8239","3431113",0.588263700669705,5769,0.629036621350224,5452,-0.0407729206805189,317
"8240","4431113",0.546789369969165,7859,0.586626246228414,7799,-0.0398368762592485,60
"8241","1141113",0.766441263391336,591,0.796790795310853,444,-0.0303495319195163,147
"8242","2141113",0.703218090883147,1626,0.740416310670029,1306,-0.0371982197868819,320
"8243","3141113",0.660103882069644,2809,0.71162247747025,2023,-0.0515185954006059,786
"8244","4141113",0.618629551369104,4396,0.669212102348439,3554,-0.0505825509793355,842
"8245","1241113",0.71248348579834,1418,0.741486516365146,1277,-0.0290030305668062,141
"8246","2241113",0.649260313290151,3222,0.685112031724323,2922,-0.0358517184341718,300
"8247","3241113",0.606146104476648,4971,0.656318198524544,4131,-0.0501720940478958,840
"8248","4241113",0.564671773776108,6941,0.613907823402733,6274,-0.0492360496266254,667
"8249","1341113",0.684504015521564,2091,0.714435949031848,1948,-0.0299319335102844,143
"8250","2341113",0.621280843013375,4279,0.658061464391025,4050,-0.03678062137765,229
"8251","3341113",0.578166634199872,6290,0.629267631191246,5444,-0.051100996991374,846
"8252","4341113",0.536692303499332,8382,0.586857256069435,7788,-0.0501649525701037,594
"8253","1441113",0.645567517536568,3343,0.673806445063743,3356,-0.0282389275271746,-13
"8254","2441113",0.582344345028379,6075,0.617431960422919,6078,-0.0350876153945403,-3
"8255","3441113",0.539230136214876,8265,0.58863812722314,7680,-0.0494079910082643,585
"8256","4441113",0.497755805514336,10371,0.54622775210133,10100,-0.0484719465869939,271
"8257","1112113",0.893701709115996,28,0.89790471201472,33,-0.00420300289872366,-5
"8258","2112113",0.830478536607808,158,0.841530227373897,162,-0.0110516907660893,-4
"8259","3112113",0.787364327794304,392,0.812736394174117,317,-0.0253720663798133,75
"8260","4112113",0.745889997093764,840,0.770326019052307,770,-0.0244360219585429,70
"8261","1212113",0.839743931523,123,0.842600433069014,157,-0.00285650154601358,-34
"8262","2212113",0.776520759014811,483,0.786225948428191,567,-0.00970518941337917,-84
"8263","3212113",0.733406550201308,1035,0.757432115228411,973,-0.0240255650271032,62
"8264","4212113",0.691932219500768,1904,0.715021740106601,1937,-0.0230895206058328,-33
"8265","1312113",0.811764461246224,239,0.815549865735716,300,-0.00378540448949183,-61
"8266","2312113",0.748541288738035,806,0.759175381094893,946,-0.0106340923568574,-140
"8267","3312113",0.705427079924532,1581,0.730381547895113,1518,-0.0249544679705814,63
"8268","4312113",0.663952749223992,2696,0.687971172773303,2811,-0.0240184235493111,-115
"8269","1412113",0.772827963261228,522,0.77492036176761,698,-0.00209239850638199,-176
"8270","2412113",0.709604790753039,1485,0.718545877126787,1841,-0.00894108637374769,-356
"8271","3412113",0.666490581939536,2614,0.689752043927008,2752,-0.0232614619874717,-138
"8272","4412113",0.625016251238996,4127,0.647341668805197,4542,-0.0223254175662013,-415
"8273","1122113",0.825722438249576,175,0.837335400357313,178,-0.0116129621077369,-3
"8274","2122113",0.762499265741388,634,0.78096091571649,628,-0.0184616499751025,6
"8275","3122113",0.719385056927884,1283,0.752167082516711,1059,-0.0327820255888265,224
"8276","4122113",0.677910726227344,2288,0.7097567073949,2092,-0.0318459811675561,196
"8277","1222113",0.77176466065658,531,0.782031121411607,611,-0.0102664607550268,-80
"8278","2222113",0.708541488148391,1505,0.725656636770784,1654,-0.0171151486223924,-149
"8279","3222113",0.665427279334888,2649,0.696862803571004,2510,-0.0314355242361164,139
"8280","4222113",0.623952948634348,4179,0.654452428449194,4219,-0.030499479814846,-40
"8281","1322113",0.743785190379804,870,0.754980554078309,1009,-0.011195363698505,-139
"8282","2322113",0.680562017871615,2210,0.698606069437486,2458,-0.0180440515658706,-248
"8283","3322113",0.637447809058112,3659,0.669812236237706,3519,-0.0323644271795946,140
"8284","4322113",0.595973478357572,5424,0.627401861115896,5539,-0.0314283827583243,-115
"8285","1422113",0.704848692394808,1593,0.714351050110203,1952,-0.0095023577153952,-359
"8286","2422113",0.641625519886619,3501,0.65797656546938,4054,-0.0163510455827609,-553
"8287","3422113",0.598511311073116,5298,0.629182732269601,5448,-0.0306714211964849,-150
"8288","4422113",0.557036980372576,7341,0.58677235714779,7793,-0.0297353767752145,-452
"8289","1132113",0.782389916084477,429,0.798870307909284,430,-0.0164803918248076,-1
"8290","2132113",0.719166743576288,1286,0.742495823268461,1260,-0.0233290796921732,26
"8291","3132113",0.676052534762784,2339,0.713701990068682,1972,-0.0376494553058973,367
"8292","4132113",0.634578204062245,3756,0.671291614946871,3462,-0.0367134108846269,294
"8293","1232113",0.728432138491481,1114,0.743566028963578,1242,-0.0151338904720976,-128
"8294","2232113",0.665208965983292,2653,0.687191544322755,2846,-0.0219825783394632,-193
"8295","3232113",0.622094757169788,4258,0.658397711122976,4035,-0.0363029539531872,223
"8296","4232113",0.580620426469248,6168,0.615987336001165,6172,-0.0353669095319168,-4
"8297","1332113",0.700452668214705,1684,0.71651546163028,1897,-0.0160627934155758,-213
"8298","2332113",0.637229495706516,3667,0.660140976989457,3964,-0.0229114812829414,-297
"8299","3332113",0.594115286893012,5510,0.631347143789678,5343,-0.0372318568966654,167
"8300","4332113",0.552640956192472,7556,0.588936768667867,7661,-0.036295812475395,-105
"8301","1432113",0.661516170229709,2774,0.675885957662175,3291,-0.014369787432466,-517
"8302","2432113",0.59829299772152,5309,0.619511473021351,5966,-0.0212184752998317,-657
"8303","3432113",0.555178788908016,7446,0.590717639821572,7563,-0.0355388509135557,-117
"8304","4432113",0.513704458207476,9581,0.548307264699762,9990,-0.0346028064922853,-409
"8305","1142113",0.733356351629647,1036,0.7584718137822,958,-0.0251154621525531,78
"8306","2142113",0.670133179121458,2500,0.702097329141377,2354,-0.0319641500199187,146
"8307","3142113",0.627018970307955,4035,0.673303495941598,3382,-0.0462845256336427,653
"8308","4142113",0.585544639607415,5916,0.630893120819787,5366,-0.0453484812123723,550
"8309","1242113",0.679398574036651,2246,0.703167534836494,2310,-0.023768960799843,-64
"8310","2242113",0.616175401528462,4494,0.646793050195671,4570,-0.0306176486672086,-76
"8311","3242113",0.573061192714959,6531,0.617999216995891,6046,-0.0449380242809326,485
"8312","4242113",0.531586862014419,8642,0.575588841874081,8458,-0.0440019798596623,184
"8313","1342113",0.651419103759875,3143,0.676116967503196,3286,-0.0246978637433213,-143
"8314","2342113",0.588195931251686,5771,0.619742482862373,5955,-0.0315465516106869,-184
"8315","3342113",0.545081722438183,7963,0.590948649662594,7549,-0.0458669272244109,414
"8316","4342113",0.503607391737643,10085,0.548538274540783,9977,-0.0449308828031405,108
"8317","1442113",0.612482605774879,4683,0.63548746353509,5144,-0.0230048577602114,-461
"8318","2442113",0.54925943326669,7732,0.579112978894267,8248,-0.0298535456275771,-516
"8319","3442113",0.506145224453187,9944,0.550319145694488,9877,-0.0441739212413012,67
"8320","4442113",0.464670893752647,11923,0.507908770572677,12120,-0.0432378768200308,-197
"8321","1113113",0.854818533543511,87,0.872408121625481,73,-0.0175895880819703,14
"8322","2113113",0.791595361035322,367,0.816033636984658,294,-0.0244382759493359,73
"8323","3113113",0.748481152221818,808,0.787239803784878,555,-0.0387586515630599,253
"8324","4113113",0.707006821521279,1544,0.744829428663068,1216,-0.0378226071417894,328
"8325","1213113",0.800860755950515,305,0.817103842679775,290,-0.0162430867292601,15
"8326","2213113",0.737637583442326,965,0.760729358038952,925,-0.0230917745966257,40
"8327","3213113",0.694523374628822,1828,0.731935524839172,1496,-0.0374121502103497,332
"8328","4213113",0.653049043928282,3073,0.689525149717362,2758,-0.0364761057890794,315
"8329","1313113",0.772881285673739,521,0.790053275346477,517,-0.0171719896727384,4
"8330","2313113",0.70965811316555,1483,0.733678790705654,1444,-0.024020677540104,39
"8331","3313113",0.666543904352046,2612,0.704884957505874,2253,-0.038341053153828,359
"8332","4313113",0.625069573651506,4125,0.662474582384064,3859,-0.0374050087325577,266
"8333","1413113",0.733944787688743,1026,0.749423771378371,1115,-0.0154789836896285,-89
"8334","2413113",0.670721615180554,2482,0.693049286737548,2639,-0.0223276715569942,-157
"8335","3413113",0.62760740636705,4012,0.664255453537768,3786,-0.0366480471707182,226
"8336","4413113",0.58613307566651,5881,0.621845078415958,5838,-0.035712002749448,43
"8337","1123113",0.786839262677091,397,0.811838809968074,324,-0.0249995472909835,73
"8338","2123113",0.723616090168902,1202,0.755464325327251,1001,-0.0318482351583491,201
"8339","3123113",0.680501881355398,2213,0.726670492127472,1624,-0.0461686107720731,589
"8340","4123113",0.639027550654859,3604,0.684260117005661,2958,-0.0452325663508026,646
"8341","1223113",0.732881485084095,1044,0.756534531022368,987,-0.0236530459382733,57
"8342","2223113",0.669658312575906,2516,0.700160046381545,2402,-0.0305017338056389,114
"8343","3223113",0.626544103762402,4054,0.671366213181765,3459,-0.0448221094193629,595
"8344","4223113",0.585069773061862,5949,0.628955838059955,5455,-0.0438860649980927,494
"8345","1323113",0.704902014807319,1592,0.72948396368907,1544,-0.0245819488817516,48
"8346","2323113",0.64167884229913,3498,0.673109479048247,3391,-0.0314306367491172,107
"8347","3323113",0.598564633485626,5296,0.644315645848467,4684,-0.0457510123628412,612
"8348","4323113",0.557090302785086,7339,0.601905270726657,6936,-0.0448149679415709,403
"8349","1423113",0.665965516822323,2628,0.688854459720964,2778,-0.0228889428986417,-150
"8350","2423113",0.602742344314134,5100,0.632479975080141,5289,-0.0297376307660074,-189
"8351","3423113",0.55962813550063,7186,0.603686141880362,6841,-0.0440580063797315,345
"8352","4423113",0.51815380480009,9341,0.561275766758551,9249,-0.0431219619584612,92
"8353","1133113",0.743506740511991,875,0.773373717520045,722,-0.0298669770080542,153
"8354","2133113",0.680283568003802,2220,0.716999232879222,1889,-0.0367156648754198,331
"8355","3133113",0.637169359190299,3669,0.688205399679443,2805,-0.0510360404891438,864
"8356","4133113",0.595695028489759,5440,0.645795024557632,4618,-0.0500999960678735,822
"8357","1233113",0.689548962918995,1955,0.718069438574339,1858,-0.0285204756553442,97
"8358","2233113",0.626325790410806,4061,0.661694953933516,3904,-0.0353691635227098,157
"8359","3233113",0.583211581597303,6039,0.632901120733736,5271,-0.0496895391364338,768
"8360","4233113",0.541737250896763,8137,0.590490745611926,7573,-0.0487534947151633,564
"8361","1333113",0.661569492642219,2772,0.691018871241041,2707,-0.0294493785988225,65
"8362","2333113",0.59834632013403,5306,0.634644386600218,5199,-0.036298066466188,107
"8363","3333113",0.555232111320527,7443,0.605850553400439,6711,-0.0506184420799121,732
"8364","4333113",0.513757780619987,9579,0.563440178278628,9135,-0.0496823976586416,444
"8365","1433113",0.622632994657223,4233,0.650389367272936,4403,-0.0277563726157126,-170
"8366","2433113",0.559409822149034,7201,0.594014882632112,7403,-0.0346050604830783,-202
"8367","3433113",0.516295613335531,9454,0.565221049432333,9027,-0.0489254360968023,427
"8368","4433113",0.474821282634991,11484,0.522810674310523,11356,-0.0479893916755318,128
"8369","1143113",0.694473176057162,1832,0.732975223392961,1466,-0.0385020473357998,366
"8370","2143113",0.631250003548973,3870,0.676600738752138,3268,-0.0453507352031653,602
"8371","3143113",0.588135794735469,5772,0.647806905552359,4512,-0.0596711108168894,1260
"8372","4143113",0.546661464034929,7863,0.605396530430548,6743,-0.0587350663956189,1120
"8373","1243113",0.640515398464166,3545,0.677670944447255,3219,-0.0371555459830896,326
"8374","2243113",0.577292225955977,6324,0.621296459806432,5870,-0.0440042338504552,454
"8375","3243113",0.534178017142473,8502,0.592502626606652,7477,-0.0583246094641792,1025
"8376","4243113",0.492703686441933,10609,0.550092251484842,9890,-0.0573885650429089,719
"8377","1343113",0.61253592818739,4682,0.650620377113957,4389,-0.0380844489265678,293
"8378","2343113",0.549312755679201,7729,0.594245892473134,7390,-0.0449331367939334,339
"8379","3343113",0.506198546865697,9942,0.565452059273355,9017,-0.0592535124076574,925
"8380","4343113",0.464724216165157,11921,0.523041684151544,11346,-0.0583174679863872,575
"8381","1443113",0.573599430202393,6502,0.609990873145851,6484,-0.036391442943458,18
"8382","2443113",0.510376257694205,9745,0.553616388505028,9707,-0.0432401308108237,38
"8383","3443113",0.467262048880701,11803,0.524822555305249,11258,-0.0575605064245477,545
"8384","4443113",0.425787718180161,13483,0.482412180183438,13237,-0.0566244620032774,246
"8385","1114113",0.802611461572941,296,0.827757508251825,228,-0.0251460466788842,68
"8386","2114113",0.739388289064752,933,0.771383023611002,750,-0.0319947345462498,183
"8387","3114113",0.696274080251249,1789,0.742589190411223,1258,-0.0463151101599738,531
"8388","4114113",0.654799749550709,2989,0.700178815289412,2400,-0.0453790657387034,589
"8389","1214113",0.748653683979945,805,0.772453229306119,734,-0.0237995453261741,71
"8390","2214113",0.685430511471756,2072,0.716078744665296,1907,-0.0306482331935397,165
"8391","3214113",0.642316302658253,3472,0.687284911465516,2844,-0.0449686088072637,628
"8392","4214113",0.600841971957713,5190,0.644874536343706,4659,-0.0440325643859933,531
"8393","1314113",0.720674213703169,1262,0.745402661972821,1200,-0.0247284482696524,62
"8394","2314113",0.65745104119498,2908,0.689028177331998,2771,-0.031577136137018,137
"8395","3314113",0.614336832381476,4592,0.660234344132218,3959,-0.045897511750742,633
"8396","4314113",0.572862501680936,6539,0.617823969010408,6056,-0.0449614673294716,483
"8397","1414113",0.681737715718173,2176,0.704773158004715,2255,-0.0230354422865425,-79
"8398","2414113",0.618514543209984,4405,0.648398673363892,4480,-0.0298841301539082,-75
"8399","3414113",0.57540033439648,6405,0.619604840164113,5961,-0.0442045057676322,444
"8400","4414113",0.53392600369594,8511,0.577194465042302,8364,-0.0432684613463619,147
"8401","1124113",0.734632190706521,1017,0.767188196594419,820,-0.0325560058878974,197
"8402","2124113",0.671409018198332,2463,0.710813711953595,2060,-0.039404693755263,403
"8403","3124113",0.628294809384829,3990,0.682019878753816,3051,-0.053725069368987,939
"8404","4124113",0.586820478684289,5834,0.639609503632005,4944,-0.0527890249477166,890
"8405","1224113",0.680674413113525,2209,0.711883917648712,2017,-0.0312095045351873,192
"8406","2224113",0.617451240605336,4444,0.655509433007889,4166,-0.0380581924025529,278
"8407","3224113",0.574337031791833,6465,0.62671559980811,5583,-0.0523785680162769,882
"8408","4224113",0.532862701091293,8580,0.584305224686299,7930,-0.0514425235950066,650
"8409","1324113",0.652694942836749,3091,0.684833350315414,2934,-0.0321384074786656,157
"8410","2324113",0.58947177032856,5711,0.628458865674591,5480,-0.0389870953460312,231
"8411","3324113",0.546357561515056,7882,0.599665032474812,7077,-0.0533074709597552,805
"8412","4324113",0.504883230814516,10012,0.557254657353001,9495,-0.0523714265384848,517
"8413","1424113",0.613758444851753,4626,0.644203846347309,4688,-0.0304454014955557,-62
"8414","2424113",0.550535272343564,7674,0.587829361706485,7720,-0.0372940893629214,-46
"8415","3424113",0.50742106353006,9878,0.559035528506706,9395,-0.0516144649766455,483
"8416","4424113",0.46594673282952,11861,0.516625153384896,11684,-0.0506784205553751,177
"8417","1134113",0.691299668541421,1928,0.72872310414639,1570,-0.0374234356049682,358
"8418","2134113",0.628076496033233,3996,0.672348619505566,3429,-0.0442721234723338,567
"8419","3134113",0.584962287219729,5951,0.643554786305787,4730,-0.0585924990860578,1221
"8420","4134113",0.543487956519189,8044,0.601144411183977,6990,-0.0576564546647874,1054
"8421","1234113",0.637341890948425,3663,0.673418825200683,3378,-0.0360769342522581,285
"8422","2234113",0.574118718440236,6473,0.61704434055986,6106,-0.0429256221196237,367
"8423","3234113",0.531004509626733,8681,0.588250507360081,7699,-0.0572459977333477,982
"8424","4234113",0.489530178926193,10770,0.54584013223827,10122,-0.0563099533120773,648
"8425","1334113",0.609362420671649,4832,0.646368257867385,4589,-0.0370058371957364,243
"8426","2334113",0.54613924816346,7896,0.589993773226562,7601,-0.0438545250631019,295
"8427","3334113",0.503025039349957,10117,0.561199940026783,9254,-0.058174900676826,863
"8428","4334113",0.461550708649417,12064,0.518789564904972,11566,-0.0572388562555556,498
"8429","1434113",0.570425922686653,6668,0.60573875389928,6718,-0.0353128312126265,-50
"8430","2434113",0.507202750178464,9891,0.549364269258456,9928,-0.0421615190799922,-37
"8431","3434113",0.464088541364961,11952,0.520570436058677,11464,-0.0564818946937162,488
"8432","4434113",0.422614210664421,13592,0.478160060936867,13412,-0.0555458502724459,180
"8433","1144113",0.642266104086592,3474,0.688324610019306,2802,-0.0460585059327137,672
"8434","2144113",0.579042931578403,6253,0.631950125378482,5323,-0.0529071938000792,930
"8435","3144113",0.5359287227649,8424,0.603156292178703,6871,-0.0672275694138033,1553
"8436","4144113",0.49445439206436,10520,0.560745917056892,9281,-0.0662915249925329,1239
"8437","1244113",0.588308326493596,5768,0.633020331073599,5263,-0.0447120045800036,505
"8438","2244113",0.525085153985407,8997,0.576645846432776,8390,-0.0515606924473692,607
"8439","3244113",0.481970945171903,11139,0.547852013232997,10013,-0.0658810680610932,1126
"8440","4244113",0.440496614471363,12925,0.505441638111186,12227,-0.0649450236398228,698
"8441","1344113",0.56032885621682,7160,0.605969763740301,6701,-0.0456409075234818,459
"8442","2344113",0.497105683708631,10406,0.549595279099478,9912,-0.0524895953908474,494
"8443","3344113",0.453991474895127,12390,0.520801445899699,11452,-0.0668099710045714,938
"8444","4344113",0.412517144194587,13923,0.478391070777888,13399,-0.0658739265833011,524
"8445","1444113",0.521392358231824,9178,0.565340259772196,9022,-0.043947901540372,156
"8446","2444113",0.458169185723635,12225,0.508965775131372,12066,-0.0507965894077377,159
"8447","3444113",0.415054976910131,13844,0.480171941931593,13328,-0.0651169650214617,516
"8448","4444113",0.373580646209591,14973,0.437761566809783,14766,-0.0641809206001914,207
"8449","1111213",0.880937786729475,43,0.89088884688859,41,-0.00995106015911507,2
"8450","2111213",0.817714614221286,207,0.834514362247767,193,-0.0167997480264807,14
"8451","3111213",0.774600405407783,507,0.805720529047988,374,-0.0311201236402047,133
"8452","4111213",0.733126074707243,1039,0.763310153926177,886,-0.0301840792189343,153
"8453","1211213",0.826980009136479,171,0.835584567942884,184,-0.00860455880640498,-13
"8454","2211213",0.76375683662829,621,0.779210083302061,647,-0.0154532466737706,-26
"8455","3211213",0.720642627814787,1264,0.750416250102281,1094,-0.0297736222874946,170
"8456","4211213",0.679168297114247,2253,0.708005874980471,2143,-0.0288375778662242,110
"8457","1311213",0.799000538859703,320,0.808534000609586,353,-0.00953346174988323,-33
"8458","2311213",0.735777366351514,998,0.752159515968763,1061,-0.0163821496172488,-63
"8459","3311213",0.69266315753801,1886,0.723365682768983,1717,-0.0307025252309728,169
"8460","4311213",0.651188826837471,3150,0.680955307647173,3094,-0.0297664808097025,56
"8461","1411213",0.760064040874707,669,0.76790449664148,799,-0.00784045576677339,-130
"8462","2411213",0.696840868366518,1781,0.711530012000657,2028,-0.0146891436341391,-247
"8463","3411213",0.653726659553015,3043,0.682736178800878,3015,-0.0290095192478631,28
"8464","4411213",0.612252328852475,4696,0.640325803679067,4899,-0.0280734748265927,-203
"8465","1121213",0.812958515863055,233,0.830319535231184,217,-0.0173610193681283,16
"8466","2121213",0.749735343354866,787,0.77394505059036,714,-0.0242097072354939,73
"8467","3121213",0.706621134541363,1554,0.745151217390581,1208,-0.0385300828492179,346
"8468","4121213",0.665146803840823,2655,0.70274084226877,2328,-0.0375940384279475,327
"8469","1221213",0.759000738270059,679,0.775015256285477,695,-0.0160145180154182,-16
"8470","2221213",0.69577756576187,1799,0.718640771644654,1837,-0.0228632058827838,-38
"8471","3221213",0.652663356948367,3093,0.689846938444875,2749,-0.0371835814965078,344
"8472","4221213",0.611189026247827,4750,0.647436563323064,4535,-0.0362475370752374,215
"8473","1321213",0.731021267993283,1076,0.747964688952179,1149,-0.0169434209588964,-73
"8474","2321213",0.667798095485094,2578,0.691590204311356,2690,-0.023792108826262,-112
"8475","3321213",0.624683886671591,4144,0.662796371111577,3848,-0.038112484439986,296
"8476","4321213",0.583209555971051,6041,0.620385995989766,5924,-0.0371764400187157,117
"8477","1421213",0.692084770008287,1902,0.707335184984074,2171,-0.0152504149757866,-269
"8478","2421213",0.628861597500098,3970,0.65096070034325,4371,-0.0220991028431523,-401
"8479","3421213",0.585747388686595,5901,0.622166867143471,5822,-0.0364194784568763,79
"8480","4421213",0.544273057986055,8002,0.579756492021661,8212,-0.0354834340356059,-210
"8481","1131213",0.769625993697956,560,0.791854442783155,494,-0.0222284490851991,66
"8482","2131213",0.706402821189767,1563,0.735479958142331,1411,-0.0290771369525646,152
"8483","3131213",0.663288612376263,2725,0.706686124942552,2197,-0.0433975125662887,528
"8484","4131213",0.621814281675723,4265,0.664275749820742,3785,-0.0424614681450183,480
"8485","1231213",0.71566821610496,1355,0.736550163837448,1388,-0.020881947732489,-33
"8486","2231213",0.652445043596771,3103,0.680175679196625,3129,-0.0277306355998546,-26
"8487","3231213",0.609330834783267,4836,0.651381845996846,4348,-0.0420510112135786,488
"8488","4231213",0.567856504082727,6808,0.608971470875035,6555,-0.0411149667923082,253
"8489","1331213",0.687688745828183,2002,0.70949959650415,2099,-0.0218108506759672,-97
"8490","2331213",0.624465573319994,4157,0.653125111863327,4277,-0.0286595385433328,-120
"8491","3331213",0.581351364506491,6128,0.624331278663548,5703,-0.0429799141570568,425
"8492","4331213",0.539877033805951,8235,0.581920903541737,8088,-0.0420438697357864,147
"8493","1431213",0.648752247843187,3234,0.668870092536045,3570,-0.0201178446928574,-336
"8494","2431213",0.585529075334998,5922,0.612495607895222,6361,-0.0269665325602231,-439
"8495","3431213",0.542414866521495,8100,0.583701774695442,7965,-0.0412869081739471,135
"8496","4431213",0.500940535820955,10219,0.541291399573632,10402,-0.0403508637526767,-183
"8497","1141213",0.720592429243126,1265,0.751455948656071,1073,-0.0308635194129445,192
"8498","2141213",0.657369256734937,2913,0.695081464015247,2573,-0.0377122072803101,340
"8499","3141213",0.614255047921434,4596,0.666287630815468,3678,-0.0520325828940341,918
"8500","4141213",0.572780717220894,6540,0.623877255693657,5731,-0.0510965384727637,809
"8501","1241213",0.66663465165013,2610,0.696151669710364,2529,-0.0295170180602344,81
"8502","2241213",0.603411479141941,5073,0.639777185069541,4927,-0.0363657059276,146
"8503","3241213",0.560297270328438,7162,0.610983351869762,6436,-0.050686081541324,726
"8504","4241213",0.518822939627898,9294,0.568572976747951,8854,-0.0497500371200537,440
"8505","1341213",0.638655181373354,3612,0.669101102377066,3560,-0.0304459210037127,52
"8506","2341213",0.575432008865165,6403,0.612726617736243,6346,-0.0372946088710783,57
"8507","3341213",0.532317800051661,8603,0.583932784536464,7950,-0.0516149844848023,653
"8508","4341213",0.490843469351121,10693,0.541522409414653,10392,-0.0506789400635319,301
"8509","1441213",0.599718683388358,5243,0.628471598408961,5477,-0.0287529150206028,-234
"8510","2441213",0.536495510880169,8397,0.572097113768137,8648,-0.0356016028879685,-251
"8511","3441213",0.493381302066665,10572,0.543303280568358,10271,-0.0499219785016926,301
"8512","4441213",0.451906971366125,12463,0.500892905446548,12446,-0.0489859340804222,17
"8513","1112213",0.847852874967786,100,0.852569865359938,115,-0.0047169903921519,-15
"8514","2112213",0.784629702459597,412,0.796195380719115,452,-0.0115656782595175,-40
"8515","3112213",0.741515493646094,901,0.767401547519335,812,-0.0258860538732415,89
"8516","4112213",0.700041162945554,1690,0.724991172397525,1677,-0.0249500094519711,13
"8517","1212213",0.79389509737479,348,0.797265586414232,439,-0.00337048903944182,-91
"8518","2212213",0.730671924866601,1082,0.740891101773409,1294,-0.0102191769068074,-212
"8519","3212213",0.687557716053098,2008,0.712097268573629,2006,-0.0245395525205314,2
"8520","4212213",0.646083385352558,3329,0.669686893451819,3526,-0.023603508099261,-197
"8521","1312213",0.765915627098014,595,0.770215019080934,772,-0.00429939198292006,-177
"8522","2312213",0.702692454589825,1638,0.713840534440111,1969,-0.0111480798502857,-331
"8523","3312213",0.659578245776322,2826,0.685046701240331,2927,-0.0254684554640097,-101
"8524","4312213",0.618103915075782,4423,0.642636326118521,4784,-0.0245324110427393,-361
"8525","1412213",0.726979129113018,1139,0.729585515112828,1540,-0.00260638599981022,-401
"8526","2412213",0.663755956604829,2708,0.673211030472005,3387,-0.00945507386717592,-679
"8527","3412213",0.620641747791326,4303,0.644417197272226,4680,-0.0237754494808999,-377
"8528","4412213",0.579167417090786,6249,0.602006822150415,6933,-0.0228394050596296,-684
"8529","1122213",0.779873604101366,451,0.792000553702531,493,-0.0121269496011651,-42
"8530","2122213",0.716650431593177,1332,0.735626069061708,1407,-0.0189756374685307,-75
"8531","3122213",0.673536222779674,2399,0.706832235861929,2189,-0.0332960130822547,210
"8532","4122213",0.632061892079134,3841,0.664421860740118,3779,-0.0323599686609843,62
"8533","1222213",0.72591582650837,1161,0.736696274756825,1382,-0.010780448248455,-221
"8534","2222213",0.662692654000181,2737,0.680321790116002,3120,-0.0176291361158206,-383
"8535","3222213",0.619578445186678,4355,0.651527956916222,4338,-0.0319495117295446,17
"8536","4222213",0.578104114486138,6292,0.609117581794412,6547,-0.0310134673082743,-255
"8537","1322213",0.697936356231594,1743,0.709645707423527,2094,-0.0117093511919333,-351
"8538","2322213",0.634713183723405,3750,0.653271222782704,4273,-0.0185580390592989,-523
"8539","3322213",0.591598974909902,5597,0.624477389582925,5696,-0.0328784146730229,-99
"8540","4322213",0.550124644209362,7700,0.582067014461114,8081,-0.0319423702517525,-381
"8541","1422213",0.658999858246598,2847,0.669016203455421,3566,-0.0100163452088234,-719
"8542","2422213",0.595776685738409,5436,0.612641718814598,6355,-0.0168650330761891,-919
"8543","3422213",0.552662476924906,7552,0.583847885614819,7958,-0.0311854086899132,-406
"8544","4422213",0.511188146224366,9709,0.541437510493008,10397,-0.0302493642686428,-688
"8545","1132213",0.736541081936267,986,0.753535461254503,1033,-0.0169943793182359,-47
"8546","2132213",0.673317909428078,2410,0.697160976613679,2502,-0.0238430671856015,-92
"8547","3132213",0.630203700614574,3909,0.6683671434139,3601,-0.0381634427993255,308
"8548","4132213",0.588729369914034,5745,0.62595676829209,5616,-0.0372273983780551,129
"8549","1232213",0.68258330434327,2152,0.698231182308796,2472,-0.0156478779655258,-320
"8550","2232213",0.619360131835082,4368,0.641856697667973,4822,-0.0224965658328914,-454
"8551","3232213",0.576245923021578,6372,0.613062864468194,6327,-0.0368169414466154,45
"8552","4232213",0.534771592321038,8473,0.570652489346383,8745,-0.035880897025345,-272
"8553","1332213",0.654603834066494,3004,0.671180614975498,3465,-0.0165767809090041,-461
"8554","2332213",0.591380661558305,5614,0.614806130334675,6220,-0.0234254687763696,-606
"8555","3332213",0.548266452744802,7776,0.586012297134896,7834,-0.0377458443900937,-58
"8556","4332213",0.506792122044262,9913,0.543601922013085,10259,-0.0368097999688233,-346
"8557","1432213",0.615667336081498,4512,0.630551111007393,5379,-0.0148837749258942,-867
"8558","2432213",0.55244416357331,7570,0.574176626366569,8538,-0.0217324627932599,-968
"8559","3432213",0.509329954759806,9782,0.54538279316679,10151,-0.0360528384069839,-369
"8560","4432213",0.467855624059266,11782,0.50297241804498,12347,-0.0351167939857135,-565
"8561","1142213",0.687507517481437,2010,0.713136967127418,1980,-0.0256294496459814,30
"8562","2142213",0.624284344973248,4170,0.656762482486595,4113,-0.0324781375133469,57
"8563","3142213",0.581170136159745,6137,0.627968649286816,5507,-0.046798513127071,630
"8564","4142213",0.539695805459205,8245,0.585558274165005,7858,-0.0458624687058006,387
"8565","1242213",0.633549739888441,3793,0.657832688181712,4059,-0.0242829482932713,-266
"8566","2242213",0.570326567380252,6675,0.601458203540889,6964,-0.0311316361606369,-289
"8567","3242213",0.527212358566749,8890,0.57266437034111,8610,-0.0454520117743609,280
"8568","4242213",0.485738027866209,10966,0.530253995219299,10991,-0.0445159673530905,-25
"8569","1342213",0.605570269611665,4984,0.630782120848414,5370,-0.0252118512367495,-386
"8570","2342213",0.542347097103476,8104,0.574407636207591,8525,-0.0320605391041151,-421
"8571","3342213",0.499232888289972,10304,0.545613803007812,10135,-0.0463809147178391,169
"8572","4342213",0.457758557589433,12235,0.503203427886001,12338,-0.0454448702965687,-103
"8573","1442213",0.566633771626669,6856,0.590152616880309,7594,-0.0235188452536397,-738
"8574","2442213",0.50341059911848,10097,0.533778132239485,10805,-0.0303675331210054,-708
"8575","3442213",0.460296390304976,12122,0.504984299039706,12247,-0.0446879087347294,-125
"8576","4442213",0.418822059604437,13731,0.462573923917895,13995,-0.043751864313459,-264
"8577","1113213",0.808969699395301,255,0.827073274970699,234,-0.0181035755753985,21
"8578","2113213",0.745746526887112,849,0.770698790329876,762,-0.0249522634427641,87
"8579","3113213",0.702632318073608,1641,0.741904957130096,1270,-0.0392726390564881,371
"8580","4113213",0.661157987373068,2781,0.699494582008286,2426,-0.0383365946352177,355
"8581","1213213",0.755011921802305,720,0.771768996024993,742,-0.0167570742226884,-22
"8582","2213213",0.691788749294116,1912,0.71539451138417,1922,-0.0236057620900539,-10
"8583","3213213",0.648674540480612,3237,0.68660067818439,2867,-0.037926137703778,370
"8584","4213213",0.607200209780072,4924,0.64419030306258,4690,-0.0369900932825077,234
"8585","1313213",0.727032451525528,1138,0.744718428691695,1218,-0.0176859771661666,-80
"8586","2313213",0.66380927901734,2706,0.688343944050872,2801,-0.0245346650335322,-95
"8587","3313213",0.620695070203836,4300,0.659550110851092,3989,-0.0388550406472562,311
"8588","4313213",0.579220739503296,6246,0.617139735729282,6102,-0.0379189962259859,144
"8589","1413213",0.688095953540532,1994,0.704088924723589,2272,-0.0159929711830568,-278
"8590","2413213",0.624872781032344,4137,0.647714440082766,4517,-0.0228416590504225,-380
"8591","3413213",0.58175857221884,6104,0.618920606882987,5996,-0.0371620346641465,108
"8592","4413213",0.5402842415183,8220,0.576510231761176,8399,-0.0362259902428762,-179
"8593","1123213",0.740990428528881,909,0.766503963313292,834,-0.0255135347844118,75
"8594","2123213",0.677767256020692,2296,0.710129478672469,2081,-0.0323622226517774,215
"8595","3123213",0.634653047207188,3753,0.68133564547269,3081,-0.0466825982655014,672
"8596","4123213",0.593178716506648,5545,0.638925270350879,4994,-0.0457465538442309,551
"8597","1223213",0.687032650935885,2024,0.711199684367586,2042,-0.0241670334317016,-18
"8598","2223213",0.623809478427696,4185,0.654825199726763,4197,-0.0310157212990672,-12
"8599","3223213",0.580695269614192,6164,0.626031366526983,5614,-0.0453360969127912,550
"8600","4223213",0.539220938913652,8266,0.583620991405173,7974,-0.0444000524915209,292
"8601","1323213",0.659053180659108,2845,0.684149117034288,2964,-0.0250959363751798,-119
"8602","2323213",0.59583000815092,5432,0.627774632393465,5522,-0.0319446242425454,-90
"8603","3323213",0.552715799337416,7550,0.598980799193686,7117,-0.0462649998562694,433
"8604","4323213",0.511241468636876,9706,0.556570424071875,9539,-0.0453289554349992,167
"8605","1423213",0.620116682674112,4332,0.643519613066182,4734,-0.02340293039207,-402
"8606","2423213",0.556893510165924,7350,0.587145128425359,7766,-0.0302516182594357,-416
"8607","3423213",0.51377930135242,9577,0.55835129522558,9429,-0.0445719938731597,148
"8608","4423213",0.47230497065188,11602,0.515940920103769,11720,-0.0436359494518894,-118
"8609","1133213",0.697657906363781,1751,0.728038870865264,1586,-0.0303809645014824,165
"8610","2133213",0.634434733855592,3765,0.67166438622444,3452,-0.037229652368848,313
"8611","3133213",0.591320525042089,5617,0.642870553024661,4770,-0.051550027982572,847
"8612","4133213",0.549846194341549,7708,0.60046017790285,7036,-0.0506139835613018,672
"8613","1233213",0.643700128770785,3405,0.672734591919557,3405,-0.0290344631487724,0
"8614","2233213",0.580476956262596,6177,0.616360107278734,6149,-0.035883151016138,28
"8615","3233213",0.537362747449093,8353,0.587566274078955,7737,-0.050203526629862,616
"8616","4233213",0.495888416748553,10456,0.545155898957144,10161,-0.0492674822085916,295
"8617","1333213",0.615720658494009,4506,0.645684024586259,4623,-0.0299633660922507,-117
"8618","2333213",0.55249748598582,7566,0.589309539945436,7644,-0.0368120539596163,-78
"8619","3333213",0.509383277172316,9778,0.560515706745657,9295,-0.0511324295733403,483
"8620","4333213",0.467908946471776,11779,0.518105331623846,11610,-0.0501963851520698,169
"8621","1433213",0.576784160509013,6346,0.605054520618154,6769,-0.0282703601091409,-423
"8622","2433213",0.513560988000824,9590,0.54868003597733,9969,-0.0351190479765066,-379
"8623","3433213",0.47044677918732,11670,0.519886202777551,11503,-0.0494394235902306,167
"8624","4433213",0.42897244848678,13378,0.477475827655741,13448,-0.04850337916896,-70
"8625","1143213",0.648624341908951,3240,0.68764037673818,2825,-0.039016034829228,415
"8626","2143213",0.585401169400763,5932,0.631265892097356,5346,-0.0458647226965936,586
"8627","3143213",0.542286960587259,8106,0.602472058897577,6902,-0.0601850983103176,1204
"8628","4143213",0.500812629886719,10222,0.560061683775766,9328,-0.0592490538890471,894
"8629","1243213",0.594666564315955,5486,0.632336097792473,5297,-0.0376695334765178,189
"8630","2243213",0.531443391807767,8656,0.57596161315165,8428,-0.0445182213438834,228
"8631","3243213",0.488329182994263,10839,0.54716777995187,10045,-0.0588385969576074,794
"8632","4243213",0.446854852293723,12688,0.50475740483006,12257,-0.0579025525363371,431
"8633","1343213",0.566687094039179,6852,0.605285530459175,6755,-0.038598436419996,97
"8634","2343213",0.50346392153099,10093,0.548911045818352,9956,-0.0454471242873616,137
"8635","3343213",0.460349712717487,12120,0.520117212618573,11487,-0.0597674999010857,633
"8636","4343213",0.418875382016947,13729,0.477706837496762,13436,-0.0588314554798153,293
"8637","1443213",0.527750596054183,8856,0.56465602649107,9059,-0.0369054304368862,-203
"8638","2443213",0.464527423545994,11932,0.508281541850246,12096,-0.0437541183042519,-164
"8639","3443213",0.421413214732491,13634,0.479487708650467,13353,-0.0580744939179759,281
"8640","4443213",0.379938884031951,14842,0.437077333528656,14782,-0.0571384494967056,60
"8641","1114213",0.756762627424731,699,0.782422661597043,601,-0.0256600341723124,98
"8642","2114213",0.693539454916542,1859,0.72604817695622,1638,-0.032508722039678,221
"8643","3114213",0.650425246103039,3174,0.697254343756441,2497,-0.046829097653402,677
"8644","4114213",0.608950915402499,4847,0.65484396863463,4195,-0.0458930532321317,652
"8645","1214213",0.702804849831735,1631,0.727118382651337,1607,-0.0243135328196024,24
"8646","2214213",0.639581677323546,3574,0.670743898010514,3480,-0.0311622206869679,94
"8647","3214213",0.596467468510042,5392,0.641950064810734,4819,-0.045482596300692,573
"8648","4214213",0.554993137809502,7448,0.599539689688924,7082,-0.0445465518794216,366
"8649","1314213",0.674825379554959,2368,0.700067815318039,2404,-0.0252424357630806,-36
"8650","2314213",0.61160220704677,4717,0.643693330677216,4722,-0.0320911236304462,-5
"8651","3314213",0.568487998233266,6766,0.614899497477436,6216,-0.0464114992441702,550
"8652","4314213",0.527013667532726,8902,0.572489122355626,8622,-0.0454754548228998,280
"8653","1414213",0.635888881569963,3715,0.659438311349933,3992,-0.0235494297799708,-277
"8654","2414213",0.572665709061774,6547,0.60306382670911,6876,-0.0303981176473365,-329
"8655","3414213",0.52955150024827,8754,0.574269993509331,8534,-0.0447184932610605,220
"8656","4414213",0.48807716954773,10852,0.53185961838752,10898,-0.0437824488397901,-46
"8657","1124213",0.688783356558311,1972,0.721853349939637,1756,-0.0330699933813257,216
"8658","2124213",0.625560184050122,4097,0.665478865298813,3722,-0.0399186812486912,375
"8659","3124213",0.582445975236619,6066,0.636685032099034,5091,-0.0542390568624153,975
"8660","4124213",0.540971644536079,8177,0.594274656977223,7388,-0.0533030124411449,789
"8661","1224213",0.634825578965315,3745,0.66654907099393,3664,-0.0317234920286156,81
"8662","2224213",0.571602406457126,6598,0.610174586353107,6473,-0.0385721798959812,125
"8663","3224213",0.528488197643622,8811,0.581380753153328,8113,-0.0528925555097052,698
"8664","4224213",0.487013866943082,10904,0.538970378031517,10523,-0.0519565110884348,381
"8665","1324213",0.606846108688539,4936,0.639498503660632,4953,-0.0326523949720938,-17
"8666","2324213",0.54362293618035,8031,0.583124019019809,8007,-0.0395010828394594,24
"8667","3324213",0.500508727366846,10234,0.55433018582003,9663,-0.0538214584531834,571
"8668","4324213",0.459034396666306,12188,0.511919810698219,11936,-0.052885414031913,252
"8669","1424213",0.567909610703543,6804,0.598868999692527,7120,-0.030959388988984,-316
"8670","2424213",0.504686438195354,10020,0.542494515051703,10318,-0.0378080768563497,-298
"8671","3424213",0.46157222938185,12063,0.513700681851924,11844,-0.0521284524700737,219
"8672","4424213",0.42009789868131,13688,0.471290306730114,13711,-0.0511924080488033,-23
"8673","1134213",0.645450834393211,3350,0.683388257491608,2990,-0.0379374230983964,360
"8674","2134213",0.582227661885022,6085,0.627013772850784,5562,-0.044786110965762,523
"8675","3134213",0.539113453071519,8273,0.598219939651005,7164,-0.059106486579486,1109
"8676","4134213",0.497639122370979,10381,0.555809564529195,9587,-0.0581704421582157,794
"8677","1234213",0.591493056800215,5607,0.628083978545901,5498,-0.0365909217456863,109
"8678","2234213",0.528269884292026,8827,0.571709493905078,8674,-0.0434396096130519,153
"8679","3234213",0.485155675478523,10989,0.542915660705299,10292,-0.057759985226776,697
"8680","4234213",0.443681344777983,12809,0.500505285583488,12470,-0.0568239408055056,339
"8681","1334213",0.563513586523439,6986,0.601033411212604,6996,-0.0375198246891646,-10
"8682","2334213",0.50029041401525,10251,0.54465892657178,10197,-0.0443685125565302,54
"8683","3334213",0.457176205201747,12252,0.515865093372001,11725,-0.0586888881702542,527
"8684","4334213",0.415701874501207,13824,0.47345471825019,13624,-0.0577528437489838,200
"8685","1434213",0.524577088538443,9017,0.560403907244498,9301,-0.0358268187060548,-284
"8686","2434213",0.461353916030254,12077,0.504029422603675,12298,-0.0426755065734205,-221
"8687","3434213",0.418239707216751,13744,0.475235589403895,13540,-0.0569958821871444,204
"8688","4434213",0.376765376516211,14912,0.432825214282085,14899,-0.0560598377658741,13
"8689","1144213",0.596417269938382,5399,0.642989763364524,4759,-0.0465724934261419,640
"8690","2144213",0.533194097430193,8567,0.5866152787237,7800,-0.0534211812935075,767
"8691","3144213",0.490079888616689,10741,0.557821445523921,9454,-0.0677415569072315,1287
"8692","4144213",0.448605557916149,12613,0.515411070402111,11752,-0.0668055124859611,861
"8693","1244213",0.542459492345386,8095,0.587685484418817,7724,-0.0452259920734318,371
"8694","2244213",0.479236319837197,11257,0.531310999777994,10923,-0.0520746799407974,334
"8695","3244213",0.436122111023693,13094,0.502517166578215,12366,-0.0663950555545214,728
"8696","4244213",0.394647780323153,14458,0.460106791456404,14080,-0.065459011133251,378
"8697","1344213",0.514480022068609,9535,0.56063491708552,9287,-0.0461548950169101,248
"8698","2344213",0.451256849560421,12491,0.504260432444696,12283,-0.0530035828842756,208
"8699","3344213",0.408142640746917,14055,0.475466599244917,13529,-0.0673239584979996,526
"8700","4344213",0.366668310046377,15131,0.433056224123106,14891,-0.0663879140767293,240
"8701","1444213",0.475543524083613,11443,0.520005413117414,11494,-0.0444618890338002,-51
"8702","2444213",0.412320351575425,13928,0.46363092847659,13957,-0.0513105769011659,-29
"8703","3444213",0.369206142761921,15066,0.434837095276811,14846,-0.06563095251489,220
"8704","4444213",0.327731812061381,15763,0.392426720155001,15690,-0.0646949080936196,73
"8705","1111313",0.858483807724167,78,0.872838856960916,70,-0.0143550492367485,8
"8706","2111313",0.795260635215978,339,0.816464372320092,291,-0.021203737104114,48
"8707","3111313",0.752146426402475,756,0.787670539120313,548,-0.0355241127178381,208
"8708","4111313",0.710672095701935,1456,0.745260163998503,1202,-0.0345880682965678,254
"8709","1211313",0.804526030131171,283,0.81753457801521,285,-0.0130085478840385,-2
"8710","2211313",0.741302857622982,905,0.761160093374386,917,-0.0198572357514041,-12
"8711","3211313",0.698188648809479,1739,0.732366260174607,1485,-0.0341776113651281,254
"8712","4211313",0.656714318108939,2933,0.689955885052796,2742,-0.0332415669438576,191
"8713","1311313",0.776546559854395,482,0.790484010681912,511,-0.0139374508275167,-29
"8714","2311313",0.713323387346206,1401,0.734109526041088,1435,-0.0207861386948823,-34
"8715","3311313",0.670209178532702,2499,0.705315692841309,2241,-0.0351065143086063,258
"8716","4311313",0.628734847832163,3975,0.662905317719498,3845,-0.0341704698873359,130
"8717","1411313",0.737610061869399,968,0.749854506713806,1103,-0.0122444448444069,-135
"8718","2411313",0.67438688936121,2388,0.693480022072983,2623,-0.0190931327117726,-235
"8719","3411313",0.631272680547706,3869,0.664686188873203,3764,-0.0334135083254966,105
"8720","4411313",0.589798349847167,5696,0.622275813751393,5815,-0.0324774639042261,-119
"8721","1121313",0.790504536857747,374,0.812269545303509,320,-0.0217650084457617,54
"8722","2121313",0.727281364349558,1133,0.755895060662686,995,-0.0286136963131273,138
"8723","3121313",0.684167155536055,2101,0.727101227462906,1609,-0.0429340719268513,492
"8724","4121313",0.642692824835515,3456,0.684690852341096,2939,-0.041998027505581,517
"8725","1221313",0.736546759264751,984,0.756965266357803,977,-0.0204185070930517,7
"8726","2221313",0.673323586756562,2408,0.700590781716979,2385,-0.0272671949604173,23
"8727","3221313",0.630209377943059,3908,0.6717969485172,3445,-0.0415875705741413,463
"8728","4221313",0.588735047242519,5744,0.62938657339539,5439,-0.0406515261528708,305
"8729","1321313",0.708567288987975,1504,0.729914699024505,1534,-0.02134741003653,-30
"8730","2321313",0.645344116479786,3357,0.673540214383682,3373,-0.0281960979038955,-16
"8731","3321313",0.602229907666282,5123,0.644746381183902,4667,-0.0425164735176196,456
"8732","4321313",0.560755576965743,7131,0.602336006062092,6914,-0.0415804290963491,217
"8733","1421313",0.669630791002979,2520,0.689285195056399,2763,-0.0196544040534201,-243
"8734","2421313",0.60640761849479,4960,0.632910710415576,5269,-0.0265030919207858,-309
"8735","3421313",0.563293409681286,6999,0.604116877215796,6819,-0.0408234675345098,180
"8736","4421313",0.521819078980747,9155,0.561706502093986,9230,-0.0398874231132393,-75
"8737","1131313",0.747172014692647,823,0.77380445285548,716,-0.0266324381628326,107
"8738","2131313",0.683948842184459,2103,0.717429968214657,1874,-0.0334811260301981,229
"8739","3131313",0.640834633370955,3528,0.688636135014877,2788,-0.0478015016439222,740
"8740","4131313",0.599360302670415,5264,0.646225759893067,4594,-0.0468654572226517,670
"8741","1231313",0.693214237099651,1870,0.718500173909774,1843,-0.0252859368101224,27
"8742","2231313",0.629991064591463,3913,0.66212568926895,3874,-0.032134624677488,39
"8743","3231313",0.586876855777959,5833,0.633331856069171,5252,-0.046455000291212,581
"8744","4231313",0.545402525077419,7945,0.590921480947361,7551,-0.0455189558699417,394
"8745","1331313",0.665234766822875,2652,0.691449606576476,2694,-0.0262148397536006,-42
"8746","2331313",0.602011594314686,5133,0.635075121935653,5173,-0.0330635276209662,-40
"8747","3331313",0.558897385501183,7229,0.606281288735873,6683,-0.0473839032346902,546
"8748","4331313",0.517423054800643,9385,0.563870913614063,9113,-0.04644785881342,272
"8749","1431313",0.626298268837879,4063,0.65082010260837,4376,-0.0245218337704908,-313
"8750","2431313",0.56307509632969,7010,0.594445617967547,7373,-0.0313705216378565,-363
"8751","3431313",0.519960887516187,9237,0.565651784767767,9005,-0.0456908972515805,232
"8752","4431313",0.478486556815647,11298,0.523241409645957,11332,-0.0447548528303102,-34
"8753","1141313",0.698138450237818,1740,0.733405958728396,1454,-0.0352675084905779,286
"8754","2141313",0.634915277729629,3743,0.677031474087573,3247,-0.0421161963579435,496
"8755","3141313",0.591801068916126,5592,0.648237640887793,4488,-0.0564365719716675,1104
"8756","4141313",0.550326738215586,7691,0.605827265765983,6712,-0.0555005275503972,979
"8757","1241313",0.644180672644822,3395,0.67810167978269,3200,-0.0339210071378679,195
"8758","2241313",0.580957500136633,6149,0.621727195141866,5842,-0.0407696950052335,307
"8759","3241313",0.53784329132313,8337,0.592933361942087,7456,-0.0550900706189575,881
"8760","4241313",0.49636896062259,10440,0.550522986820277,9865,-0.0541540261976871,575
"8761","1341313",0.616201202368046,4493,0.651051112449392,4364,-0.0348499100813462,129
"8762","2341313",0.552978029859857,7544,0.594676627808569,7359,-0.0416985979487118,185
"8763","3341313",0.509863821046353,9763,0.565882794608789,8993,-0.0560189735624358,770
"8764","4341313",0.468389490345813,11763,0.523472419486979,11323,-0.0550829291411653,440
"8765","1441313",0.57726470438305,6326,0.610421608481286,6461,-0.0331569040982364,-135
"8766","2441313",0.514041531874861,9567,0.554047123840463,9677,-0.040005591965602,-110
"8767","3441313",0.470927323061357,11650,0.525253290640683,11233,-0.0543259675793261,417
"8768","4441313",0.429452992360817,13360,0.482842915518873,13219,-0.0533899231580555,141
"8769","1112313",0.825398895962478,178,0.834519875432264,192,-0.0091209794697853,-14
"8770","2112313",0.762175723454289,638,0.77814539079144,662,-0.0159696673371509,-24
"8771","3112313",0.719061514640786,1287,0.749351557591661,1119,-0.0302900429508749,168
"8772","4112313",0.677587183940246,2301,0.70694118246985,2186,-0.0293539985296046,115
"8773","1212313",0.771441118369482,535,0.779215596486557,646,-0.00777447811707532,-111
"8774","2212313",0.708217945861293,1514,0.722841111845734,1731,-0.0146231659844409,-217
"8775","3212313",0.66510373704779,2656,0.694047278645955,2608,-0.0289435415981649,48
"8776","4212313",0.62362940634725,4198,0.651636903524144,4334,-0.0280074971768944,-136
"8777","1312313",0.743461648092706,876,0.75216502915326,1060,-0.00870338106055357,-184
"8778","2312313",0.680238475584517,2221,0.695790544512436,2547,-0.0155520689279192,-326
"8779","3312313",0.637124266771014,3670,0.666996711312657,3651,-0.0298724445416432,19
"8780","4312313",0.595649936070474,5442,0.624586336190846,5693,-0.0289364001203727,-251
"8781","1412313",0.70452515010771,1602,0.711535525185154,2027,-0.00701037507744373,-425
"8782","2412313",0.641301977599521,3515,0.65516104054433,4178,-0.0138590629448094,-663
"8783","3412313",0.598187768786018,5314,0.626367207344551,5597,-0.0281794385585334,-283
"8784","4412313",0.556713438085478,7356,0.583956832222741,7949,-0.027243394137263,-593
"8785","1122313",0.757419625096058,693,0.773950563774857,713,-0.0165309386787985,-20
"8786","2122313",0.69419645258787,1840,0.717576079134034,1871,-0.0233796265461641,-31
"8787","3122313",0.651082243774366,3153,0.688782245934254,2784,-0.0377000021598881,369
"8788","4122313",0.609607913073826,4817,0.646371870812444,4588,-0.0367639577386178,229
"8789","1222313",0.703461847503062,1622,0.718646284829151,1836,-0.0151844373260885,-214
"8790","2222313",0.640238674994873,3556,0.662271800188327,3868,-0.0220331251934541,-312
"8791","3222313",0.59712446618137,5368,0.633477966988548,5246,-0.0363535008071781,122
"8792","4222313",0.55565013548083,7419,0.591067591866738,7546,-0.0354174563859077,-127
"8793","1322313",0.675482377226286,2352,0.691595717495853,2689,-0.0161133402695668,-337
"8794","2322313",0.612259204718097,4695,0.635221232855029,5170,-0.0229620281369324,-475
"8795","3322313",0.569144995904594,6730,0.60642739965525,6678,-0.0372824037506564,52
"8796","4322313",0.527670665204054,8859,0.56401702453344,9107,-0.0363463593293859,-248
"8797","1422313",0.63654587924129,3695,0.650966213527747,4369,-0.0144203342864569,-674
"8798","2422313",0.573322706733101,6520,0.594591728886924,7365,-0.0212690221538226,-845
"8799","3422313",0.530208497919598,8722,0.565797895687144,8998,-0.0355893977675467,-276
"8800","4422313",0.488734167219058,10812,0.523387520565334,11327,-0.0346533533462762,-515
"8801","1132313",0.714087102930959,1384,0.735485471326828,1410,-0.0213983683958694,-26
"8802","2132313",0.65086393042277,3159,0.679110986686005,3169,-0.028247056263235,-10
"8803","3132313",0.607749721609266,4901,0.650317153486225,4408,-0.042567431876959,493
"8804","4132313",0.566275390908726,6877,0.607906778364415,6613,-0.0416313874556885,264
"8805","1232313",0.660129325337963,2808,0.680181192381122,3128,-0.0200518670431592,-320
"8806","2232313",0.596906152829774,5375,0.623806707740298,5736,-0.0269005549105248,-361
"8807","3232313",0.55379194401627,7507,0.595012874540519,7343,-0.0412209305242488,164
"8808","4232313",0.51231761331573,9657,0.552602499418709,9769,-0.0402848861029785,-112
"8809","1332313",0.632149855061186,3839,0.653130625047824,4276,-0.0209807699866374,-437
"8810","2332313",0.568926682552997,6742,0.596756140407,7250,-0.027829457854003,-508
"8811","3332313",0.525812473739494,8963,0.567962307207221,8890,-0.042149833467727,73
"8812","4332313",0.484338143038954,11023,0.525551932085411,11224,-0.0412137890464568,-201
"8813","1432313",0.59321335707619,5543,0.612501121079718,6360,-0.0192877640035276,-817
"8814","2432313",0.529990184568002,8737,0.556126636438895,9564,-0.0261364518708933,-827
"8815","3432313",0.486875975754498,10913,0.527332803239115,11128,-0.0404568274846173,-215
"8816","4432313",0.445401645053958,12740,0.484922428117305,13142,-0.039520783063347,-402
"8817","1142313",0.665053538476129,2657,0.695086977199744,2572,-0.0300334387236147,85
"8818","2142313",0.60183036596794,5139,0.638712492558921,5001,-0.0368821265909803,138
"8819","3142313",0.558716157154437,7238,0.609918659359141,6491,-0.0512025022047043,747
"8820","4142313",0.517241826453897,9400,0.567508284237331,8911,-0.0502664577834341,489
"8821","1242313",0.611095760883133,4751,0.639782698254038,4926,-0.0286869373709048,-175
"8822","2242313",0.547872588374944,7797,0.583408213613214,7983,-0.0355356252382704,-186
"8823","3242313",0.504758379561441,10016,0.554614380413435,9643,-0.0498560008519944,373
"8824","4242313",0.463284048860901,11988,0.512204005291625,11919,-0.0489199564307239,69
"8825","1342313",0.583116290606357,6042,0.61273213092074,6345,-0.029615840314383,-303
"8826","2342313",0.519893118098168,9239,0.556357646279916,9549,-0.0364645281817486,-310
"8827","3342313",0.476778909284664,11386,0.527563813080137,11118,-0.0507849037954726,268
"8828","4342313",0.435304578584125,13131,0.485153437958327,13134,-0.0498488593742021,-3
"8829","1442313",0.544179792621361,8008,0.572102626952634,8647,-0.0279228343312732,-639
"8830","2442313",0.480956620113172,11186,0.515728142311811,11733,-0.0347715221986389,-547
"8831","3442313",0.437842411299668,13021,0.486934309112031,13053,-0.0490918978123628,-32
"8832","4442313",0.396368080599128,14405,0.444523933990221,14584,-0.0481558533910925,-179
"8833","1113313",0.786515720389993,400,0.809023285043025,347,-0.0225075646530319,53
"8834","2113313",0.723292547881804,1208,0.752648800402201,1046,-0.0293562525203975,162
"8835","3113313",0.6801783390683,2223,0.723854967202422,1705,-0.0436766281341215,518
"8836","4113313",0.63870400836776,3610,0.681444592080611,3078,-0.0427405837128511,532
"8837","1213313",0.732557942796997,1051,0.753719006097318,1029,-0.0211610633003217,22
"8838","2213313",0.669334770288808,2533,0.697344521456495,2494,-0.0280097511676873,39
"8839","3213313",0.626220561475304,4068,0.668550688256716,3591,-0.0423301267814113,477
"8840","4213313",0.584746230774764,5966,0.626140313134905,5609,-0.0413940823601411,357
"8841","1313313",0.70457847252022,1600,0.72666843876402,1625,-0.0220899662438,-25
"8842","2313313",0.641355300012032,3513,0.670293954123197,3500,-0.0289386541111656,13
"8843","3313313",0.598241091198528,5311,0.641500120923418,4848,-0.0432590297248896,463
"8844","4313313",0.556766760497988,7354,0.599089745801607,7112,-0.0423229853036193,242
"8845","1413313",0.665641974535224,2640,0.686038934795915,2889,-0.0203969602606902,-249
"8846","2413313",0.602418802027036,5114,0.629664450155091,5425,-0.0272456481280559,-311
"8847","3413313",0.559304593213532,7209,0.600870616955312,7008,-0.0415660237417799,201
"8848","4413313",0.517830262512992,9359,0.558460241833502,9426,-0.0406299793205096,-67
"8849","1123313",0.718536449523573,1298,0.748453973385618,1137,-0.0299175238620452,161
"8850","2123313",0.655313277015384,2980,0.692079488744795,2666,-0.0367662117294107,314
"8851","3123313",0.61219906820188,4698,0.663285655545015,3827,-0.0510865873431348,871
"8852","4123313",0.57072473750134,6649,0.620875280423205,5895,-0.0501505429218643,754
"8853","1223313",0.664578671930577,2674,0.693149694439912,2637,-0.028571022509335,37
"8854","2223313",0.601355499422388,5171,0.636775209799088,5086,-0.0354197103767006,85
"8855","3223313",0.558241290608884,7266,0.607981376599309,6608,-0.0497400859904246,658
"8856","4223313",0.516766959908344,9424,0.565571001477499,9011,-0.0488040415691543,413
"8857","1323313",0.6365992016538,3691,0.666099127106614,3692,-0.0294999254528132,-1
"8858","2323313",0.573376029145612,6515,0.60972464246579,6509,-0.0363486133201788,6
"8859","3323313",0.530261820332108,8720,0.580930809266011,8137,-0.0506689889339028,583
"8860","4323313",0.488787489631568,10810,0.538520434144201,10550,-0.0497329445126325,260
"8861","1423313",0.597662703668804,5340,0.625469623138508,5640,-0.0278069194697034,-300
"8862","2423313",0.534439531160616,8491,0.569095138497685,8827,-0.0346556073370691,-336
"8863","3423313",0.491325322347112,10673,0.540301305297905,10459,-0.0489759829507931,214
"8864","4423313",0.449850991646572,12552,0.497890930176095,12584,-0.0480399385295228,-32
"8865","1133313",0.675203927358473,2359,0.709988880937589,2084,-0.0347849535791158,275
"8866","2133313",0.611980754850284,4705,0.653614396296766,4251,-0.0416336414464814,454
"8867","3133313",0.568866546036781,6744,0.624820563096986,5676,-0.0559540170602054,1068
"8868","4133313",0.527392215336241,8881,0.582410187975176,8059,-0.0550179726389352,822
"8869","1233313",0.621246149765477,4282,0.654684601991883,4203,-0.0334384522264058,79
"8870","2233313",0.558022977257288,7275,0.598310117351059,7156,-0.0402871400937714,119
"8871","3233313",0.514908768443785,9520,0.56951628415128,8802,-0.0546075157074954,718
"8872","4233313",0.473434437743245,11549,0.52710590902947,11137,-0.053671471286225,412
"8873","1333313",0.593266679488701,5540,0.627634034658585,5530,-0.0343673551698841,10
"8874","2333313",0.530043506980512,8733,0.571259550017762,8709,-0.0412160430372497,24
"8875","3333313",0.486929298167008,10909,0.542465716817982,10320,-0.0555364186509737,589
"8876","4333313",0.445454967466469,12733,0.500055341696172,12495,-0.0546003742297032,238
"8877","1433313",0.554330181503705,7486,0.587004530690479,7776,-0.0326743491867743,-290
"8878","2433313",0.491107008995516,10686,0.530630046049656,10962,-0.03952303705414,-276
"8879","3433313",0.447992800182012,12640,0.501836212849876,12406,-0.053843412667864,234
"8880","4433313",0.406518469481472,14116,0.459425837728066,14105,-0.0529073682465935,11
"8881","1143313",0.626170362903643,4070,0.669590386810505,3534,-0.0434200239068614,536
"8882","2143313",0.562947190395455,7016,0.613215902169682,6310,-0.050268711774227,706
"8883","3143313",0.519832981581951,9242,0.584422068969902,7923,-0.064589087387951,1319
"8884","4143313",0.478358650881411,11305,0.542011693848092,10354,-0.0636530429666805,951
"8885","1243313",0.572212585310647,6580,0.614286107864799,6251,-0.0420735225541512,329
"8886","2243313",0.508989412802459,9803,0.557911623223975,9449,-0.0489222104215168,354
"8887","3243313",0.465875203988955,11865,0.529117790024196,11048,-0.0632425860352408,817
"8888","4243313",0.424400873288415,13534,0.486707414902386,13065,-0.0623065416139706,469
"8889","1343313",0.544233115033871,8004,0.587235540531501,7759,-0.0430024254976294,245
"8890","2343313",0.481009942525682,11183,0.530861055890677,10947,-0.049851113364995,236
"8891","3343313",0.437895733712179,13019,0.502067222690898,12391,-0.064171488978719,628
"8892","4343313",0.396421403011639,14404,0.459656847569088,14095,-0.0632354445574488,309
"8893","1443313",0.505296617048875,9991,0.546606036563395,10076,-0.0413094195145196,-85
"8894","2443313",0.442073444540686,12865,0.490231551922572,12921,-0.0481581073818853,-56
"8895","3443313",0.398959235727183,14326,0.461437718722792,14035,-0.0624784829956094,291
"8896","4443313",0.357484905026643,15304,0.419027343600982,15216,-0.061542438574339,88
"8897","1114313",0.734308648419423,1021,0.764372671669369,863,-0.030064023249946,158
"8898","2114313",0.671085475911234,2470,0.707998187028545,2144,-0.0369127111173115,326
"8899","3114313",0.62797126709773,3999,0.679204353828766,3165,-0.0512330867310355,834
"8900","4114313",0.586496936397191,5853,0.636793978706956,5084,-0.0502970423097651,769
"8901","1214313",0.680350870826427,2218,0.709068392723663,2112,-0.0287175218972358,106
"8902","2214313",0.617127698318238,4459,0.652693908082839,4294,-0.0355662097646013,165
"8903","3214313",0.574013489504734,6478,0.62390007488306,5730,-0.0498865853783254,748
"8904","4214313",0.532539158804194,8597,0.581489699761249,8106,-0.0489505409570551,491
"8905","1314313",0.652371400549651,3109,0.682017825390365,3052,-0.029646424840714,57
"8906","2314313",0.589148228041462,5726,0.625643340749541,5632,-0.0364951127080796,94
"8907","3314313",0.546034019227958,7903,0.596849507549762,7247,-0.0508154883218036,656
"8908","4314313",0.504559688527418,10031,0.554439132427952,9658,-0.0498794439005333,373
"8909","1414313",0.613434902564655,4640,0.641388321422259,4853,-0.0279534188576042,-213
"8910","2414313",0.550211730056466,7695,0.585013836781436,7884,-0.0348021067249699,-189
"8911","3414313",0.507097521242962,9897,0.556220003581656,9560,-0.0491224823386939,337
"8912","4414313",0.465623190542422,11869,0.513809628459846,11841,-0.0481864379174236,28
"8913","1124313",0.666329377553003,2622,0.703803360011962,2283,-0.0374739824589592,339
"8914","2124313",0.603106205044814,5088,0.647428875371139,4536,-0.0443226703263248,552
"8915","3124313",0.55999199623131,7177,0.618635042171359,6010,-0.0586430459400488,1167
"8916","4124313",0.518517665530771,9311,0.576224667049549,8414,-0.0577070015187783,897
"8917","1224313",0.612371599960007,4688,0.648499081066256,4473,-0.036127481106249,215
"8918","2224313",0.549148427451818,7739,0.592124596425432,7496,-0.0429761689736146,243
"8919","3224313",0.506034218638314,9948,0.563330763225653,9143,-0.0572965445873386,805
"8920","4224313",0.464559887937774,11931,0.520920388103843,11448,-0.0563605001660683,483
"8921","1324313",0.584392129683231,5984,0.621448513732958,5862,-0.0370563840497272,122
"8922","2324313",0.521168957175042,9190,0.565074029092135,9038,-0.0439050719170928,152
"8923","3324313",0.478054748361538,11318,0.536280195892355,10672,-0.0582254475308168,646
"8924","4324313",0.436580417660998,13075,0.493869820770545,12763,-0.0572894031095465,312
"8925","1424313",0.545455631698235,7937,0.580819009764852,8142,-0.0353633780666174,-205
"8926","2424313",0.482232459190046,11128,0.524444525124029,11275,-0.0422120659339831,-147
"8927","3424313",0.439118250376542,12973,0.495650691924249,12683,-0.056532441547707,290
"8928","4424313",0.397643919676002,14363,0.453240316802439,14304,-0.0555963971264368,59
"8929","1134313",0.622996855387903,4218,0.665338267563933,3729,-0.0423414121760298,489
"8930","2134313",0.559773682879714,7183,0.60896378292311,6556,-0.0491901000433954,627
"8931","3134313",0.516659474066211,9430,0.58016994972333,8180,-0.0635104756571194,1250
"8932","4134313",0.475185143365671,11462,0.53775957460152,10594,-0.0625744312358492,868
"8933","1234313",0.569039077794907,6733,0.610033988618227,6482,-0.0409949108233199,251
"8934","2234313",0.505815905286718,9957,0.553659503977404,9706,-0.0478435986906854,251
"8935","3234313",0.462701696473215,12009,0.524865670777624,11255,-0.0621639743044095,754
"8936","4234313",0.421227365772675,13641,0.482455295655814,13236,-0.061227929883139,405
"8937","1334313",0.541059607518131,8173,0.582983421284929,8021,-0.0419238137667981,152
"8938","2334313",0.477836435009942,11332,0.526608936644106,11164,-0.0487725016341637,168
"8939","3334313",0.434722226196439,13159,0.497815103444326,12587,-0.0630928772478876,572
"8940","4334313",0.393247895495899,14496,0.455404728322516,14233,-0.0621568328266173,263
"8941","1434313",0.502123109533135,10159,0.542353917316823,10328,-0.0402308077836883,-169
"8942","2434313",0.438899937024946,12979,0.485979432676,13096,-0.0470794956510539,-117
"8943","3434313",0.395785728211443,14420,0.45718559947622,14172,-0.0613998712647779,248
"8944","4434313",0.354311397510903,15356,0.41477522435441,15305,-0.0604638268435075,51
"8945","1144313",0.573963290933074,6482,0.624939773436849,5670,-0.0509764825037754,812
"8946","2144313",0.510740118424885,9734,0.568565288796026,8855,-0.057825170371141,879
"8947","3144313",0.467625909611381,11791,0.539771455596246,10483,-0.072145545984865,1308
"8948","4144313",0.426151578910841,13469,0.497361080474436,12606,-0.0712095015635946,863
"8949","1244313",0.520005513340078,9235,0.569635494491143,8793,-0.0496299811510652,442
"8950","2244313",0.456782340831889,12270,0.51326100985032,11867,-0.0564786690184308,403
"8951","3244313",0.413668132018385,13879,0.48446717665054,13162,-0.0707990446321549,717
"8952","4244313",0.372193801317845,15005,0.44205680152873,14658,-0.0698630002108845,347
"8953","1344313",0.492026043063301,10646,0.542584927157845,10312,-0.0505588840945435,334
"8954","2344313",0.428802870555113,13382,0.486210442517022,13085,-0.057407571961909,297
"8955","3344313",0.385688661741609,14686,0.457416609317242,14163,-0.0717279475756331,523
"8956","4344313",0.344214331041069,15523,0.415006234195432,15301,-0.0707919031543627,222
"8957","1444313",0.453089545078305,12425,0.501955423189739,12396,-0.0488658781114336,29
"8958","2444313",0.389866372570116,14593,0.445580938548916,14551,-0.0557145659787994,42
"8959","3444313",0.346752163756613,15479,0.416787105349136,15262,-0.0700349415925234,217
"8960","4444313",0.305277833056073,15993,0.374376730227326,15928,-0.069098897171253,65
"8961","1111413",0.82869179071202,165,0.8387137171238,169,-0.0100219264117807,-4
"8962","2111413",0.765468618203831,604,0.782339232482977,604,-0.0168706142791463,0
"8963","3111413",0.722354409390327,1226,0.753545399283198,1032,-0.0311909898928703,194
"8964","4111413",0.680880078689787,2200,0.711135024161387,2044,-0.0302549454715999,156
"8965","1211413",0.774734013119024,505,0.783409438178094,595,-0.0086754250590706,-90
"8966","2211413",0.711510840610835,1434,0.727034953537271,1612,-0.0155241129264362,-178
"8967","3211413",0.668396631797331,2561,0.698241120337491,2471,-0.0298444885401602,90
"8968","4211413",0.626922301096791,4038,0.655830745215681,4155,-0.0289084441188898,-117
"8969","1311413",0.746754542842247,830,0.756358870844796,990,-0.00960432800254885,-160
"8970","2311413",0.683531370334059,2120,0.699984386203973,2407,-0.0164530158699144,-287
"8971","3311413",0.640417161520555,3547,0.671190553004194,3464,-0.0307733914836384,83
"8972","4311413",0.598942830820015,5279,0.628780177882383,5465,-0.0298373470623681,-186
"8973","1411413",0.707818044857251,1526,0.71572936687669,1913,-0.007911322019439,-387
"8974","2411413",0.644594872349063,3381,0.659354882235867,3994,-0.0147600098868047,-613
"8975","3411413",0.601480663535559,5162,0.630561049036088,5376,-0.0290803855005287,-214
"8976","4411413",0.560006332835019,7176,0.588150673914277,7703,-0.0281443410792583,-527
"8977","1121413",0.7607125198456,662,0.778144405466394,663,-0.0174318856207939,-1
"8978","2121413",0.697489347337411,1760,0.72176992082557,1760,-0.0242805734881595,0
"8979","3121413",0.654375138523907,3016,0.692976087625791,2643,-0.0386009491018835,373
"8980","4121413",0.612900807823367,4663,0.65056571250398,4392,-0.0376649046806131,271
"8981","1221413",0.706754742252604,1551,0.722840126520687,1732,-0.0160853842680838,-181
"8982","2221413",0.643531569744415,3412,0.666465641879864,3669,-0.0229340721354494,-257
"8983","3221413",0.600417360930911,5207,0.637671808680085,5053,-0.0372544477491734,154
"8984","4221413",0.558943030230371,7228,0.595261433558274,7332,-0.036318403327903,-104
"8985","1321413",0.678775271975827,2262,0.69578955918739,2548,-0.0170142872115621,-286
"8986","2321413",0.615552099467639,4522,0.639415074546566,4959,-0.0238629750789277,-437
"8987","3321413",0.572437890654135,6563,0.610621241346787,6452,-0.0381833506926517,111
"8988","4321413",0.530963559953595,8684,0.568210866224976,8877,-0.0372473062713813,-193
"8989","1421413",0.639838773990831,3569,0.655160055219284,4179,-0.0153212812284522,-610
"8990","2421413",0.576615601482643,6355,0.59878557057846,7125,-0.0221699690958179,-770
"8991","3421413",0.533501392669139,8540,0.569991737378681,8775,-0.0364903447095419,-235
"8992","4421413",0.492027061968599,10645,0.527581362256871,11115,-0.0355543002882716,-470
"8993","1131413",0.7173799976805,1319,0.739679313018365,1323,-0.0222993153378647,-4
"8994","2131413",0.654156825172311,3028,0.683304828377541,2995,-0.0291480032052303,33
"8995","3131413",0.611042616358808,4754,0.654510995177762,4213,-0.0434683788189543,541
"8996","4131413",0.569568285658268,6718,0.612100620055952,6383,-0.0425323343976839,335
"8997","1231413",0.663422220087504,2722,0.684375034072659,2953,-0.0209528139851546,-231
"8998","2231413",0.600199047579315,5223,0.628000549431835,5502,-0.0278015018525202,-279
"8999","3231413",0.557084838765812,7340,0.599206716232056,7105,-0.0421218774662442,235
"9000","4231413",0.515610508065272,9493,0.556796341110245,9522,-0.0411858330449738,-29
"9001","1331413",0.635442749810728,3728,0.657324466739361,4090,-0.0218817169286328,-362
"9002","2331413",0.572219577302539,6579,0.600949982098537,7001,-0.0287304047959984,-422
"9003","3331413",0.529105368489035,8785,0.572156148898758,8644,-0.0430507804097224,141
"9004","4331413",0.487631037788495,10875,0.529745773776948,11013,-0.0421147359884521,-138
"9005","1431413",0.596506251825732,5390,0.616694962771255,6126,-0.020188710945523,-736
"9006","2431413",0.533283079317543,8559,0.560320478130432,9305,-0.0270373988128887,-746
"9007","3431413",0.490168870504039,10736,0.531526644930652,10913,-0.0413577744266127,-177
"9008","4431413",0.4486945398035,12610,0.489116269808842,12970,-0.0404217300053423,-360
"9009","1141413",0.66834643322567,2563,0.699280818891281,2429,-0.0309343856656101,134
"9010","2141413",0.605123260717482,5005,0.642906334250457,4763,-0.0377830735329757,242
"9011","3141413",0.562009051903978,7061,0.614112501050678,6261,-0.0521034491466997,800
"9012","4141413",0.520534721203438,9208,0.571702125928868,8675,-0.0511674047254294,533
"9013","1241413",0.614388655632674,4589,0.643976539945574,4697,-0.0295878843129,-108
"9014","2241413",0.551165483124486,7647,0.587602055304751,7730,-0.0364365721802656,-83
"9015","3241413",0.508051274310982,9854,0.558808222104972,9405,-0.0507569477939896,449
"9016","4241413",0.466576943610442,11833,0.516397846983161,11694,-0.0498209033727193,139
"9017","1341413",0.586409185355898,5859,0.616925972612277,6109,-0.0305167872563783,-250
"9018","2341413",0.523186012847709,9080,0.560551487971453,9292,-0.0373654751237439,-212
"9019","3341413",0.480071804034206,11216,0.531757654771674,10900,-0.0516858507374679,316
"9020","4341413",0.438597473333666,12990,0.489347279649863,12960,-0.0507498063161975,30
"9021","1441413",0.547472687370902,7813,0.576296468644171,8407,-0.0288237812732685,-594
"9022","2441413",0.484249514862713,11035,0.519921984003348,11497,-0.0356724691406342,-462
"9023","3441413",0.44113530604921,12897,0.491128150803568,12883,-0.0499928447543581,14
"9024","4441413",0.39966097534867,14305,0.448717775681758,14454,-0.0490568003330877,-149
"9025","1112413",0.795606878950331,335,0.800394735595148,419,-0.00478785664481751,-84
"9026","2112413",0.732383706442142,1053,0.744020250954325,1232,-0.0116365445121831,-179
"9027","3112413",0.689269497628638,1959,0.715226417754546,1928,-0.0259569201259071,31
"9028","4112413",0.647795166928098,3268,0.672816042632735,3402,-0.0250208757046367,-134
"9029","1212413",0.741649101357335,894,0.745090456649442,1212,-0.00344135529210743,-318
"9030","2212413",0.678425928849146,2274,0.688715972008619,2787,-0.010290043159473,-513
"9031","3212413",0.635311720035642,3730,0.659922138808839,3974,-0.024610418773197,-244
"9032","4212413",0.593837389335102,5515,0.617511763687029,6075,-0.0236743743519267,-560
"9033","1312413",0.713669631080558,1392,0.718039889316144,1861,-0.00437025823558568,-469
"9034","2312413",0.65044645857237,3173,0.661665404675321,3906,-0.0112189461029513,-733
"9035","3312413",0.607332249758866,4917,0.632871571475541,5274,-0.0255393217166753,-357
"9036","4312413",0.565857919058326,6894,0.590461196353731,7577,-0.0246032772954049,-683
"9037","1412413",0.674733133095562,2373,0.677410385348038,3230,-0.00267725225247584,-857
"9038","2412413",0.611509960587374,4728,0.621035900707215,5885,-0.00952594011984154,-1157
"9039","3412413",0.56839575177387,6772,0.592242067507436,7489,-0.0238463157335655,-717
"9040","4412413",0.52692142107333,8909,0.549831692385625,9900,-0.0229102713122952,-991
"9041","1122413",0.727627608083911,1124,0.739825423937742,1320,-0.0121978158538307,-196
"9042","2122413",0.664404435575722,2681,0.683450939296918,2989,-0.0190465037211963,-308
"9043","3122413",0.621290226762218,4278,0.654657106097139,4204,-0.0333668793349203,74
"9044","4122413",0.579815896061678,6212,0.612246730975328,6377,-0.03243083491365,-165
"9045","1222413",0.673669830490915,2395,0.684521144992035,2947,-0.0108513145011206,-552
"9046","2222413",0.610446657982726,4773,0.628146660351212,5494,-0.0177000023684862,-721
"9047","3222413",0.567332449169222,6828,0.599352827151433,7091,-0.0320203779822102,-263
"9048","4222413",0.525858118468682,8962,0.556942452029622,9512,-0.0310843335609399,-550
"9049","1322413",0.645690360214139,3341,0.657470577658737,4084,-0.0117802174445989,-743
"9050","2322413",0.58246718770595,6064,0.601096093017914,6994,-0.0186289053119645,-930
"9051","3322413",0.539352978892446,8258,0.572302259818135,8634,-0.0329492809256885,-376
"9052","4322413",0.497878648191906,10369,0.529891884696324,11008,-0.0320132365044181,-639
"9053","1422413",0.606753862229143,4941,0.616841073690632,6118,-0.0100872114614891,-1177
"9054","2422413",0.543530689720954,8038,0.560466589049808,9299,-0.0169358993288548,-1261
"9055","3422413",0.50041648090745,10239,0.531672755850029,10906,-0.0312562749425788,-667
"9056","4422413",0.45894215020691,12193,0.489262380728219,12964,-0.0303202305213083,-771
"9057","1132413",0.684295085918811,2099,0.701360331489713,2374,-0.0170652455709015,-275
"9058","2132413",0.621071913410622,4287,0.644985846848889,4655,-0.0239139334382671,-368
"9059","3132413",0.577957704597119,6297,0.61619201364911,6160,-0.0382343090519911,137
"9060","4132413",0.536483373896579,8398,0.5737816385273,8556,-0.0372982646307207,-158
"9061","1232413",0.630337308325815,3903,0.646056052544006,4607,-0.0157187442181914,-704
"9062","2232413",0.567114135817626,6838,0.589681567903183,7623,-0.022567432085557,-785
"9063","3232413",0.523999927004123,9044,0.560887734703404,9270,-0.036887807699281,-226
"9064","4232413",0.482525596303583,11117,0.518477359581593,11588,-0.0359517632780106,-471
"9065","1332413",0.602357838049039,5120,0.619005485210709,5993,-0.0166476471616697,-873
"9066","2332413",0.53913466554085,8271,0.562631000569885,9185,-0.0234963350290353,-914
"9067","3332413",0.496020456727347,10452,0.533837167370106,10800,-0.0378167106427593,-348
"9068","4332413",0.454546126026807,12360,0.491426792248295,12869,-0.0368806662214888,-509
"9069","1432413",0.563421340064043,6993,0.578375981242603,8295,-0.0149546411785598,-1302
"9070","2432413",0.500198167555854,10259,0.52200149660178,11399,-0.0218033290459255,-1140
"9071","3432413",0.45708395874235,12257,0.493207663402,12792,-0.0361237046596495,-535
"9072","4432413",0.415609628041811,13829,0.45079728828019,14385,-0.0351876602383791,-556
"9073","1142413",0.635261521463982,3734,0.660961837362629,3931,-0.025700315898647,-197
"9074","2142413",0.572038348955793,6587,0.604587352721805,6798,-0.0325490037660126,-211
"9075","3142413",0.528924140142289,8793,0.575793519522026,8440,-0.0468693793797366,353
"9076","4142413",0.487449809441749,10883,0.533383144400216,10822,-0.0459333349584662,61
"9077","1242413",0.581303743870985,6130,0.605657558416922,6723,-0.0243538145459369,-593
"9078","2242413",0.518080571362797,9345,0.549283073776099,9934,-0.0312025024133025,-589
"9079","3242413",0.474966362549293,11472,0.52048924057632,11469,-0.0455228780270265,3
"9080","4242413",0.433492031848753,13210,0.478078865454509,13416,-0.044586833605756,-206
"9081","1342413",0.553324273594209,7525,0.578606991083624,8279,-0.0252827174894151,-754
"9082","2342413",0.49010110108602,10739,0.522232506442801,11387,-0.0321314053567807,-648
"9083","3342413",0.446986892272517,12681,0.493438673243022,12781,-0.0464517809705047,-100
"9084","4342413",0.405512561571977,14148,0.451028298121211,14377,-0.0455157365492343,-229
"9085","1442413",0.514387775609213,9542,0.537977487115519,10578,-0.0235897115063053,-1036
"9086","2442413",0.451164603101024,12499,0.481603002474695,13270,-0.0304383993736709,-771
"9087","3442413",0.408050394287521,14059,0.452809169274916,14318,-0.0447587749873949,-259
"9088","4442413",0.366576063586981,15134,0.410398794153106,15390,-0.0438227305661245,-256
"9089","1113413",0.756723703377845,702,0.774898145205909,701,-0.0181744418280642,1
"9090","2113413",0.693500530869656,1862,0.718523660565086,1842,-0.0250231296954297,20
"9091","3113413",0.650386322056153,3177,0.689729827365307,2754,-0.0393435053091538,423
"9092","4113413",0.608911991355613,4849,0.647319452243496,4544,-0.0384074608878833,305
"9093","1213413",0.702765925784849,1634,0.719593866260203,1816,-0.016827940475354,-182
"9094","2213413",0.63954275327666,3579,0.66321938161938,3829,-0.0236766283427196,-250
"9095","3213413",0.596428544463157,5398,0.6344255484196,5212,-0.0379970039564436,186
"9096","4213413",0.554954213762617,7451,0.59201517329779,7502,-0.0370609595351733,-51
"9097","1313413",0.674786455508073,2371,0.692543298926905,2657,-0.0177568434188322,-286
"9098","2313413",0.611563282999884,4723,0.636168814286082,5115,-0.0246055312861978,-392
"9099","3313413",0.568449074186381,6768,0.607374981086302,6634,-0.0389259068999218,134
"9100","4313413",0.52697474348584,8905,0.564964605964492,9043,-0.0379898624786515,-138
"9101","1413413",0.635849957523077,3719,0.651913794958799,4326,-0.0160638374357224,-607
"9102","2413413",0.572626785014888,6553,0.595539310317976,7315,-0.0229125253030881,-762
"9103","3413413",0.529512576201385,8758,0.566745477118197,8955,-0.0372329009168121,-197
"9104","4413413",0.488038245500845,10856,0.524335101996386,11282,-0.0362968564955418,-426
"9105","1123413",0.688744432511425,1975,0.714328833548503,1956,-0.0255844010370774,19
"9106","2123413",0.625521260003236,4102,0.657954348907679,4057,-0.032433088904443,45
"9107","3123413",0.582407051189733,6068,0.6291605157079,5449,-0.046753464518167,619
"9108","4123413",0.540932720489193,8181,0.586750140586089,7795,-0.0458174200968965,386
"9109","1223413",0.634786654918429,3748,0.659024554602796,4012,-0.0242378996843672,-264
"9110","2223413",0.57156348241024,6603,0.602650069961973,6895,-0.0310865875517328,-292
"9111","3223413",0.528449273596737,8815,0.573856236762194,8551,-0.0454069631654568,264
"9112","4223413",0.486974942896197,10908,0.531445861640383,10920,-0.0444709187441865,-12
"9113","1323413",0.606807184641653,4939,0.631973987269498,5322,-0.0251668026278454,-383
"9114","2323413",0.543584012133464,8034,0.575599502628675,8457,-0.032015490495211,-423
"9115","3323413",0.500469803319961,10235,0.546805669428896,10065,-0.046335866108935,170
"9116","4323413",0.45899547261942,12190,0.504395294307085,12276,-0.0453998216876648,-86
"9117","1423413",0.567870686656657,6806,0.591344483301393,7536,-0.0234737966447356,-730
"9118","2423413",0.504647514148468,10024,0.534969998660569,10739,-0.0303224845121013,-715
"9119","3423413",0.461533305334965,12066,0.50617616546079,12200,-0.0446428601258253,-134
"9120","4423413",0.420058974634425,13692,0.46376579033898,13953,-0.043706815704555,-261
"9121","1133413",0.645411910346326,3353,0.675863741100474,3295,-0.030451830754148,58
"9122","2133413",0.582188737838137,6089,0.61948925645965,5967,-0.0373005186215136,122
"9123","3133413",0.539074529024633,8275,0.590695423259871,7565,-0.0516208942352376,710
"9124","4133413",0.497600198324093,10385,0.548285048138061,9992,-0.0506848498139674,393
"9125","1233413",0.591454132753329,5611,0.620559462154767,5912,-0.0291053294014381,-301
"9126","2233413",0.52823096024514,8831,0.564184977513944,9093,-0.0359540172688037,-262
"9127","3233413",0.485116751431637,10991,0.535391144314165,10719,-0.0502743928825277,272
"9128","4233413",0.443642420731097,12812,0.492980769192354,12802,-0.0493383484612571,10
"9129","1333413",0.563474662476553,6988,0.59350889482147,7432,-0.0300342323449163,-444
"9130","2333413",0.500251489968364,10254,0.537134410180646,10628,-0.0368829202122819,-374
"9131","3333413",0.457137281154861,12253,0.508340576980867,12092,-0.0512032958260059,161
"9132","4333413",0.415662950454321,13825,0.465930201859056,13890,-0.0502672514047354,-65
"9133","1433413",0.524538164491557,9019,0.552879390853364,9754,-0.0283412263618065,-735
"9134","2433413",0.461314991983368,12082,0.49650490621254,12643,-0.0351899142291721,-561
"9135","3433413",0.418200783169865,13746,0.467711073012761,13831,-0.0495102898428961,-85
"9136","4433413",0.376726452469325,14914,0.425300697890951,15077,-0.0485742454216256,-163
"9137","1143413",0.596378345891496,5402,0.63546524697339,5149,-0.0390869010818936,253
"9138","2143413",0.533155173383307,8570,0.579090762332566,8251,-0.0459355889492592,319
"9139","3143413",0.490040964569804,10743,0.550296929132787,9879,-0.0602559645629832,864
"9140","4143413",0.448566633869264,12614,0.507886554010976,12122,-0.0593199201417127,492
"9141","1243413",0.5424205682985,8099,0.580160968027683,8182,-0.0377403997291834,-83
"9142","2243413",0.479197395790311,11261,0.52378648338686,11308,-0.044589087596549,-47
"9143","3243413",0.436083186976808,13096,0.494992650187081,12716,-0.058909463210273,380
"9144","4243413",0.394608856276268,14461,0.45258227506527,14328,-0.0579734187890027,133
"9145","1343413",0.514441098021724,9538,0.553110400694385,9738,-0.0386693026726617,-200
"9146","2343413",0.451217925513535,12494,0.496735916053562,12634,-0.0455179905400272,-140
"9147","3343413",0.408103716700031,14056,0.467942082853783,13821,-0.0598383661537512,235
"9148","4343413",0.366629385999491,15132,0.425531707731972,15070,-0.0589023217324809,62
"9149","1443413",0.475504600036728,11446,0.51248089672628,11905,-0.0369762966895518,-459
"9150","2443413",0.412281427528539,13932,0.456106412085456,14205,-0.0438249845569175,-273
"9151","3443413",0.369167218715035,15068,0.427312578885677,15038,-0.0581453601706414,30
"9152","4443413",0.327692888014495,15765,0.384902203763867,15796,-0.057209315749371,-31
"9153","1114413",0.704516631407275,1603,0.730247531832253,1524,-0.0257309004249781,79
"9154","2114413",0.641293458899087,3517,0.67387304719143,3353,-0.0325795882923436,164
"9155","3114413",0.598179250085583,5315,0.645079213991651,4648,-0.0468999639060677,667
"9156","4114413",0.556704919385043,7357,0.60266883886984,6893,-0.0459639194847973,464
"9157","1214413",0.650558853814279,3165,0.674943252886547,3321,-0.024384399072268,-156
"9158","2214413",0.58733568130609,5810,0.618568768245724,6015,-0.0312330869396336,-205
"9159","3214413",0.544221472492587,8005,0.589774935045944,7616,-0.0455534625533576,389
"9160","4214413",0.502747141792047,10127,0.547364559924134,10040,-0.0446174181320872,87
"9161","1314413",0.622579383537503,4237,0.647892685553249,4510,-0.0253133020157462,-273
"9162","2314413",0.559356211029314,7205,0.591518200912426,7527,-0.0321619898831118,-322
"9163","3314413",0.516242002215811,9456,0.562724367712647,9179,-0.0464823654968358,277
"9164","4314413",0.474767671515271,11486,0.520313992590836,11481,-0.0455463210755654,5
"9165","1414413",0.583642885552507,6020,0.607263181585143,6640,-0.0236202960326364,-620
"9166","2414413",0.520419713044318,9217,0.55088869694432,9851,-0.0304689839000021,-634
"9167","3414413",0.477305504230815,11355,0.522094863744541,11397,-0.0447893595137261,-42
"9168","4414413",0.435831173530275,13109,0.47968448862273,13346,-0.0438533150924557,-237
"9169","1124413",0.636537360540855,3697,0.669678220174847,3527,-0.0331408596339913,170
"9170","2124413",0.573314188032667,6522,0.613303735534023,6307,-0.0399895475013569,215
"9171","3124413",0.530199979219163,8723,0.584509902334244,7917,-0.0543099231150809,806
"9172","4124413",0.488725648518623,10813,0.542099527212434,10349,-0.0533738786938105,464
"9173","1224413",0.582579582947859,6058,0.61437394122914,6244,-0.0317943582812812,-186
"9174","2224413",0.51935641043967,9258,0.557999456588317,9446,-0.0386430461486468,-188
"9175","3224413",0.476242201626167,11411,0.529205623388538,11042,-0.0529634217623708,369
"9176","4224413",0.434767870925627,13156,0.486795248266727,13061,-0.0520273773411004,95
"9177","1324413",0.554600112671083,7467,0.587323373895843,7755,-0.0327232612247594,-288
"9178","2324413",0.491376940162894,10670,0.530948889255019,10944,-0.039571949092125,-274
"9179","3324413",0.448262731349391,12626,0.50215505605524,12388,-0.053892324705849,238
"9180","4324413",0.406788400648851,14106,0.459744680933429,14092,-0.0529562802845786,14
"9181","1424413",0.515663614686087,9488,0.546693869927737,10070,-0.0310302552416496,-582
"9182","2424413",0.452440442177898,12440,0.490319385286913,12917,-0.0378789431090152,-477
"9183","3424413",0.409326233364395,14020,0.461525552087134,14030,-0.0521993187227393,-10
"9184","4424413",0.367851902663855,15101,0.419115176965324,15214,-0.0512632743014688,-113
"9185","1134413",0.593204838375756,5544,0.631213127726818,5350,-0.038008289351062,194
"9186","2134413",0.529981665867567,8739,0.574838643085995,8502,-0.0448569772184276,237
"9187","3134413",0.486867457054063,10915,0.546044809886215,10111,-0.0591773528321516,804
"9188","4134413",0.445393126353523,12741,0.503634434764405,12314,-0.0582413084108813,427
"9189","1234413",0.53924706078276,8263,0.575908848781112,8431,-0.036661787998352,-168
"9190","2234413",0.476023888274571,11422,0.519534364140288,11527,-0.0435104758657175,-105
"9191","3234413",0.432909679461067,13236,0.490740530940509,12902,-0.0578308514794415,334
"9192","4234413",0.391435348760527,14557,0.448330155818698,14468,-0.0568948070581711,89
"9193","1334413",0.511267590505983,9704,0.548858281447814,9960,-0.0375906909418302,-256
"9194","2334413",0.448044417997795,12638,0.49248379680699,12828,-0.0444393788091957,-190
"9195","3334413",0.404930209184291,14167,0.463689963607211,13956,-0.0587597544229198,211
"9196","4334413",0.363455878483751,15195,0.4212795884854,15164,-0.0578237100016493,31
"9197","1434413",0.472331092520987,11601,0.508228777479708,12101,-0.0358976849587204,-500
"9198","2434413",0.409107920012799,14031,0.451854292838885,14352,-0.042746372826086,-321
"9199","3434413",0.365993711199295,15147,0.423060459639105,15126,-0.05706674843981,21
"9200","4434413",0.324519380498755,15796,0.380650084517295,15850,-0.0561307040185396,-54
"9201","1144413",0.544171273920926,8010,0.590814633599734,7558,-0.0466433596788075,452
"9202","2144413",0.480948101412737,11188,0.53444014895891,10767,-0.0534920475461731,421
"9203","3144413",0.437833892599234,13022,0.505646315759131,12217,-0.0678124231598971,805
"9204","4144413",0.396359561898694,14406,0.463235940637321,13969,-0.0668763787386267,437
"9205","1244413",0.49021349632793,10731,0.535510354654028,10707,-0.0452968583260974,24
"9206","2244413",0.426990323819741,13438,0.479135870013204,13370,-0.052145546193463,68
"9207","3244413",0.383876115006238,14734,0.450342036813425,14406,-0.066465921807187,328
"9208","4244413",0.342401784305698,15555,0.407931661691614,15444,-0.0655298773859165,111
"9209","1344413",0.462234026051154,12035,0.50845978732073,12086,-0.0462257612695757,-51
"9210","2344413",0.399010853542965,14324,0.452085302679906,14341,-0.0530744491369412,-17
"9211","3344413",0.355896644729462,15332,0.423291469480127,15119,-0.0673948247506652,213
"9212","4344413",0.314422314028922,15905,0.380881094358316,15846,-0.0664587803293948,59
"9213","1444413",0.423297528066158,13572,0.467830283352624,13826,-0.0445327552864658,-254
"9214","2444413",0.360074355557969,15259,0.4114557987118,15372,-0.0513814431538314,-113
"9215","3444413",0.316960146744466,15875,0.382661965512021,15825,-0.0657018187675554,50
"9216","4444413",0.275485816043926,16193,0.340251590390211,16191,-0.064765774346285,2
"9217","1111123",0.871737851070362,58,0.886435169433744,48,-0.0146973183633823,10
"9218","2111123",0.808514678562173,259,0.830060684792921,219,-0.0215460062307479,40
"9219","3111123",0.765400469748669,605,0.801266851593141,412,-0.0358663818444719,193
"9220","4111123",0.723926139048129,1193,0.758856476471331,952,-0.0349303374232016,241
"9221","1211123",0.817780073477365,206,0.831130890488038,209,-0.0133508170106723,-3
"9222","2211123",0.754556900969177,729,0.774756405847215,702,-0.0201995048780379,27
"9223","3211123",0.711442692155673,1441,0.745962572647435,1188,-0.0345198804917619,253
"9224","4211123",0.669968361455133,2506,0.703552197525625,2295,-0.0335838360704914,211
"9225","1311123",0.789800603200589,382,0.80408032315474,393,-0.0142797199541506,-11
"9226","2311123",0.7265774306924,1151,0.747705838513917,1153,-0.0211284078215161,-2
"9227","3311123",0.683463221878897,2123,0.718912005314137,1831,-0.0354487834352402,292
"9228","4311123",0.641988891178357,3484,0.676501630192327,3274,-0.0345127390139697,210
"9229","1411123",0.750864105215593,775,0.763450819186634,883,-0.0125867139710407,-108
"9230","2411123",0.687640932707404,2004,0.707076334545811,2181,-0.0194354018384064,-177
"9231","3411123",0.644526723893901,3382,0.678282501346031,3193,-0.0337557774521304,189
"9232","4411123",0.603052393193361,5090,0.635872126224221,5129,-0.0328197330308599,-39
"9233","1121123",0.803758580203942,288,0.825865857776337,241,-0.0221072775723955,47
"9234","2121123",0.740535407695753,918,0.769491373135514,779,-0.0289559654397611,139
"9235","3121123",0.697421198882249,1762,0.740697539935735,1300,-0.0432763410534851,462
"9236","4121123",0.655946868181709,2950,0.698287164813924,2468,-0.0423402966322148,482
"9237","1221123",0.749800802610946,784,0.770561578830631,764,-0.0207607762196855,20
"9238","2221123",0.686577630102757,2038,0.714187094189808,1958,-0.0276094640870511,80
"9239","3221123",0.643463421289253,3418,0.685393260990028,2913,-0.0419298397007751,505
"9240","4221123",0.601989090588713,5134,0.642982885868218,4760,-0.0409937952795046,374
"9241","1321123",0.721821332334169,1236,0.743511011497333,1243,-0.0216896791631638,-7
"9242","2321123",0.65859815982598,2868,0.68713652685651,2848,-0.0285383670305294,20
"9243","3321123",0.615483951012477,4526,0.65834269365673,4038,-0.0428587426442534,488
"9244","4321123",0.574009620311937,6479,0.61593231853492,6173,-0.0419226982229829,306
"9245","1421123",0.682884834349173,2137,0.702881507529227,2322,-0.0199966731800539,-185
"9246","2421123",0.619661661840984,4351,0.646507022888404,4585,-0.0268453610474196,-234
"9247","3421123",0.576547453027481,6358,0.617713189688625,6064,-0.0411657366611436,294
"9248","4421123",0.535073122326941,8461,0.575302814566814,8473,-0.0402296922398732,-12
"9249","1131123",0.760426058038842,666,0.787400765328308,553,-0.0269747072894664,113
"9250","2131123",0.697202885530653,1768,0.731026280687485,1512,-0.033823395156832,256
"9251","3131123",0.65408867671715,3031,0.702232447487706,2352,-0.048143770770556,679
"9252","4131123",0.61261434601661,4678,0.659822072365895,3981,-0.0472077263492855,697
"9253","1231123",0.706468280445846,1560,0.732096486382602,1492,-0.0256282059367562,68
"9254","2231123",0.643245107937657,3429,0.675722001741779,3300,-0.0324768938041218,129
"9255","3231123",0.600130899124154,5231,0.646928168541999,4562,-0.0467972694178458,669
"9256","4231123",0.558656568423614,7243,0.604517793420189,6806,-0.0458612249965755,437
"9257","1331123",0.67848881016907,2272,0.705045919049304,2247,-0.0265571088802344,25
"9258","2331123",0.615265637660881,4542,0.648671434408481,4464,-0.0334057967476,78
"9259","3331123",0.572151428847377,6583,0.619877601208702,5945,-0.047726172361324,638
"9260","4331123",0.530677098146837,8699,0.577467226086891,8351,-0.0467901279400538,348
"9261","1431123",0.639552312184074,3577,0.664416415081198,3780,-0.0248641028971246,-203
"9262","2431123",0.576329139675885,6366,0.608041930440375,6605,-0.0317127907644903,-239
"9263","3431123",0.533214930862381,8566,0.579248097240596,8239,-0.0460331663782143,327
"9264","4431123",0.491740600161841,10655,0.536837722118785,10645,-0.045097121956944,10
"9265","1141123",0.711392493584013,1442,0.747002271201224,1171,-0.0356097776172117,271
"9266","2141123",0.648169321075824,3260,0.690627786560401,2723,-0.0424584654845773,537
"9267","3141123",0.60505511226232,5007,0.661833953360622,3895,-0.0567788410983013,1112
"9268","4141123",0.56358078156178,6979,0.619423578238811,5972,-0.0558427966770311,1007
"9269","1241123",0.657434715991016,2909,0.691697992255518,2685,-0.0342632762645018,224
"9270","2241123",0.594211543482827,5506,0.635323507614695,5162,-0.0411119641318674,344
"9271","3241123",0.551097334669324,7652,0.606529674414915,6674,-0.0554323397455914,978
"9272","4241123",0.509623003968784,9772,0.564119299293105,9097,-0.0544962953243209,675
"9273","1341123",0.62945524571424,3940,0.66464742492222,3768,-0.03519217920798,172
"9274","2341123",0.566232073206051,6882,0.608272940281397,6593,-0.0420408670753456,289
"9275","3341123",0.523117864392548,9084,0.579479107081617,8227,-0.0563612426890696,857
"9276","4341123",0.481643533692008,11150,0.537068731959807,10633,-0.0554251982677991,517
"9277","1441123",0.590518747729244,5663,0.624017920954114,5722,-0.0334991732248702,-59
"9278","2441123",0.527295575221055,8887,0.567643436313291,8906,-0.0403478610922359,-19
"9279","3441123",0.484181366407552,11039,0.538849603113512,10531,-0.0546682367059599,508
"9280","4441123",0.442707035707012,12843,0.496439227991701,12650,-0.0537321922846893,193
"9281","1112123",0.838652939308673,130,0.848116187905092,134,-0.00946324859641912,-4
"9282","2112123",0.775429766800484,498,0.791741703264269,498,-0.0163119364637847,0
"9283","3112123",0.73231555798698,1055,0.762947870064489,895,-0.0306323120775087,160
"9284","4112123",0.69084122728644,1931,0.720537494942679,1793,-0.0296962676562385,138
"9285","1212123",0.784695161715677,410,0.792811908959386,484,-0.00811674724370914,-74
"9286","2212123",0.721471989207488,1247,0.736437424318562,1392,-0.0149654351110747,-145
"9287","3212123",0.678357780393984,2280,0.707643591118783,2161,-0.0292858107247987,119
"9288","4212123",0.636883449693444,3677,0.665233215996973,3736,-0.0283497663035283,-59
"9289","1312123",0.7567156914389,703,0.765761341626088,850,-0.00904565018718739,-147
"9290","2312123",0.693492518930712,1863,0.709386856985264,2105,-0.015894338054553,-242
"9291","3312123",0.650378310117208,3178,0.680593023785485,3110,-0.030214713668277,68
"9292","4312123",0.608903979416668,4851,0.638182648663675,5033,-0.0292786692470065,-182
"9293","1412123",0.717779193453904,1313,0.725131837657982,1672,-0.00735264420407755,-359
"9294","2412123",0.654556020945716,3008,0.668757353017159,3579,-0.0142013320714433,-571
"9295","3412123",0.611441812132212,4732,0.639963519817379,4921,-0.0285217076851673,-189
"9296","4412123",0.569967481431672,6694,0.597553144695569,7209,-0.0275856632638968,-515
"9297","1122123",0.770673668442253,547,0.787546876247685,550,-0.0168732078054323,-3
"9298","2122123",0.707450495934064,1537,0.731172391606862,1508,-0.0237218956727979,29
"9299","3122123",0.66433628712056,2684,0.702378558407082,2345,-0.0380422712865219,339
"9300","4122123",0.62286195642002,4222,0.659968183285272,3971,-0.0371062268652517,251
"9301","1222123",0.716715890849257,1329,0.732242597301979,1488,-0.0155267064527224,-159
"9302","2222123",0.653492718341068,3060,0.675868112661156,3294,-0.022375394320088,-234
"9303","3222123",0.610378509527564,4781,0.647074279461376,4554,-0.036695769933812,227
"9304","4222123",0.568904178827024,6743,0.604663904339566,6796,-0.0357597255125415,-53
"9305","1322123",0.68873642057248,1976,0.705192029968681,2245,-0.0164556093962006,-269
"9306","2322123",0.625513248064292,4103,0.648817545327858,4460,-0.0233042972635662,-357
"9307","3322123",0.582399039250788,6069,0.620023712128078,5937,-0.0376246728772902,132
"9308","4322123",0.540924708550248,8183,0.577613337006268,8342,-0.0366886284560197,-159
"9309","1422123",0.649799922587484,3200,0.664562526000575,3773,-0.0147626034130908,-573
"9310","2422123",0.586576750079296,5847,0.608188041359752,6600,-0.0216112912804565,-753
"9311","3422123",0.543462541265792,8045,0.579394208159973,8232,-0.0359316668941805,-187
"9312","4422123",0.501988210565252,10169,0.536983833038162,10639,-0.03499562247291,-470
"9313","1132123",0.727341146277153,1130,0.749081783799656,1124,-0.0217406375225032,6
"9314","2132123",0.664117973768964,2690,0.692707299158833,2653,-0.0285893253898688,37
"9315","3132123",0.621003764955461,4288,0.663913465959054,3804,-0.0429097010035928,484
"9316","4132123",0.579529434254921,6230,0.621503090837243,5858,-0.0419736565823223,372
"9317","1232123",0.673383368684157,2406,0.69377750485395,2615,-0.020394136169793,-209
"9318","2232123",0.610160196175968,4791,0.637403020213127,5065,-0.0272428240371586,-274
"9319","3232123",0.567045987362465,6842,0.608609187013347,6580,-0.0415631996508826,262
"9320","4232123",0.525571656661925,8976,0.566198811891537,8981,-0.0406271552296124,-5
"9321","1332123",0.645403898407381,3354,0.666726937520652,3657,-0.0213230391132713,-303
"9322","2332123",0.582180725899192,6090,0.610352452879829,6466,-0.0281717269806369,-376
"9323","3332123",0.539066517085689,8276,0.581558619680049,8099,-0.0424921025943609,177
"9324","4332123",0.497592186385148,10387,0.539148244558239,10516,-0.0415560581730906,-129
"9325","1432123",0.606467400422385,4956,0.626097433552546,5610,-0.0196300331301614,-654
"9326","2432123",0.543244227914196,8058,0.569722948911723,8788,-0.0264787209975271,-730
"9327","3432123",0.500130019100693,10263,0.540929115711944,10426,-0.0407990966112511,-163
"9328","4432123",0.458655688400152,12208,0.498518740590133,12564,-0.0398630521899808,-356
"9329","1142123",0.678307581822324,2282,0.708683289672572,2126,-0.0303757078502486,156
"9330","2142123",0.615084409314135,4552,0.652308805031749,4312,-0.0372243957176142,240
"9331","3142123",0.571970200500631,6589,0.62351497183197,5755,-0.0515447713313382,834
"9332","4142123",0.530495869800091,8707,0.581104596710159,8125,-0.0506087269100679,582
"9333","1242123",0.624349804229327,4167,0.653379010726866,4269,-0.0290292064975386,-102
"9334","2242123",0.561126631721139,7116,0.597004526086043,7237,-0.0358778943649042,-121
"9335","3242123",0.518012422907635,9351,0.568210692886263,8878,-0.0501982699786282,473
"9336","4242123",0.476538092207095,11399,0.525800317764453,11211,-0.0492622255573577,188
"9337","1342123",0.596370333952551,5404,0.626328443393568,5601,-0.0299581094410168,-197
"9338","2342123",0.533147161444362,8571,0.569953958752745,8778,-0.0368067973083824,-207
"9339","3342123",0.490032952630859,10744,0.541160125552965,10412,-0.0511271729221064,332
"9340","4342123",0.448558621930319,12616,0.498749750431155,12557,-0.0501911285008359,59
"9341","1442123",0.557433835967555,7311,0.585698939425462,7849,-0.028265103457907,-538
"9342","2442123",0.494210663459366,10536,0.529324454784639,11037,-0.0351137913252727,-501
"9343","3442123",0.451096454645863,12503,0.50053062158486,12468,-0.0494341669389967,35
"9344","4442123",0.409622123945323,14011,0.458120246463049,14148,-0.0484981225177263,-137
"9345","1113123",0.799769763736187,316,0.822619597515853,258,-0.0228498337796658,58
"9346","2113123",0.736546591227998,985,0.76624511287503,838,-0.0296985216470314,147
"9347","3113123",0.693432382414495,1866,0.73745127967525,1362,-0.0440188972607554,504
"9348","4113123",0.651958051713955,3121,0.69504090455344,2578,-0.0430828528394849,543
"9349","1213123",0.745811986143191,845,0.767315318570147,817,-0.0215033324269556,28
"9350","2213123",0.682588813635002,2150,0.710940833929323,2055,-0.0283520202943212,95
"9351","3213123",0.639474604821499,3588,0.682147000729544,3042,-0.0426723959080452,546
"9352","4213123",0.598000274120959,5323,0.639736625607734,4936,-0.0417363514867749,387
"9353","1313123",0.717832515866415,1310,0.740264751236849,1313,-0.0224322353704338,-3
"9354","2313123",0.654609343358226,3003,0.683890266596025,2972,-0.0292809232377994,31
"9355","3313123",0.611495134544723,4730,0.655096433396246,4185,-0.0436012988515234,545
"9356","4313123",0.570020803844183,6693,0.612686058274436,6352,-0.0426652544302532,341
"9357","1413123",0.678896017881419,2259,0.699635247268743,2421,-0.020739229387324,-162
"9358","2413123",0.61567284537323,4511,0.64326076262792,4748,-0.0275879172546897,-237
"9359","3413123",0.572558636559727,6560,0.61446692942814,6237,-0.0419082928684137,323
"9360","4413123",0.531084305859187,8678,0.57205655430633,8654,-0.0409722484471434,24
"9361","1123123",0.731790492869767,1067,0.762050285858446,911,-0.030259792988679,156
"9362","2123123",0.668567320361578,2555,0.705675801217623,2226,-0.0371084808560446,329
"9363","3123123",0.625453111548075,4109,0.676881968017843,3255,-0.0514288564697686,854
"9364","4123123",0.583978780847535,6003,0.634471592896033,5210,-0.0504928120484981,793
"9365","1223123",0.677832715276771,2293,0.70674600691274,2194,-0.0289132916359688,99
"9366","2223123",0.614609542768582,4573,0.650371522271917,4404,-0.0357619795033344,169
"9367","3223123",0.571495333955079,6612,0.621577689072137,5851,-0.0500823551170584,761
"9368","4223123",0.530021003254539,8734,0.579167313950327,8245,-0.0491463106957881,489
"9369","1323123",0.649853244999995,3195,0.679695439579442,3153,-0.029842194579447,42
"9370","2323123",0.586630072491806,5842,0.623320954938619,5763,-0.0366908824468126,79
"9371","3323123",0.543515863678303,8041,0.594527121738839,7368,-0.0510112580605366,673
"9372","4323123",0.502041532977763,10165,0.552116746617029,9791,-0.0500752136392664,374
"9373","1423123",0.610916747014999,4757,0.639065935611336,4984,-0.0281491885963372,-227
"9374","2423123",0.54769357450681,7801,0.582691450970513,8040,-0.0349978764637029,-239
"9375","3423123",0.504579365693307,10030,0.553897617770734,9691,-0.0493182520774269,339
"9376","4423123",0.463105034992767,11996,0.511487242648923,11961,-0.0483822076561566,35
"9377","1133123",0.688457970704668,1986,0.723585193410417,1715,-0.0351272227057496,271
"9378","2133123",0.625234798196479,4117,0.667210708769594,3640,-0.0419759105731152,477
"9379","3133123",0.582120589382975,6094,0.638416875569815,5022,-0.0562962861868392,1072
"9380","4133123",0.540646258682435,8201,0.596006500448004,7294,-0.055360241765569,907
"9381","1233123",0.634500193111671,3761,0.668280914464711,3608,-0.0337807213530397,153
"9382","2233123",0.571277020603483,6623,0.611906429823888,6402,-0.0406294092204053,221
"9383","3233123",0.528162811789979,8837,0.583112596624108,8009,-0.0549497848341293,828
"9384","4233123",0.486688481089439,10920,0.540702221502298,10440,-0.0540137404128588,480
"9385","1333123",0.606520722834895,4952,0.641230347131413,4861,-0.0347096242965179,91
"9386","2333123",0.543297550326706,8053,0.58485586249059,7894,-0.0415583121638835,159
"9387","3333123",0.500183341513203,10261,0.55606202929081,9569,-0.0558786877776075,692
"9388","4333123",0.458709010812663,12205,0.513651654169,11848,-0.054942643356337,357
"9389","1433123",0.567584224849899,6816,0.600600843163307,7030,-0.0330166183134081,-214
"9390","2433123",0.50436105234171,10039,0.544226358522484,10225,-0.0398653061807738,-186
"9391","3433123",0.461246843528207,12088,0.515432525322705,11751,-0.0541856817944978,337
"9392","4433123",0.419772512827667,13705,0.473022150200894,13647,-0.0532496373732274,58
"9393","1143123",0.639424406249838,3592,0.683186699283333,3003,-0.0437622930334952,589
"9394","2143123",0.576201233741649,6375,0.62681221464251,5576,-0.0506109809008608,799
"9395","3143123",0.533087024928146,8573,0.59801838144273,7179,-0.0649313565145848,1394
"9396","4143123",0.491612694227606,10660,0.55560800632092,9597,-0.0639953120933143,1063
"9397","1243123",0.585466628656842,5926,0.627882420337627,5513,-0.042415791680785,413
"9398","2243123",0.522243456148653,9136,0.571507935696804,8692,-0.0492644795481506,444
"9399","3243123",0.47912924733515,11269,0.542714102497024,10304,-0.0635848551618746,965
"9400","4243123",0.43765491663461,13032,0.500303727375214,12479,-0.0626488107406044,553
"9401","1343123",0.557487158380066,7308,0.600831853004329,7013,-0.0433446946242633,295
"9402","2343123",0.494263985871877,10534,0.544457368363506,10212,-0.0501933824916289,322
"9403","3343123",0.451149777058373,12501,0.515663535163726,11740,-0.0645137581053529,761
"9404","4343123",0.409675446357833,14010,0.473253160041916,13635,-0.0635777136840827,375
"9405","1443123",0.51855066039507,9309,0.560202349036223,9317,-0.0416516886411534,-8
"9406","2443123",0.455327487886881,12325,0.5038278643954,12309,-0.0485003765085191,16
"9407","3443123",0.412213279073377,13935,0.475034031195621,13550,-0.0628207521222432,385
"9408","4443123",0.370738948372837,15036,0.43262365607381,14911,-0.0618847077009728,125
"9409","1114123",0.747562691765617,822,0.777968984142197,667,-0.0304062923765798,155
"9410","2114123",0.684339519257428,2096,0.721594499501374,1767,-0.0372549802439454,329
"9411","3114123",0.641225310443925,3518,0.692800666301594,2649,-0.0515753558576694,869
"9412","4114123",0.599750979743385,5241,0.650390291179784,4402,-0.0506393114363989,839
"9413","1214123",0.693604914172621,1857,0.722664705196491,1735,-0.0290597910238696,122
"9414","2214123",0.630381741664432,3901,0.666290220555668,3677,-0.0359084788912352,224
"9415","3214123",0.587267532850929,5818,0.637496387355888,5062,-0.0502288545049592,756
"9416","4214123",0.545793202150389,7921,0.595086012234078,7340,-0.0492928100836889,581
"9417","1314123",0.665625443895845,2642,0.695614137863193,2553,-0.0299886939673478,89
"9418","2314123",0.602402271387656,5115,0.63923965322237,4967,-0.0368373818347134,148
"9419","3314123",0.559288062574153,7210,0.61044582002259,6459,-0.0511577574484374,751
"9420","4314123",0.517813731873613,9360,0.56803544490078,8884,-0.0502217130271672,476
"9421","1414123",0.626688945910849,4048,0.654984633895087,4192,-0.028295687984238,-144
"9422","2414123",0.56346577340266,6989,0.598610149254264,7137,-0.0351443758516037,-148
"9423","3414123",0.520351564589157,9221,0.569816316054484,8784,-0.0494647514653277,437
"9424","4414123",0.478877233888617,11282,0.527405940932674,11125,-0.0485287070440574,157
"9425","1124123",0.679583420899197,2241,0.71739967248479,1875,-0.037816251585593,366
"9426","2124123",0.616360248391008,4486,0.661025187843967,3929,-0.0446649394529586,557
"9427","3124123",0.573246039577505,6527,0.632231354644188,5303,-0.0589853150666826,1224
"9428","4124123",0.531771708876965,8636,0.589820979522377,7612,-0.0580492706454121,1024
"9429","1224123",0.625625643306201,4094,0.662095393539084,3875,-0.0364697502328828,219
"9430","2224123",0.562402470798012,7044,0.605720908898261,6720,-0.0433184381002484,324
"9431","3224123",0.519288261984509,9270,0.576927075698481,8377,-0.0576388137139724,893
"9432","4224123",0.477813931283969,11335,0.534516700576671,10762,-0.0567027692927021,573
"9433","1324123",0.597646173029425,5342,0.635044826205786,5175,-0.037398653176361,167
"9434","2324123",0.534423000521236,8493,0.578670341564963,8275,-0.0442473410437266,218
"9435","3324123",0.491308791707733,10676,0.549876508365183,9897,-0.0585677166574506,779
"9436","4324123",0.449834461007193,12554,0.507466133243373,12138,-0.0576316722361804,416
"9437","1424123",0.558709675044429,7239,0.59441532223768,7375,-0.0357056471932512,-136
"9438","2424123",0.49548650253624,10468,0.538040837596857,10575,-0.0425543350606169,-107
"9439","3424123",0.452372293722737,12451,0.509247004397078,12052,-0.0568747106743409,399
"9440","4424123",0.410897963022197,13968,0.466836629275267,13854,-0.0559386662530706,114
"9441","1134123",0.636250898734098,3707,0.678934580036761,3179,-0.0426836813026636,528
"9442","2134123",0.573027726225909,6532,0.622560095395938,5807,-0.0495323691700292,725
"9443","3134123",0.529913517412405,8741,0.593766262196159,7421,-0.0638527447837532,1320
"9444","4134123",0.488439186711865,10835,0.551355887074348,9825,-0.062916700362483,1010
"9445","1234123",0.582293121141102,6080,0.623630301091055,5749,-0.0413371799499537,331
"9446","2234123",0.519069948632913,9281,0.567255816450232,8925,-0.0481858678173193,356
"9447","3234123",0.475955739819409,11429,0.538461983250452,10555,-0.0625062434310433,874
"9448","4234123",0.434481409118869,13169,0.496051608128642,12668,-0.0615701990097727,501
"9449","1334123",0.554313650864325,7487,0.596579733757757,7262,-0.0422660828934319,225
"9450","2334123",0.491090478356137,10687,0.540205249116934,10464,-0.0491147707607975,223
"9451","3334123",0.447976269542633,12641,0.511411415917155,11966,-0.0634351463745215,675
"9452","4334123",0.406501938842093,14117,0.469001040795344,13794,-0.0624991019532511,323
"9453","1434123",0.515377152879329,9501,0.555950229789651,9582,-0.0405730769103221,-81
"9454","2434123",0.45215398037114,12456,0.499575745148828,12519,-0.0474217647776877,-63
"9455","3434123",0.409039771557637,14034,0.470781911949049,13733,-0.0617421403914117,301
"9456","4434123",0.367565440857097,15110,0.428371536827238,15017,-0.0608060959701414,93
"9457","1144123",0.587217334279268,5822,0.638536085909677,5016,-0.0513187516304092,806
"9458","2144123",0.523994161771079,9045,0.582161601268854,8076,-0.0581674394977748,969
"9459","3144123",0.480879952957576,11189,0.553367768069075,9725,-0.0724878151114988,1464
"9460","4144123",0.439405622257036,12966,0.510957392947264,11986,-0.0715517706902283,980
"9461","1244123",0.533259556686272,8561,0.583231806963971,7999,-0.049972250277699,562
"9462","2244123",0.470036384178083,11692,0.526857322323148,11151,-0.0568209381450646,541
"9463","3244123",0.42692217536458,13444,0.498063489123368,12579,-0.0711413137587886,865
"9464","4244123",0.38544784466404,14699,0.455653114001558,14225,-0.0702052693375183,474
"9465","1344123",0.505280086409496,9992,0.556181239630673,9562,-0.0509011532211773,430
"9466","2344123",0.442056913901307,12866,0.49980675498985,12507,-0.0577498410885428,359
"9467","3344123",0.398942705087803,14327,0.47101292179007,13723,-0.0720702167022669,604
"9468","4344123",0.357468374387264,15305,0.42860254666826,15011,-0.0711341722809966,294
"9469","1444123",0.4663435884245,11846,0.515551735662567,11746,-0.0492081472380674,100
"9470","2444123",0.403120415916311,14212,0.459177251021744,14117,-0.0560568351054332,95
"9471","3444123",0.360006207102808,15261,0.430383417821965,14969,-0.0703772107191572,292
"9472","4444123",0.318531876402268,15858,0.387973042700154,15756,-0.0694411662978868,102
"9473","1111223",0.825889016922152,174,0.841100322778962,163,-0.0152113058568105,11
"9474","2111223",0.762665844413963,631,0.784725838138139,583,-0.0220599937241761,48
"9475","3111223",0.719551635600459,1281,0.755932004938359,994,-0.0363803693379001,287
"9476","4111223",0.678077304899919,2286,0.713521629816549,1973,-0.0354443249166299,313
"9477","1211223",0.771931239329155,528,0.785796043833256,569,-0.0138648045041005,-41
"9478","2211223",0.708708066820966,1502,0.729421559192433,1547,-0.0207134923714661,-45
"9479","3211223",0.665593858007463,2645,0.700627725992653,2384,-0.0350338679851901,261
"9480","4211223",0.624119527306923,4175,0.658217350870843,4042,-0.0340978235639197,133
"9481","1311223",0.743951769052379,867,0.758745476499958,955,-0.0147937074475788,-88
"9482","2311223",0.68072859654419,2206,0.702370991859135,2347,-0.0216423953149444,-141
"9483","3311223",0.637614387730687,3651,0.673577158659355,3371,-0.0359627709286684,280
"9484","4311223",0.596140057030147,5416,0.631166783537545,5351,-0.0350267265073979,65
"9485","1411223",0.705015271067383,1591,0.718115972531852,1855,-0.013100701464469,-264
"9486","2411223",0.641792098559194,3493,0.661741487891029,3902,-0.0199493893318347,-409
"9487","3411223",0.598677889745691,5293,0.63294765469125,5267,-0.0342697649455587,26
"9488","4411223",0.557203559045151,7332,0.590537279569439,7571,-0.0333337205242882,-239
"9489","1121223",0.757909746055732,687,0.780531011121555,635,-0.0226212650658237,52
"9490","2121223",0.694686573547543,1822,0.724156526480732,1695,-0.0294699529331893,127
"9491","3121223",0.651572364734039,3137,0.695362693280953,2565,-0.0437903285469133,572
"9492","4121223",0.610098034033499,4793,0.652952318159142,4282,-0.0428542841256431,511
"9493","1221223",0.703951968462735,1610,0.725226732175849,1667,-0.0212747637131138,-57
"9494","2221223",0.640728795954546,3533,0.668852247535026,3572,-0.0281234515804794,-39
"9495","3221223",0.597614587141043,5345,0.640058414335246,4913,-0.0424438271942034,432
"9496","4221223",0.556140256440503,7390,0.597648039213436,7197,-0.0415077827729329,193
"9497","1321223",0.675972498185959,2341,0.698176164842551,2474,-0.022203666656592,-133
"9498","2321223",0.61274932567777,4670,0.641801680201728,4826,-0.0290523545239576,-156
"9499","3321223",0.569635116864267,6711,0.613007847001948,6331,-0.0433727301376816,380
"9500","4321223",0.528160786163727,8839,0.570597471880138,8746,-0.0424366857164111,93
"9501","1421223",0.637036000200963,3672,0.657546660874445,4078,-0.0205106606734822,-406
"9502","2421223",0.573812827692774,6488,0.601172176233622,6989,-0.0273593485408479,-501
"9503","3421223",0.530698618879271,8698,0.572378343033843,8630,-0.0416797241545719,68
"9504","4421223",0.489224288178731,10785,0.529967967912032,11004,-0.0407436797333014,-219
"9505","1131223",0.714577223890632,1375,0.742065918673526,1266,-0.0274886947828946,109
"9506","2131223",0.651354051382443,3145,0.685691434032703,2901,-0.0343373826502602,244
"9507","3131223",0.60823984256894,4884,0.656897600832924,4107,-0.0486577582639842,777
"9508","4131223",0.5667655118684,6850,0.614487225711113,6236,-0.0477217138427137,614
"9509","1231223",0.660619446297636,2796,0.68676163972782,2863,-0.0261421934301844,-67
"9510","2231223",0.597396273789447,5357,0.630387155086997,5389,-0.03299088129755,-32
"9511","3231223",0.554282064975943,7489,0.601593321887217,6955,-0.047311256911274,534
"9512","4231223",0.512807734275403,9637,0.559182946765407,9385,-0.0463752124900038,252
"9513","1331223",0.63263997602086,3819,0.659711072394522,3984,-0.0270710963736627,-165
"9514","2331223",0.569416803512671,6723,0.603336587753699,6860,-0.0339197842410283,-137
"9515","3331223",0.526302594699167,8943,0.57454275455392,8517,-0.0482401598547523,426
"9516","4331223",0.484828263998627,11003,0.532132379432109,10883,-0.047304115433482,120
"9517","1431223",0.593703478035864,5520,0.619081568426416,5988,-0.0253780903905528,-468
"9518","2431223",0.530480305527675,8709,0.562707083785593,9181,-0.0322267782579185,-472
"9519","3431223",0.487366096714171,10892,0.533913250585814,10795,-0.0465471538716425,97
"9520","4431223",0.445891766013631,12721,0.491502875464003,12865,-0.0456111094503722,-144
"9521","1141223",0.665543659435802,2647,0.701667424546442,2364,-0.03612376511064,283
"9522","2141223",0.602320486927614,5121,0.645292939905619,4637,-0.0429724529780056,484
"9523","3141223",0.55920627811411,7215,0.61649910670584,6141,-0.0572928285917296,1074
"9524","4141223",0.51773194741357,9362,0.574088731584029,8543,-0.0563567841704593,819
"9525","1241223",0.611585881842806,4720,0.646363145600736,4590,-0.03477726375793,130
"9526","2241223",0.548362709334617,7775,0.589988660959913,7602,-0.0416259516252956,173
"9527","3241223",0.505248500521114,9994,0.561194827760133,9255,-0.0559463272390196,739
"9528","4241223",0.463774169820574,11966,0.518784452638323,11567,-0.0550102828177491,399
"9529","1341223",0.58360641156603,6024,0.619312578267438,5980,-0.0357061667014082,44
"9530","2341223",0.520383239057841,9220,0.562938093626615,9167,-0.0425548545687738,53
"9531","3341223",0.477269030244338,11359,0.534144260426835,10786,-0.0568752301824978,573
"9532","4341223",0.435794699543798,13112,0.491733885305025,12858,-0.0559391857612273,254
"9533","1441223",0.544669913581034,7984,0.578683074299332,8274,-0.0340131607182984,-290
"9534","2441223",0.481446741072845,11161,0.522308589658509,11383,-0.0408618485856641,-222
"9535","3441223",0.438332532259342,13001,0.49351475645873,12774,-0.0551822241993881,227
"9536","4441223",0.396858201558802,14391,0.451104381336919,14374,-0.0542461797781177,17
"9537","1112223",0.792804105160463,357,0.80278134125031,402,-0.00997723608984735,-45
"9538","2112223",0.729580932652274,1098,0.746406856609487,1180,-0.0168259239572129,-82
"9539","3112223",0.68646672383877,2047,0.717613023409707,1870,-0.031146299570937,177
"9540","4112223",0.64499239313823,3365,0.675202648287897,3315,-0.0302102551496667,50
"9541","1212223",0.738846327567466,939,0.747477062304604,1158,-0.00863073473713738,-219
"9542","2212223",0.675623155059278,2348,0.69110257766378,2704,-0.015479422604503,-356
"9543","3212223",0.632508946245774,3828,0.662308744464001,3867,-0.029799798218227,-39
"9544","4212223",0.591034615545234,5630,0.619898369342191,5943,-0.0288637537969565,-313
"9545","1312223",0.71086685729069,1449,0.720426494971306,1801,-0.00955963768061563,-352
"9546","2312223",0.647643684782501,3278,0.664052010330483,3797,-0.0164083255479812,-519
"9547","3312223",0.604529475968998,5028,0.635258177130703,5168,-0.0307287011617052,-140
"9548","4312223",0.563055145268458,7011,0.592847802008893,7465,-0.0297926567404347,-454
"9549","1412223",0.671930359305694,2448,0.6797969910032,3148,-0.00786663169750579,-700
"9550","2412223",0.608707186797505,4864,0.623422506362377,5760,-0.0147153195648715,-896
"9551","3412223",0.565592977984002,6910,0.594628673162597,7364,-0.0290356951785955,-454
"9552","4412223",0.524118647283462,9041,0.552218298040787,9786,-0.028099650757325,-745
"9553","1122223",0.724824834294043,1182,0.742212029592903,1264,-0.0173871952988606,-82
"9554","2122223",0.661601661785854,2770,0.68583754495208,2897,-0.0242358831662262,-127
"9555","3122223",0.61848745297235,4407,0.6570437117523,4101,-0.0385562587799502,306
"9556","4122223",0.57701312227181,6339,0.61463333663049,6230,-0.0376202143586799,109
"9557","1222223",0.670867056701046,2475,0.686907750647197,2856,-0.0160406939461506,-381
"9558","2222223",0.607643884192858,4906,0.630533266006374,5380,-0.0228893818135162,-474
"9559","3222223",0.564529675379354,6949,0.601739432806594,6948,-0.0372097574272402,1
"9560","4222223",0.523055344678814,9089,0.559329057684784,9371,-0.0362737130059697,-282
"9561","1322223",0.64288758642427,3445,0.659857183313899,3979,-0.0169695968896288,-534
"9562","2322223",0.579664413916081,6220,0.603482698673076,6851,-0.0238182847569944,-631
"9563","3322223",0.536550205102578,8388,0.574688865473296,8511,-0.0381386603707184,-123
"9564","4322223",0.495075874402038,10494,0.532278490351486,10878,-0.037202615949448,-384
"9565","1422223",0.603951088439274,5052,0.619227679345793,5983,-0.015276590906519,-931
"9566","2422223",0.540727915931085,8195,0.56285319470497,9173,-0.0221252787738847,-978
"9567","3422223",0.497613707117582,10383,0.534059361505191,10789,-0.0364456543876087,-406
"9568","4422223",0.456139376417042,12301,0.49164898638338,12862,-0.0355096099663382,-561
"9569","1132223",0.681492312128943,2187,0.703746937144874,2285,-0.0222546250159315,-98
"9570","2132223",0.618269139620754,4418,0.647372452504051,4539,-0.029103312883297,-121
"9571","3132223",0.57515493080725,6429,0.618578619304272,6013,-0.043423688497021,416
"9572","4132223",0.533680600106711,8530,0.576168244182461,8418,-0.0424876440757506,112
"9573","1232223",0.627534534535947,4016,0.648442658199168,4475,-0.0209081236632213,-459
"9574","2232223",0.564311362027758,6959,0.592068173558345,7499,-0.0277568115305868,-540
"9575","3232223",0.521197153214255,9187,0.563274340358565,9147,-0.0420771871443109,40
"9576","4232223",0.479722822513714,11230,0.520863965236755,11449,-0.0411411427230406,-219
"9577","1332223",0.599555064259171,5251,0.62139209086587,5865,-0.0218370266066995,-614
"9578","2332223",0.536331891750982,8407,0.565017606225047,9039,-0.0286857144740651,-632
"9579","3332223",0.493217682937478,10585,0.536223773025267,10673,-0.0430060900877891,-88
"9580","4332223",0.451743352236938,12469,0.493813397903457,12764,-0.0420700456665188,-295
"9581","1432223",0.560618566274175,7141,0.580762586897764,8145,-0.0201440206235897,-1004
"9582","2432223",0.497395393765986,10397,0.524388102256941,11278,-0.0269927084909554,-881
"9583","3432223",0.454281184952482,12375,0.495594269057162,12687,-0.0413130841046793,-312
"9584","4432223",0.412806854251942,13912,0.453183893935351,14305,-0.0403770396834091,-393
"9585","1142223",0.632458747674113,3831,0.66334844301779,3823,-0.0308896953436768,8
"9586","2142223",0.569235575165925,6728,0.606973958376967,6653,-0.0377383832110424,75
"9587","3142223",0.526121366352421,8955,0.578180125177188,8310,-0.0520587588247664,645
"9588","4142223",0.484647035651881,11009,0.535769750055377,10699,-0.0511227144034961,310
"9589","1242223",0.578500970081117,6276,0.608044164072084,6604,-0.0295431939909668,-328
"9590","2242223",0.515277797572928,9508,0.551669679431261,9811,-0.0363918818583324,-303
"9591","3242223",0.472163588759425,11611,0.522875846231481,11353,-0.0507122574720564,258
"9592","4242223",0.430689258058885,13316,0.480465471109671,13319,-0.0497762130507859,-3
"9593","1342223",0.550521499804341,7676,0.580993596738786,8134,-0.0304720969344451,-458
"9594","2342223",0.487298327296152,10895,0.524619112097963,11270,-0.0373207848018107,-375
"9595","3342223",0.444184118482649,12792,0.495825278898183,12679,-0.0516411604155346,113
"9596","4342223",0.402709787782109,14226,0.453414903776373,14302,-0.0507051159942642,-76
"9597","1442223",0.511585001819345,9690,0.54036409277068,10457,-0.0287790909513352,-767
"9598","2442223",0.448361829311156,12625,0.483989608129857,13181,-0.0356277788187009,-556
"9599","3442223",0.405247620497653,14162,0.455195774930078,14240,-0.0499481544324249,-78
"9600","4442223",0.363773289797113,15190,0.412785399808267,15351,-0.0490121100111545,-161
"9601","1113223",0.753920929587977,735,0.777284750861071,673,-0.023363821273094,62
"9602","2113223",0.690697757079788,1935,0.720910266220248,1783,-0.0302125091404596,152
"9603","3113223",0.647583548266285,3283,0.692116433020468,2663,-0.0445328847541836,620
"9604","4113223",0.606109217565745,4973,0.649706057898658,4430,-0.0435968403329131,543
"9605","1213223",0.699963151994981,1693,0.721980471915365,1753,-0.0220173199203838,-60
"9606","2213223",0.636739979486792,3683,0.665605987274541,3716,-0.0288660077877494,-33
"9607","3213223",0.593625770673289,5527,0.636812154074762,5083,-0.0431863834014734,444
"9608","4213223",0.552151439972749,7592,0.594401778952952,7379,-0.0422503389802031,213
"9609","1313223",0.671983681718205,2447,0.694929904582067,2582,-0.0229462228638621,-135
"9610","2313223",0.608760509210016,4859,0.638555419941244,5014,-0.0297949107312276,-155
"9611","3313223",0.565646300396512,6905,0.609761586741464,6505,-0.0441152863449517,400
"9612","4313223",0.524171969695972,9040,0.567351211619654,8918,-0.0431792419236814,122
"9613","1413223",0.633047183733209,3809,0.654300400613961,4224,-0.0212532168807522,-415
"9614","2413223",0.56982401122502,6699,0.597925915973138,7188,-0.0281019047481179,-489
"9615","3413223",0.526709802411516,8924,0.569132082773358,8824,-0.0424222803618419,100
"9616","4413223",0.485235471710976,10986,0.526721707651548,11157,-0.0414862359405717,-171
"9617","1123223",0.685941658721557,2058,0.716715439203664,1896,-0.0307737804821072,162
"9618","2123223",0.622718486213368,4227,0.660340954562841,3957,-0.0376224683494728,270
"9619","3123223",0.579604277399865,6227,0.631547121363061,5336,-0.0519428439631968,891
"9620","4123223",0.538129946699325,8325,0.589136746241251,7651,-0.0510067995419263,674
"9621","1223223",0.631983881128561,3844,0.661411160257958,3916,-0.029427279129397,-72
"9622","2223223",0.568760708620372,6747,0.605036675617135,6770,-0.0362759669967626,-23
"9623","3223223",0.525646499806869,8970,0.576242842417355,8413,-0.0505963426104866,557
"9624","4223223",0.484172169106329,11040,0.533832467295545,10801,-0.0496602981892164,239
"9625","1323223",0.604004410851785,5050,0.63436059292466,5217,-0.0303561820728753,-167
"9626","2323223",0.540781238343596,8189,0.577986108283837,8322,-0.0372048699402409,-133
"9627","3323223",0.497667029530092,10378,0.549192275084057,9942,-0.0515252455539649,436
"9628","4323223",0.456192698829552,12298,0.506781899962247,12173,-0.0505892011326946,125
"9629","1423223",0.565067912866789,6933,0.593731088956554,7425,-0.0286631760897654,-492
"9630","2423223",0.5018447403586,10174,0.537356604315731,10621,-0.0355118639571311,-447
"9631","3423223",0.458730531545096,12204,0.508562771115952,12084,-0.0498322395708551,120
"9632","4423223",0.417256200844556,13781,0.466152395994141,13879,-0.0488961951495849,-98
"9633","1133223",0.642609136556457,3459,0.678250346755635,3195,-0.0356412101991779,264
"9634","2133223",0.579385964048269,6235,0.621875862114812,5834,-0.0424898980665435,401
"9635","3133223",0.536271755234765,8412,0.593082028915033,7448,-0.0568102736802675,964
"9636","4133223",0.494797424534225,10509,0.550671653793222,9859,-0.0558742292589972,650
"9637","1233223",0.588651358963461,5749,0.622946067809929,5788,-0.0342947088464679,-39
"9638","2233223",0.525428186455272,8984,0.566571583169106,8964,-0.0411433967138335,20
"9639","3233223",0.482313977641769,11125,0.537777749969326,10592,-0.0554637723275575,533
"9640","4233223",0.440839646941229,12914,0.495367374847516,12702,-0.054527727906287,212
"9641","1333223",0.560671888686685,7137,0.595895500476631,7300,-0.0352236117899462,-163
"9642","2333223",0.497448716178496,10393,0.539521015835808,10499,-0.0420722996573117,-106
"9643","3333223",0.454334507364993,12372,0.510727182636028,11997,-0.0563926752710358,375
"9644","4333223",0.412860176664453,13910,0.468316807514218,13813,-0.0554566308497653,97
"9645","1433223",0.521735390701689,9160,0.555265996508525,9613,-0.0335306058068363,-453
"9646","2433223",0.4585122181935,12213,0.498891511867702,12554,-0.040379293674202,-341
"9647","3433223",0.415398009379997,13835,0.470097678667923,13761,-0.0546996692879261,74
"9648","4433223",0.373923678679457,14966,0.427687303546112,15029,-0.0537636248666556,-63
"9649","1143223",0.593575572101628,5530,0.637851852628551,5046,-0.0442762805269235,484
"9650","2143223",0.530352399593439,8714,0.581477367987728,8107,-0.051124968394289,607
"9651","3143223",0.487238190779935,10900,0.552683534787949,9764,-0.065445344008013,1136
"9652","4143223",0.445763860079396,12725,0.510273159666138,12018,-0.0645092995867426,707
"9653","1243223",0.539617794508632,8248,0.582547573682845,8051,-0.0429297791742133,197
"9654","2243223",0.476394622000443,11405,0.526173089042022,11190,-0.0497784670415788,215
"9655","3243223",0.433280413186939,13223,0.497379255842242,12605,-0.0640988426553028,618
"9656","4243223",0.391806082486399,14550,0.454968880720432,14249,-0.0631627982340326,301
"9657","1343223",0.511638324231856,9688,0.555497006349547,9603,-0.0438586821176915,85
"9658","2343223",0.448415151723667,12621,0.499122521708724,12543,-0.050707369985057,78
"9659","3343223",0.405300942910163,14160,0.470328688508944,13754,-0.0650277455987812,406
"9660","4343223",0.363826612209623,15189,0.427918313387134,15025,-0.0640917011775109,164
"9661","1443223",0.47270182624686,11579,0.514867502381441,11784,-0.0421656761345817,-205
"9662","2443223",0.409478653738671,14016,0.458493017740618,14137,-0.0490143640019474,-121
"9663","3443223",0.366364444925167,15141,0.429699184540839,14985,-0.0633347396156714,156
"9664","4443223",0.324890114224627,15793,0.387288809419028,15763,-0.062398695194401,30
"9665","1114223",0.701713857617407,1660,0.732634137487415,1476,-0.030920279870008,184
"9666","2114223",0.638490685109218,3618,0.676259652846592,3283,-0.0377689677373736,335
"9667","3114223",0.595376476295715,5456,0.647465819646812,4533,-0.0520893433510976,923
"9668","4114223",0.553902145595175,7504,0.605055444525002,6767,-0.0511532989298271,737
"9669","1214223",0.647756080024411,3271,0.677329858541709,3235,-0.0295737785172978,36
"9670","2214223",0.584532907516222,5974,0.620955373900886,5891,-0.0364224663846634,83
"9671","3214223",0.541418698702719,8152,0.592161540701106,7495,-0.0507428419983874,657
"9672","4214223",0.499944368002179,10270,0.549751165579296,9906,-0.0498067975771171,364
"9673","1314223",0.619776609747635,4343,0.650279291208411,4410,-0.0305026814607761,-67
"9674","2314223",0.556553437239446,7364,0.593904806567588,7411,-0.0373513693281416,-47
"9675","3314223",0.513439228425943,9598,0.565110973367808,9032,-0.0516717449418657,566
"9676","4314223",0.471964897725403,11619,0.522700598245998,11361,-0.0507357005205954,258
"9677","1414223",0.580840111762639,6159,0.609649787240305,6514,-0.0288096754776662,-355
"9678","2414223",0.51761693925445,9370,0.553275302599482,9731,-0.0356583633450319,-361
"9679","3414223",0.474502730440947,11499,0.524481469399703,11274,-0.0499787389587559,225
"9680","4414223",0.433028399740407,13233,0.482071094277892,13249,-0.0490426945374856,-16
"9681","1124223",0.633734586750987,3786,0.672064825830008,3435,-0.0383302390790212,351
"9682","2124223",0.570511414242798,6660,0.615690341189185,6179,-0.0451789269463868,481
"9683","3124223",0.527397205429295,8880,0.586896507989406,7786,-0.0594993025601108,1094
"9684","4124223",0.485922874728755,10961,0.544486132867595,10209,-0.0585632581388403,752
"9685","1224223",0.579776809157991,6215,0.616760546884302,6123,-0.036983737726311,92
"9686","2224223",0.516553636649802,9434,0.560386062243479,9303,-0.0438324255936766,131
"9687","3224223",0.473439427836299,11548,0.531592229043699,10912,-0.0581528012074006,636
"9688","4224223",0.431965097135759,13268,0.489181853921889,12968,-0.0572167567861303,300
"9689","1324223",0.551797338881215,7607,0.589709979551004,7621,-0.0379126406697893,-14
"9690","2324223",0.488574166373026,10821,0.533335494910181,10827,-0.0447613285371549,-6
"9691","3324223",0.445459957559523,12732,0.504541661710401,12266,-0.0590817041508789,466
"9692","4324223",0.403985626858983,14193,0.462131286588591,14010,-0.0581456597296086,183
"9693","1424223",0.512860840896219,9634,0.549080475582898,9947,-0.0362196346866794,-313
"9694","2424223",0.44963766838803,12564,0.492705990942075,12813,-0.0430683225540451,-249
"9695","3424223",0.406523459574527,14115,0.463912157742296,13948,-0.0573886981677692,167
"9696","4424223",0.365049128873987,15167,0.421501782620485,15158,-0.0564526537464988,9
"9697","1134223",0.590402064585888,5673,0.63359973338198,5241,-0.0431976687960919,432
"9698","2134223",0.527178892077699,8892,0.577225248741156,8363,-0.0500463566634575,529
"9699","3134223",0.484064683264195,11048,0.548431415541377,9985,-0.0643667322771815,1063
"9700","4134223",0.442590352563655,12848,0.506021040419566,12203,-0.0634306878559112,645
"9701","1234223",0.536444286992891,8402,0.578295454436273,8303,-0.0418511674433819,99
"9702","2234223",0.473221114484702,11558,0.52192096979545,11402,-0.0486998553107475,156
"9703","3234223",0.430106905671199,13339,0.49312713659567,12796,-0.0630202309244715,543
"9704","4234223",0.388632574970659,14618,0.45071676147386,14390,-0.0620841865032011,228
"9705","1334223",0.508464816716115,9827,0.551244887102975,9832,-0.0427800703868602,-5
"9706","2334223",0.445241644207926,12748,0.494870402462152,12722,-0.0496287582542257,26
"9707","3334223",0.402127435394423,14244,0.466076569262373,13884,-0.0639491338679497,360
"9708","4334223",0.360653104693883,15246,0.423666194140562,15111,-0.0630130894466793,135
"9709","1434223",0.469528318731119,11719,0.51061538313487,12005,-0.0410870644037503,-286
"9710","2434223",0.40630514622293,14124,0.454240898494046,14279,-0.047935752271116,-155
"9711","3434223",0.363190937409427,15202,0.425447065294267,15074,-0.06225612788484,128
"9712","4434223",0.321716606708887,15827,0.383036690172457,15819,-0.0613200834635696,8
"9713","1144223",0.541368500131058,8158,0.593201239254895,7444,-0.0518327391238375,714
"9714","2144223",0.478145327622869,11313,0.536826754614072,10646,-0.058681426991203,667
"9715","3144223",0.435031118809366,13148,0.508032921414293,12112,-0.0730018026049271,1036
"9716","4144223",0.393556788108826,14489,0.465622546292482,13904,-0.0720657581836566,585
"9717","1244223",0.487410722538062,10889,0.537896960309189,10586,-0.0504862377711273,303
"9718","2244223",0.424187550029873,13542,0.481522475668366,13276,-0.0573349256384929,266
"9719","3244223",0.38107334121637,14809,0.452728642468586,14324,-0.0716553012522169,485
"9720","4244223",0.33959901051583,15607,0.410318267346776,15394,-0.0707192568309465,213
"9721","1344223",0.459431252261286,12167,0.510846392975891,11992,-0.0514151407146055,175
"9722","2344223",0.396208079753097,14411,0.454471908335068,14270,-0.0582638285819712,141
"9723","3344223",0.353093870939593,15387,0.425678075135288,15067,-0.0725842041956952,320
"9724","4344223",0.311619540239053,15939,0.383267700013478,15816,-0.0716481597744248,123
"9725","1444223",0.42049475427629,13674,0.470216889007785,13758,-0.0497221347314957,-84
"9726","2444223",0.357271581768101,15308,0.413842404366962,15328,-0.0565708225988614,-20
"9727","3444223",0.314157372954597,15912,0.385048571167183,15792,-0.0708911982125854,120
"9728","4444223",0.272683042254057,16207,0.342638196045372,16180,-0.0699551537913151,27
"9729","1111323",0.803435037916844,292,0.823050332851287,252,-0.0196152949344439,40
"9730","2111323",0.740211865408655,923,0.766675848210464,829,-0.0264639828018095,94
"9731","3111323",0.697097656595151,1772,0.737882015010685,1353,-0.0407843584155335,419
"9732","4111323",0.655623325894611,2964,0.695471639888874,2558,-0.0398483139942633,406
"9733","1211323",0.749477260323847,793,0.767746053905581,802,-0.0182687935817339,-9
"9734","2211323",0.686254087815658,2051,0.711371569264758,2034,-0.0251174814490995,17
"9735","3211323",0.643139879002155,3435,0.682577736064979,3021,-0.0394378570628235,414
"9736","4211323",0.601665548301615,5150,0.640167360943168,4905,-0.0385018126415531,245
"9737","1311323",0.721497790047071,1246,0.740695486572283,1301,-0.0191976965252122,-55
"9738","2311323",0.658274617538882,2882,0.68432100193146,2956,-0.0260463843925778,-74
"9739","3311323",0.615160408725379,4548,0.655527168731681,4164,-0.0403667600063018,384
"9740","4311323",0.573686078024839,6495,0.61311679360987,6318,-0.0394307155850313,177
"9741","1411323",0.682561292062075,2155,0.700065982604178,2405,-0.0175046905421024,-250
"9742","2411323",0.619338119553886,4371,0.643691497963354,4723,-0.0243533784094681,-352
"9743","3411323",0.576223910740383,6374,0.614897664763575,6217,-0.0386737540231921,157
"9744","4411323",0.534749580039843,8477,0.572487289641765,8623,-0.0377377096019216,-146
"9745","1121323",0.735455767050424,1007,0.762481021193881,901,-0.0270252541434571,106
"9746","2121323",0.672232594542235,2438,0.706106536553057,2215,-0.0338739420108227,223
"9747","3121323",0.629118385728731,3959,0.677312703353278,3236,-0.0481943176245467,723
"9748","4121323",0.587644055028191,5796,0.634902328231468,5186,-0.0472582732032765,610
"9749","1221323",0.681497989457427,2185,0.707176742248175,2177,-0.0256787527907472,8
"9750","2221323",0.618274816949238,4416,0.650802257607351,4377,-0.0325274406581127,39
"9751","3221323",0.575160608135735,6427,0.622008424407572,5827,-0.0468478162718368,600
"9752","4221323",0.533686277435195,8528,0.579598049285761,8219,-0.0459117718505663,309
"9753","1321323",0.653518519180651,3058,0.680126174914877,3131,-0.0266076557342254,-73
"9754","2321323",0.590295346672462,5679,0.623751690274053,5738,-0.033456343601591,-59
"9755","3321323",0.547181137858959,7840,0.594957857074274,7346,-0.047776719215315,494
"9756","4321323",0.505706807158419,9965,0.552547481952464,9770,-0.0468406747940445,195
"9757","1421323",0.614582021195655,4577,0.639496670946771,4954,-0.0249146497511156,-377
"9758","2421323",0.551358848687466,7630,0.583122186305948,8008,-0.0317633376184813,-378
"9759","3421323",0.508244639873963,9844,0.554328353106168,9664,-0.0460837132322053,180
"9760","4421323",0.466770309173423,11824,0.511917977984358,11938,-0.0451476688109348,-114
"9761","1131323",0.692123244885324,1901,0.724015928745852,1698,-0.031892683860528,203
"9762","2131323",0.628900072377135,3965,0.667641444105029,3623,-0.0387413717278936,342
"9763","3131323",0.585785863563631,5900,0.638847610905249,4996,-0.0530617473416176,904
"9764","4131323",0.544311532863092,8000,0.596437235783439,7267,-0.0521257029203471,733
"9765","1231323",0.638165467292328,3631,0.668711649800146,3581,-0.0305461825078178,50
"9766","2231323",0.574942294784139,6439,0.612337165159322,6369,-0.0373948703751834,70
"9767","3231323",0.531828085970635,8632,0.583543331959543,7976,-0.0517152459889074,656
"9768","4231323",0.490353755270095,10724,0.541132956837733,10414,-0.0507792015676372,310
"9769","1331323",0.610185997015552,4789,0.641661082466848,4836,-0.0314750854512961,-47
"9770","2331323",0.546962824507363,7853,0.585286597826024,7870,-0.0383237733186617,-17
"9771","3331323",0.503848615693859,10073,0.556492764626245,9541,-0.0526441489323857,532
"9772","4331323",0.462374284993319,12028,0.514082389504435,11825,-0.0517081045111154,203
"9773","1431323",0.571249499030556,6625,0.601031578498742,6997,-0.0297820794681862,-372
"9774","2431323",0.508026326522367,9856,0.544657093857919,10198,-0.0366307673355519,-342
"9775","3431323",0.464912117708863,11914,0.515863260658139,11726,-0.0509511429492759,188
"9776","4431323",0.423437787008323,13562,0.473452885536329,13625,-0.0500150985280057,-63
"9777","1141323",0.643089680430494,3437,0.683617434618768,2981,-0.0405277541882734,456
"9778","2141323",0.579866507922306,6208,0.627242949977944,5547,-0.047376442055639,661
"9779","3141323",0.536752299108802,8378,0.598449116778165,7147,-0.061696817669363,1231
"9780","4141323",0.495277968408262,10479,0.556038741656355,9571,-0.0607607732480927,908
"9781","1241323",0.589131902837498,5728,0.628313155673062,5484,-0.0391812528355634,244
"9782","2241323",0.525908730329309,8961,0.571938671032238,8661,-0.046029940702929,300
"9783","3241323",0.482794521515806,11104,0.543144837832459,10279,-0.060350316316653,825
"9784","4241323",0.441320190815266,12891,0.500734462710648,12457,-0.0594142718953825,434
"9785","1341323",0.561152432560722,7114,0.601262588339764,6983,-0.0401101557790416,131
"9786","2341323",0.497929260052533,10368,0.54488810369894,10180,-0.0469588436464072,188
"9787","3341323",0.45481505123903,12352,0.516094270499161,11712,-0.0612792192601312,640
"9788","4341323",0.41334072053849,13891,0.47368389537735,13615,-0.0603431748388608,276
"9789","1441323",0.522215934575726,9140,0.560633084371658,9288,-0.0384171497959318,-148
"9790","2441323",0.458992762067537,12191,0.504258599730835,12284,-0.0452658376632975,-93
"9791","3441323",0.415878553254034,13817,0.475464766531055,13530,-0.0595862132770216,287
"9792","4441323",0.374404222553494,14954,0.433054391409245,14892,-0.0586501688557511,62
"9793","1112323",0.770350126155155,553,0.784731351322635,582,-0.0143812251674807,-29
"9794","2112323",0.707126953646966,1542,0.728356866681812,1577,-0.0212299130348463,-35
"9795","3112323",0.664012744833462,2694,0.699563033482033,2424,-0.0355502886485703,270
"9796","4112323",0.622538414132922,4240,0.657152658360222,4099,-0.0346142442273001,141
"9797","1212323",0.716392348562158,1339,0.729427072376929,1546,-0.0130347238147708,-207
"9798","2212323",0.65316917605397,3069,0.673052587736106,3395,-0.0198834116821364,-326
"9799","3212323",0.610054967240466,4797,0.644258754536326,4686,-0.0342037872958604,111
"9800","4212323",0.568580636539926,6759,0.601848379414516,6941,-0.0332677428745899,-182
"9801","1312323",0.688412878285382,1987,0.702376505043631,2346,-0.013963626758249,-359
"9802","2312323",0.625189705777193,4120,0.646002020402808,4610,-0.0208123146256146,-490
"9803","3312323",0.58207549696369,6096,0.617208187203029,6099,-0.0351326902393386,-3
"9804","4312323",0.54060116626315,8203,0.574797812081218,8504,-0.0341966458180681,-301
"9805","1412323",0.649476380300386,3213,0.661747001075525,3901,-0.0122706207751392,-688
"9806","2412323",0.586253207792197,5871,0.605372516434702,6748,-0.0191193086425049,-877
"9807","3412323",0.543138998978694,8065,0.576578683234923,8396,-0.0334396842562289,-331
"9808","4412323",0.501664668278154,10188,0.534168308113112,10785,-0.0325036398349584,-597
"9809","1122323",0.702370855288735,1651,0.724162039665229,1694,-0.021791184376494,-43
"9810","2122323",0.639147682780546,3601,0.667787555024405,3620,-0.0286398722438596,-19
"9811","3122323",0.596033473967042,5422,0.638993721824626,4989,-0.0429602478575836,433
"9812","4122323",0.554559143266502,7472,0.596583346702816,7261,-0.0420242034363133,211
"9813","1222323",0.648413077695738,3252,0.668857760719522,3571,-0.020444683023784,-319
"9814","2222323",0.58518990518755,5943,0.612483276078699,6362,-0.0272933708911496,-419
"9815","3222323",0.542075696374046,8120,0.58368944287892,7967,-0.0416137465048736,153
"9816","4222323",0.500601365673506,10232,0.541279067757109,10404,-0.0406777020836031,-172
"9817","1322323",0.620433607418962,4319,0.641807193386224,4825,-0.0213735859672622,-506
"9818","2322323",0.557210434910773,7331,0.585432708745401,7863,-0.0282222738346278,-532
"9819","3322323",0.51409622609727,9560,0.556638875545622,9536,-0.0425426494483518,24
"9820","4322323",0.47262189539673,11585,0.514228500423811,11818,-0.0416066050270814,-233
"9821","1422323",0.581497109433966,6122,0.601177689418119,6988,-0.0196805799841524,-866
"9822","2422323",0.518273936925777,9329,0.544803204777295,10188,-0.0265292678515181,-859
"9823","3422323",0.475159728112274,11463,0.516009371577516,11718,-0.0408496434652421,-255
"9824","4422323",0.433685397411734,13203,0.473598996455706,13620,-0.0399135990439716,-417
"9825","1132323",0.659038333123635,2846,0.6856969472172,2900,-0.0266586140935648,-54
"9826","2132323",0.595815160615446,5433,0.629322462576376,5442,-0.0335073019609304,-9
"9827","3132323",0.552700951801943,7551,0.600528629376597,7033,-0.0478276775746544,518
"9828","4132323",0.511226621101403,9708,0.558118254254787,9439,-0.046891633153384,269
"9829","1232323",0.605080555530639,5006,0.630392668271494,5388,-0.0253121127408547,-382
"9830","2232323",0.54185738302245,8129,0.57401818363067,8547,-0.0321608006082202,-418
"9831","3232323",0.498743174208947,10325,0.545224350430891,10159,-0.0464811762219443,166
"9832","4232323",0.457268843508406,12250,0.50281397530908,12355,-0.045545131800674,-105
"9833","1332323",0.577101085253863,6334,0.603342100938196,6859,-0.0262410156843329,-525
"9834","2332323",0.513877912745674,9574,0.546967616297372,10058,-0.0330897035516985,-484
"9835","3332323",0.47076370393217,11659,0.518173783097593,11608,-0.0474100791654225,51
"9836","4332323",0.42928937323163,13366,0.475763407975782,13520,-0.0464740347441522,-154
"9837","1432323",0.538164587268867,8323,0.56271259697009,9180,-0.0245480097012231,-857
"9838","2432323",0.474941414760678,11476,0.506338112329267,12191,-0.0313966975685888,-715
"9839","3432323",0.431827205947174,13277,0.477544279129487,13444,-0.0457170731823127,-167
"9840","4432323",0.390352875246634,14583,0.435133904007677,14840,-0.0447810287610426,-257
"9841","1142323",0.610004768668805,4799,0.645298453090116,4636,-0.0352936844213102,163
"9842","2142323",0.546781596160617,7860,0.588923968449292,7663,-0.0421423722886758,197
"9843","3142323",0.503667387347113,10080,0.560130135249513,9324,-0.0564627479023998,756
"9844","4142323",0.462193056646573,12039,0.517719760127703,11630,-0.0555267034811295,409
"9845","1242323",0.556046991075809,7399,0.58999417414441,7600,-0.0339471830686002,-201
"9846","2242323",0.49282381856762,10607,0.533619689503586,10817,-0.0407958709359658,-210
"9847","3242323",0.449709609754117,12560,0.504825856303807,12253,-0.0551162465496898,307
"9848","4242323",0.408235279053577,14052,0.462415481181996,14001,-0.0541802021284194,51
"9849","1342323",0.528067520799033,8846,0.562943606811112,9166,-0.0348760860120785,-320
"9850","2342323",0.464844348290844,11918,0.506569122170288,12182,-0.0417247738794441,-264
"9851","3342323",0.421730139477341,13627,0.477775288970509,13433,-0.0560451494931681,194
"9852","4342323",0.380255808776801,14832,0.435364913848698,14835,-0.0551091050718976,-3
"9853","1442323",0.489131022814037,10795,0.522314102843006,11382,-0.0331830800289686,-587
"9854","2442323",0.425907850305848,13479,0.465939618202182,13889,-0.0400317678963344,-410
"9855","3442323",0.382793641492345,14767,0.437145785002403,14780,-0.0543521435100584,-13
"9856","4442323",0.341319310791805,15575,0.394735409880593,15662,-0.0534160990887879,-87
"9857","1113323",0.731466950582669,1072,0.759234760933396,944,-0.0277678103507274,128
"9858","2113323",0.66824377807448,2567,0.702860276292573,2324,-0.034616498218093,243
"9859","3113323",0.625129569260977,4123,0.674066443092794,3346,-0.048936873831817,777
"9860","4113323",0.583655238560437,6018,0.631656067970983,5335,-0.0480008294105465,683
"9861","1213323",0.677509172989673,2304,0.70393048198769,2279,-0.0264213089980172,25
"9862","2213323",0.614286000481484,4594,0.647555997346867,4530,-0.0332699968653828,64
"9863","3213323",0.571171791667981,6631,0.618762164147087,6005,-0.0475903724791068,626
"9864","4213323",0.52969746096744,8745,0.576351789025277,8405,-0.0466543280578365,340
"9865","1313323",0.649529702712897,3211,0.676879914654392,3256,-0.0273502119414955,-45
"9866","2313323",0.586306530204708,5867,0.620505430013569,5915,-0.034198899808861,-48
"9867","3313323",0.543192321391204,8063,0.59171159681379,7514,-0.048519275422585,549
"9868","4313323",0.501717990690664,10185,0.549301221691979,9932,-0.0475832310013148,253
"9869","1413323",0.610593204727901,4768,0.636250410686286,5114,-0.0256572059583856,-346
"9870","2413323",0.547370032219712,7822,0.579875926045463,8206,-0.0325058938257513,-384
"9871","3413323",0.504255823406208,10048,0.551082092845684,9843,-0.0468262694394753,205
"9872","4413323",0.462781492705668,12008,0.508671717723873,12082,-0.0458902250182051,-74
"9873","1123323",0.663487679716249,2720,0.69866544927599,2457,-0.0351777695597406,263
"9874","2123323",0.60026450720806,5216,0.642290964635166,4800,-0.0420264574271062,416
"9875","3123323",0.557150298394557,7337,0.613497131435387,6298,-0.0563468330408302,1039
"9876","4123323",0.515675967694017,9486,0.571086756313577,8724,-0.0554107886195597,762
"9877","1223323",0.609529902123253,4822,0.643361170330283,4743,-0.0338312682070304,79
"9878","2223323",0.546306729615064,7883,0.58698668568946,7778,-0.040679956074396,105
"9879","3223323",0.503192520801561,10108,0.558192852489681,9434,-0.05500033168812,674
"9880","4223323",0.461718190101021,12057,0.51578247736787,11730,-0.0540642872668498,327
"9881","1323323",0.581550431846477,6117,0.616310602996985,6153,-0.0347601711505087,-36
"9882","2323323",0.518327259338288,9322,0.559936118356162,9338,-0.0416088590178743,-16
"9883","3323323",0.475213050524784,11459,0.531142285156383,10934,-0.0559292346315983,525
"9884","4323323",0.433738719824244,13198,0.488731910034572,12989,-0.0549931902103279,209
"9885","1423323",0.542613933861481,8088,0.57568109902888,8453,-0.0330671651673988,-365
"9886","2423323",0.479390761353292,11245,0.519306614388056,11541,-0.0399158530347645,-296
"9887","3423323",0.436276552539788,13088,0.490512781188277,12909,-0.0542362286484885,179
"9888","4423323",0.394802221839248,14455,0.448102406066467,14477,-0.0533001842272183,-22
"9889","1133323",0.62015515755115,4331,0.660200356827961,3962,-0.0400451992768113,369
"9890","2133323",0.556931985042961,7347,0.603825872187137,6832,-0.0468938871441769,515
"9891","3133323",0.513817776229457,9576,0.575032038987358,8487,-0.0612142627579009,1089
"9892","4133323",0.472343445528917,11599,0.532621663865548,10868,-0.0602782183366306,731
"9893","1233323",0.566197379958153,6883,0.604896077882255,6781,-0.0386986979241013,102
"9894","2233323",0.502974207449964,10119,0.548521593241431,9980,-0.0455473857914669,139
"9895","3233323",0.459859998636461,12147,0.519727760041652,11513,-0.0598677614051909,634
"9896","4233323",0.418385667935921,13740,0.477317384919841,13458,-0.0589317169839205,282
"9897","1333323",0.538217909681377,8318,0.577845510548957,8333,-0.0396276008675795,-15
"9898","2333323",0.474994737173188,11471,0.521471025908133,11424,-0.0464762887349451,47
"9899","3333323",0.431880528359685,13274,0.492677192708354,12816,-0.0607966643486691,458
"9900","4333323",0.390406197659145,14579,0.450266817586543,14410,-0.0598606199273987,169
"9901","1433323",0.499281411696381,10302,0.537216006580851,10626,-0.0379345948844697,-324
"9902","2433323",0.436058239188192,13098,0.480841521940028,13307,-0.0447832827518354,-209
"9903","3433323",0.392944030374689,14508,0.452047688740248,14344,-0.0591036583655595,164
"9904","4433323",0.351469699674149,15415,0.409637313618438,15413,-0.058167613944289,2
"9905","1143323",0.57112159309632,6634,0.619801862700877,5952,-0.0486802696045568,682
"9906","2143323",0.507898420588131,9862,0.563427378060053,9136,-0.0555289574719224,726
"9907","3143323",0.464784211774627,11920,0.534633544860274,10758,-0.0698493330856464,1162
"9908","4143323",0.423309881074088,13570,0.492223169738464,12843,-0.068913288664376,727
"9909","1243323",0.517163815503324,9405,0.56449758375517,9074,-0.0473337682518467,331
"9910","2243323",0.453940642995135,12391,0.508123099114347,12106,-0.0541824561192122,285
"9911","3243323",0.410826434181631,13972,0.479329265914568,13362,-0.0685028317329363,610
"9912","4243323",0.369352103481091,15063,0.436918890792757,14792,-0.067566787311666,271
"9913","1343323",0.489184345226548,10791,0.537447016421873,10614,-0.0482626711953249,177
"9914","2343323",0.425961172718359,13476,0.481072531781049,13293,-0.0551113590626905,183
"9915","3343323",0.382846963904855,14766,0.45227869858127,14336,-0.0694317346764146,430
"9916","4343323",0.341372633204315,15572,0.409868323459459,15406,-0.0684956902551443,166
"9917","1443323",0.450247847241552,12536,0.496817512453767,12629,-0.046569665212215,-93
"9918","2443323",0.387024674733363,14656,0.440443027812943,14701,-0.0534183530795808,-45
"9919","3443323",0.343910465919859,15531,0.411649194613164,15369,-0.0677387286933048,162
"9920","4443323",0.302436135219319,16015,0.369238819491354,15977,-0.0668026842720346,38
"9921","1114323",0.679259878612099,2251,0.71458414755974,1946,-0.0353242689476414,305
"9922","2114323",0.61603670610391,4498,0.658209662918917,4043,-0.042172956815007,455
"9923","3114323",0.572922497290407,6538,0.629415829719138,5438,-0.056493332428731,1100
"9924","4114323",0.531448166589867,8655,0.587005454597327,7775,-0.0555572880074605,880
"9925","1214323",0.625302101019103,4114,0.659279868614034,3998,-0.0339777675949312,116
"9926","2214323",0.562078928510914,7060,0.602905383973211,6884,-0.0408264554622968,176
"9927","3214323",0.518964719697411,9287,0.574111550773432,8542,-0.0551468310760208,745
"9928","4214323",0.477490388996871,11344,0.531701175651621,10905,-0.0542107866547505,439
"9929","1314323",0.597322630742327,5361,0.632229301280736,5304,-0.0349066705384095,57
"9930","2314323",0.534099458234138,8506,0.575854816639913,8434,-0.041755358405775,72
"9931","3314323",0.490985249420635,10691,0.547060983440134,10052,-0.0560757340194991,639
"9932","4314323",0.449510918720095,12570,0.504650608318323,12263,-0.0551396895982288,307
"9933","1414323",0.558386132757331,7259,0.591599797312631,7523,-0.0332136645552996,-264
"9934","2414323",0.495162960249142,10487,0.535225312671807,10727,-0.0400623524226653,-240
"9935","3414323",0.452048751435639,12459,0.506431479472028,12187,-0.0543827280363893,272
"9936","4414323",0.410574420735098,13978,0.464021104350218,13945,-0.0534466836151191,33
"9937","1124323",0.611280607745679,4745,0.654014835902334,4234,-0.0427342281566546,511
"9938","2124323",0.54805743523749,7788,0.59764035126151,7198,-0.0495829160240202,590
"9939","3124323",0.504943226423987,10011,0.568846518061731,8841,-0.0639032916377442,1170
"9940","4124323",0.463468895723447,11979,0.526436142939921,11175,-0.0629672472164737,804
"9941","1224323",0.557322830152683,7320,0.598710556956628,7131,-0.0413877268039444,189
"9942","2224323",0.494099657644494,10539,0.542336072315804,10332,-0.04823641467131,207
"9943","3224323",0.450985448830991,12509,0.513542239116025,11855,-0.062556790285034,654
"9944","4224323",0.409511118130451,14015,0.471131863994214,13718,-0.0616207458637638,297
"9945","1324323",0.529343359875907,8775,0.57165998962333,8681,-0.0423166297474227,94
"9946","2324323",0.466120187367718,11855,0.515285504982506,11759,-0.0491653176147883,96
"9947","3324323",0.423005978554215,13582,0.486491671782727,13075,-0.0634856932285123,507
"9948","4324323",0.381531647853674,14792,0.444081296660917,14601,-0.0625496488072421,191
"9949","1424323",0.490406861890911,10721,0.531030485655224,10939,-0.0406236237643128,-218
"9950","2424323",0.427183689382722,13427,0.474656001014401,13568,-0.0474723116316785,-141
"9951","3424323",0.384069480569219,14729,0.445862167814621,14546,-0.0617926872454026,183
"9952","4424323",0.342595149868679,15552,0.403451792692811,15531,-0.0608566428241322,21
"9953","1134323",0.56794808558058,6801,0.615549743454305,6188,-0.0476016578737253,613
"9954","2134323",0.504724913072391,10018,0.559175258813482,9386,-0.0544503457410909,632
"9955","3134323",0.461610704258887,12062,0.530381425613702,10983,-0.0687707213548149,1079
"9956","4134323",0.420136373558347,13686,0.487971050491892,13022,-0.0678346769335447,664
"9957","1234323",0.513990307987583,9569,0.560245464508599,9313,-0.0462551565210153,256
"9958","2234323",0.450767135479395,12514,0.503870979867775,12305,-0.0531038443883809,209
"9959","3234323",0.407652926665891,14079,0.475077146667996,13548,-0.067424220002105,531
"9960","4234323",0.366178595965351,15144,0.432666771546186,14907,-0.0664881755808345,237
"9961","1334323",0.486010837710807,10954,0.533194897175301,10836,-0.0471840594644936,118
"9962","2334323",0.422787665202618,13587,0.476820412534477,13478,-0.0540327473318592,109
"9963","3334323",0.379673456389115,14849,0.448026579334698,14482,-0.0683531229455832,367
"9964","4334323",0.338199125688575,15626,0.405616204212888,15492,-0.0674170785243127,134
"9965","1434323",0.447074339725811,12678,0.492565393207195,12823,-0.0454910534813837,-145
"9966","2434323",0.383851167217622,14736,0.436190908566372,14815,-0.0523397413487495,-79
"9967","3434323",0.340736958404119,15584,0.407397075366592,15455,-0.0666601169624734,129
"9968","4434323",0.299262627703579,16047,0.364986700244782,16019,-0.0657240725412031,28
"9969","1144323",0.51891452112575,9291,0.575151249327221,8480,-0.0562367282014709,811
"9970","2144323",0.455691348617561,12317,0.518776764686398,11568,-0.0630854160688364,749
"9971","3144323",0.412577139804058,13922,0.489982931486618,12934,-0.0774057916825605,988
"9972","4144323",0.371102809103518,15027,0.447572556364808,14497,-0.07646974726129,530
"9973","1244323",0.464956743532754,11909,0.519846970381515,11506,-0.0548902268487607,403
"9974","2244323",0.401733571024565,14259,0.463472485740691,13961,-0.0617389147161263,298
"9975","3244323",0.358619362211061,15281,0.434678652540912,14851,-0.0760592903298503,430
"9976","4244323",0.317145031510522,15871,0.392268277419101,15695,-0.0751232459085799,176
"9977","1344323",0.436977273255978,13063,0.492796403048217,12811,-0.0558191297922389,252
"9978","2344323",0.373754100747789,14970,0.436421918407393,14804,-0.0626678176596046,166
"9979","3344323",0.330639891934285,15723,0.407628085207614,15451,-0.0769881932733286,272
"9980","4344323",0.289165561233745,16106,0.365217710085804,16016,-0.0760521488520583,90
"9981","1444323",0.398040775270982,14355,0.452166899080111,14339,-0.0541261238091291,16
"9982","2444323",0.334817602762793,15671,0.395792414439288,15645,-0.0609748116764948,26
"9983","3444323",0.291703393949289,16092,0.366998581239508,16000,-0.075295187290219,92
"9984","4444323",0.250229063248749,16284,0.324588206117698,16260,-0.0743591428689486,24
"9985","1111423",0.773643020904696,514,0.788925193014172,533,-0.0152821721094761,-19
"9986","2111423",0.710419848396507,1463,0.732550708373349,1479,-0.0221308599768417,-16
"9987","3111423",0.667305639583004,2593,0.70375687517357,2284,-0.0364512355905657,309
"9988","4111423",0.625831308882464,4081,0.661346500051759,3918,-0.0355151911692955,163
"9989","1211423",0.7196852433117,1278,0.733620914068466,1447,-0.0139356707567662,-169
"9990","2211423",0.656462070803511,2940,0.677246429427643,3239,-0.0207843586241317,-299
"9991","3211423",0.613347861990007,4648,0.648452596227863,4474,-0.0351047342378558,174
"9992","4211423",0.571873531289468,6594,0.606042221106053,6697,-0.0341686898165853,-103
"9993","1311423",0.691705773034924,1917,0.706570346735168,2204,-0.0148645737002444,-287
"9994","2311423",0.628482600526735,3984,0.650195862094345,4413,-0.02171326156761,-429
"9995","3311423",0.585368391713231,5935,0.621402028894565,5863,-0.036033637181334,72
"9996","4311423",0.543894061012691,8022,0.578991653772755,8260,-0.0350975927600635,-238
"9997","1411423",0.652769275049928,3087,0.665940842767062,3698,-0.0131715677171346,-611
"9998","2411423",0.589546102541739,5707,0.609566358126239,6519,-0.0200202555845003,-812
"9999","3411423",0.546431893728235,7878,0.58077252492646,8143,-0.0343406311982243,-265
"10000","4411423",0.504957563027695,10010,0.538362149804649,10559,-0.0334045867769538,-549
"10001","1121423",0.705663750038276,1576,0.728355881356765,1578,-0.0226921313184894,-2
"10002","2121423",0.642440577530087,3466,0.671981396715942,3439,-0.0295408191858549,27
"10003","3121423",0.599326368716584,5266,0.643187563516163,4751,-0.043861194799579,515
"10004","4121423",0.557852038016044,7284,0.600777188394352,7018,-0.0429251503783087,266
"10005","1221423",0.65170597244528,3130,0.673051602411059,3396,-0.0213456299657794,-266
"10006","2221423",0.588482799937091,5758,0.616677117770236,6129,-0.028194317833145,-371
"10007","3221423",0.545368591123587,7948,0.587883284570456,7715,-0.042514693446869,233
"10008","4221423",0.503894260423048,10070,0.545472909448646,10143,-0.0415786490255985,-73
"10009","1321423",0.623726502168504,4192,0.646001035077761,4611,-0.0222745329092576,-419
"10010","2321423",0.560503329660315,7149,0.589626550436938,7626,-0.0291232207766232,-477
"10011","3321423",0.517389120846811,9389,0.560832717237159,9276,-0.0434435963903472,113
"10012","4321423",0.475914790146271,11431,0.518422342115348,11590,-0.0425075519690767,-159
"10013","1421423",0.584790004183508,5961,0.605371531109655,6749,-0.0205815269261478,-788
"10014","2421423",0.521566831675319,9168,0.548997046468832,9950,-0.0274302147935135,-782
"10015","3421423",0.478452622861815,11301,0.520203213269053,11482,-0.0417505904072375,-181
"10016","4421423",0.436978292161275,13062,0.477792838147242,13431,-0.040814545985967,-369
"10017","1131423",0.662331227873176,2753,0.689890788908737,2746,-0.0275595610355602,7
"10018","2131423",0.599108055364987,5272,0.633516304267913,5244,-0.0344082489029258,28
"10019","3131423",0.555993846551484,7402,0.604722471068134,6789,-0.0487286245166498,613
"10020","4131423",0.514519515850944,9533,0.562312095946323,9203,-0.0477925800953793,330
"10021","1231423",0.60837345028018,4878,0.63458650996303,5203,-0.02621305968285,-325
"10022","2231423",0.545150277771991,7957,0.578212025322207,8306,-0.0330617475502156,-349
"10023","3231423",0.502036068958488,10166,0.549418192122428,9923,-0.0473821231639396,243
"10024","4231423",0.460561738257948,12116,0.507007817000617,12163,-0.0464460787426694,-47
"10025","1331423",0.580393980003404,6183,0.607535942629732,6629,-0.0271419626263283,-446
"10026","2331423",0.517170807495215,9403,0.551161457988909,9837,-0.0339906504936939,-434
"10027","3331423",0.474056598681712,11523,0.52236762478913,11379,-0.0483110261074179,144
"10028","4331423",0.432582267981172,13244,0.479957249667319,13339,-0.0473749816861476,-95
"10029","1431423",0.541457482018408,8147,0.566906438661627,8947,-0.0254489566432184,-800
"10030","2431423",0.478234309510219,11308,0.510531954020803,12009,-0.0322976445105841,-701
"10031","3431423",0.435120100696716,13142,0.481738120821024,13264,-0.0466180201243081,-122
"10032","4431423",0.393645769996176,14485,0.439327745699214,14726,-0.0456819757030378,-241
"10033","1141423",0.613297663418347,4649,0.649492294781652,4435,-0.0361946313633056,214
"10034","2141423",0.550074490910158,7701,0.593117810140829,7445,-0.0430433192306712,256
"10035","3141423",0.506960282096655,9904,0.56432397694105,9084,-0.0573636948443952,820
"10036","4141423",0.465485951396114,11876,0.521913601819239,11403,-0.0564276504231249,473
"10037","1241423",0.559339885825351,7206,0.594188015835946,7395,-0.0348481300105956,-189
"10038","2241423",0.496116713317162,10450,0.537813531195123,10590,-0.0416968178779612,-140
"10039","3241423",0.453002504503658,12430,0.509019697995344,12063,-0.0560171934916852,367
"10040","4241423",0.411528173803118,13952,0.466609322873533,13863,-0.0550811490704148,89
"10041","1341423",0.531360415548574,8663,0.567137448502648,8934,-0.0357770329540739,-271
"10042","2341423",0.468137243040386,11773,0.510762963861825,11996,-0.0426257208214395,-223
"10043","3341423",0.425023034226882,13512,0.481969130662046,13254,-0.0569460964351634,258
"10044","4341423",0.383548703526342,14744,0.439558755540235,14722,-0.056010052013893,22
"10045","1441423",0.492423917563579,10625,0.526507944534543,11169,-0.034084026970964,-544
"10046","2441423",0.42920074505539,13371,0.470133459893719,13759,-0.0409327148383297,-388
"10047","3441423",0.386086536241886,14677,0.44133962669394,14676,-0.0552530904520537,1
"10048","4441423",0.344612205541346,15519,0.39892925157213,15599,-0.0543170460307832,-80
"10049","1112423",0.740558109143007,917,0.75060621148552,1092,-0.010048102342513,-175
"10050","2112423",0.677334936634818,2308,0.694231726844697,2603,-0.0168967902098786,-295
"10051","3112423",0.634220727821315,3774,0.665437893644917,3724,-0.0312171658236026,50
"10052","4112423",0.592746397120775,5557,0.623027518523107,5783,-0.0302811214023323,-226
"10053","1212423",0.686600331550011,2037,0.695301932539814,2570,-0.00870160098980299,-533
"10054","2212423",0.623377159041822,4208,0.638927447898991,4993,-0.0155502888571686,-785
"10055","3212423",0.580262950228319,6194,0.610133614699211,6475,-0.0298706644708926,-281
"10056","4212423",0.538788619527779,8291,0.567723239577401,8901,-0.0289346200496221,-610
"10057","1312423",0.658620861273235,2866,0.668251365206516,3611,-0.00963050393328124,-745
"10058","2312423",0.595397688765046,5455,0.611876880565693,6404,-0.0164791918006468,-949
"10059","3312423",0.552283479951542,7583,0.583083047365913,8012,-0.0307995674143708,-429
"10060","4312423",0.510809149251003,9730,0.540672672244103,10442,-0.0298635229931004,-712
"10061","1412423",0.619684363288239,4350,0.62762186123841,5533,-0.0079374979501714,-1183
"10062","2412423",0.55646119078005,7374,0.571247376597587,8711,-0.0147861858175371,-1337
"10063","3412423",0.513346981966546,9606,0.542453543397807,10322,-0.0291065614312611,-716
"10064","4412423",0.471872651266007,11624,0.500043168275997,12499,-0.0281705170099906,-875
"10065","1122423",0.672578838276587,2429,0.690036899828113,2740,-0.0174580615515262,-311
"10066","2122423",0.609355665768398,4833,0.63366241518729,5238,-0.0243067494188918,-405
"10067","3122423",0.566241456954895,6881,0.604868581987511,6782,-0.0386271250326158,99
"10068","4122423",0.524767126254355,9010,0.5624582068657,9198,-0.0376910806113455,-188
"10069","1222423",0.618621060683591,4397,0.634732620882407,5198,-0.0161115601988162,-801
"10070","2222423",0.555397888175402,7434,0.578358136241584,8298,-0.0229602480661818,-864
"10071","3222423",0.512283679361899,9660,0.549564303041804,9917,-0.0372806236799058,-257
"10072","4222423",0.470809348661359,11658,0.507153927919994,12157,-0.0363445792586353,-499
"10073","1322423",0.590641590406815,5652,0.607682053549109,6623,-0.0170404631422945,-971
"10074","2322423",0.527418417898626,8875,0.551307568908286,9830,-0.02388915100966,-955
"10075","3322423",0.484304209085122,11026,0.522513735708506,11374,-0.0382095266233841,-348
"10076","4322423",0.442829878384583,12836,0.480103360586696,13334,-0.0372734822021135,-498
"10077","1422423",0.551705092421819,7614,0.567052549581003,8939,-0.0153474571591846,-1325
"10078","2422423",0.48848191991363,10831,0.51067806494018,12002,-0.0221961450265503,-1171
"10079","3422423",0.445367711100126,12744,0.481884231740401,13257,-0.0365165206402743,-513
"10080","4422423",0.403893380399586,14199,0.43947385661859,14725,-0.0355804762190039,-526
"10081","1132423",0.629246316111487,3953,0.651571807380084,4337,-0.0223254912685971,-384
"10082","2132423",0.566023143603299,6887,0.595197322739261,7335,-0.0291741791359627,-448
"10083","3132423",0.522908934789795,9097,0.566403489539482,8971,-0.0434945547496867,126
"10084","4132423",0.481434604089255,11162,0.523993114417671,11297,-0.0425585103284162,-135
"10085","1232423",0.575288538518491,6415,0.596267528434378,7278,-0.0209789899158869,-863
"10086","2232423",0.512065366010303,9669,0.539893043793555,10479,-0.0278276777832525,-810
"10087","3232423",0.468951157196799,11743,0.511099210593775,11981,-0.0421480533969765,-238
"10088","4232423",0.427476826496259,13415,0.468688835471965,13802,-0.0412120089757061,-387
"10089","1332423",0.547309068241715,7829,0.56921696110108,8820,-0.0219078928593651,-991
"10090","2332423",0.484085895733526,11047,0.512842476460257,11884,-0.0287565807267307,-837
"10091","3332423",0.440971686920023,12908,0.484048643260478,13179,-0.0430769563404547,-271
"10092","4332423",0.399497356219483,14310,0.441638268138667,14666,-0.0421409119191844,-356
"10093","1432423",0.508372570256719,9834,0.528587457132975,11073,-0.0202148868762553,-1239
"10094","2432423",0.44514939774853,12755,0.472212972492151,13679,-0.0270635747436209,-924
"10095","3432423",0.402035188935027,14251,0.443419139292372,14622,-0.041383950357345,-371
"10096","4432423",0.360560858234487,15251,0.401008764170561,15577,-0.0404479059360746,-326
"10097","1142423",0.580212751656658,6197,0.611173313253,6430,-0.0309605615963424,-233
"10098","2142423",0.516989579148469,9411,0.554798828612177,9634,-0.037809249463708,-223
"10099","3142423",0.473875370334966,11533,0.526004995412398,11202,-0.052129625077432,331
"10100","4142423",0.432401039634426,13251,0.483594620290587,13200,-0.0511935806561617,51
"10101","1242423",0.526254974063662,8948,0.555869034307294,9586,-0.0296140602436324,-638
"10102","2242423",0.463031801555473,12001,0.499494549666471,12523,-0.036462748110998,-522
"10103","3242423",0.419917592741969,13700,0.470700716466691,13735,-0.050783123724722,-35
"10104","4242423",0.378443262041429,14875,0.428290341344881,15019,-0.0498470793034516,-144
"10105","1342423",0.498275503786886,10351,0.528818466973996,11063,-0.0305429631871107,-712
"10106","2342423",0.435052331278697,13147,0.472443982333173,13671,-0.0373916510544762,-524
"10107","3342423",0.391938122465193,14544,0.443650149133393,14615,-0.0517120266682002,-71
"10108","4342423",0.350463791764653,15433,0.401239774011583,15576,-0.0507759822469298,-143
"10109","1442423",0.45933900580189,12174,0.48818896300589,13014,-0.0288499572040008,-840
"10110","2442423",0.396115833293701,14416,0.431814478365067,14935,-0.0356986450713665,-519
"10111","3442423",0.353001624480197,15392,0.403020645165288,15542,-0.0500190206850904,-150
"10112","4442423",0.311527293779657,15943,0.360610270043477,16062,-0.04908297626382,-119
"10113","1113423",0.701674933570521,1663,0.725109621096281,1675,-0.0234346875257596,-12
"10114","2113423",0.638451761062333,3622,0.668735136455458,3580,-0.0302833753931252,42
"10115","3113423",0.595337552248829,5461,0.639941303255678,4923,-0.0446037510068492,538
"10116","4113423",0.553863221548289,7506,0.597530928133868,7211,-0.0436677065855787,295
"10117","1213423",0.647717155977525,3275,0.669805342150575,3520,-0.0220881861730494,-245
"10118","2213423",0.584493983469337,5976,0.613430857509752,6300,-0.028936874040415,-324
"10119","3213423",0.541379774655833,8157,0.584637024309972,7910,-0.043257249654139,247
"10120","4213423",0.499905443955293,10273,0.542226649188162,10339,-0.0423212052328688,-66
"10121","1313423",0.619737685700749,4347,0.642754774817277,4778,-0.0230170891165277,-431
"10122","2313423",0.55651451319256,7369,0.586380290176454,7813,-0.0298657769838933,-444
"10123","3313423",0.513400304379057,9602,0.557586456976674,9473,-0.0441861525976173,129
"10124","4313423",0.471925973678517,11622,0.515176081854864,11768,-0.043250108176347,-146
"10125","1413423",0.580801187715753,6161,0.602125270849171,6927,-0.0213240831334178,-766
"10126","2413423",0.517578015207564,9374,0.545750786208348,10125,-0.0281727710007835,-751
"10127","3413423",0.474463806394061,11503,0.516956953008568,11667,-0.0424931466145075,-164
"10128","4413423",0.432989475693521,13235,0.474546577886758,13574,-0.0415571021932372,-339
"10129","1123423",0.633695662704101,3789,0.664540309438874,3777,-0.0308446467347728,12
"10130","2123423",0.570472490195913,6664,0.608165824798051,6602,-0.0376933346021384,62
"10131","3123423",0.527358281382409,8885,0.579371991598272,8233,-0.0520137102158624,652
"10132","4123423",0.485883950681869,10963,0.536961616476461,10641,-0.0510776657945919,322
"10133","1223423",0.579737885111105,6217,0.609236030493168,6539,-0.0294981453820626,-322
"10134","2223423",0.516514712602917,9436,0.552861545852345,9757,-0.0363468332494282,-321
"10135","3223423",0.473400503789413,11551,0.524067712652565,11292,-0.0506672088631522,259
"10136","4223423",0.431926173088873,13270,0.481657337530755,13268,-0.0497311644418819,2
"10137","1323423",0.551758414834329,7611,0.58218546315987,8073,-0.0304270483255409,-462
"10138","2323423",0.48853524232614,10825,0.525810978519047,11210,-0.0372757361929065,-385
"10139","3323423",0.445421033512637,12737,0.497017145319267,12619,-0.0515961118066304,118
"10140","4323423",0.403946702812097,14196,0.454606770197457,14263,-0.0506600673853603,-67
"10141","1423423",0.512821916849333,9635,0.541555959191764,10389,-0.028734042342431,-754
"10142","2423423",0.449598744341144,12566,0.485181474550941,13132,-0.0355827302097967,-566
"10143","3423423",0.406484535527641,14119,0.456387641351162,14195,-0.0499031058235208,-76
"10144","4423423",0.365010204827101,15168,0.413977266229351,15325,-0.0489670614022504,-157
"10145","1133423",0.590363140539002,5677,0.626075216990845,5613,-0.0357120764518435,64
"10146","2133423",0.527139968030813,8895,0.569700732350022,8790,-0.0425607643192091,105
"10147","3133423",0.48402575921731,11053,0.540906899150243,10428,-0.0568811399329331,625
"10148","4133423",0.44255142851677,12850,0.498496524028432,12566,-0.0559450955116628,284
"10149","1233423",0.536405362946006,8404,0.570770938045139,8740,-0.0343655750991335,-336
"10150","2233423",0.473182190437817,11559,0.514396453404316,11812,-0.0412142629664991,-253
"10151","3233423",0.430067981624313,13342,0.485602620204536,13117,-0.0555346385802231,225
"10152","4233423",0.388593650923773,14619,0.443192245082726,14631,-0.0545985941589527,-12
"10153","1333423",0.50842589266923,9831,0.543720370711841,10253,-0.0352944780426118,-422
"10154","2333423",0.445202720161041,12750,0.487345886071018,13039,-0.0421431659099773,-289
"10155","3333423",0.402088511347537,14248,0.458552052871239,14133,-0.0564635415237014,115
"10156","4333423",0.360614180646997,15248,0.416141677749428,15277,-0.0555274971024308,-29
"10157","1433423",0.469489394684234,11720,0.503090866743735,12344,-0.0336014720595019,-624
"10158","2433423",0.406266222176045,14125,0.446716382102912,14523,-0.0404501599268677,-398
"10159","3433423",0.363152013362541,15204,0.417922548903133,15239,-0.0547705355405916,-35
"10160","4433423",0.321677682662001,15828,0.375512173781322,15917,-0.053834491119321,-89
"10161","1143423",0.541329576084172,8161,0.585676722863761,7853,-0.0443471467795891,308
"10162","2143423",0.478106403575983,11315,0.529302238222938,11038,-0.0511958346469547,277
"10163","3143423",0.43499219476248,13151,0.500508405023159,12469,-0.0655162102606787,682
"10164","4143423",0.39351786406194,14490,0.458098029901348,14150,-0.0645801658394082,340
"10165","1243423",0.487371798491176,10891,0.530372443918055,10984,-0.0430006454268789,-93
"10166","2243423",0.424148625982987,13543,0.473997959277232,13600,-0.0498493332942445,-57
"10167","3243423",0.381034417169484,14812,0.445204126077452,14567,-0.0641697089079685,245
"10168","4243423",0.339560086468944,15608,0.402793750955642,15550,-0.0632336644866981,58
"10169","1343423",0.4593923282144,12171,0.503321876584757,12332,-0.0439295483703571,-161
"10170","2343423",0.396169155706211,14413,0.446947391943934,14517,-0.0507782362377228,-104
"10171","3343423",0.353054946892708,15390,0.418153558744154,15233,-0.0650986118514467,157
"10172","4343423",0.311580616192168,15941,0.375743183622344,15915,-0.0641625674301763,26
"10173","1443423",0.420455830229404,13676,0.462692372616651,13990,-0.0422365423872473,-314
"10174","2443423",0.357232657721215,15309,0.406317887975828,15478,-0.0490852302546129,-169
"10175","3443423",0.314118448907712,15914,0.377524054776049,15892,-0.0634056058683369,22
"10176","4443423",0.272644118207172,16208,0.335113679654238,16222,-0.0624695614470666,-14
"10177","1114423",0.649467861599952,3214,0.680459007722625,3116,-0.0309911461226736,98
"10178","2114423",0.586244689091763,5872,0.624084523081802,5718,-0.0378398339900392,154
"10179","3114423",0.543130480278259,8066,0.595290689882022,7330,-0.0521602096037632,736
"10180","4114423",0.501656149577719,10189,0.552880314760212,9753,-0.0512241651824927,436
"10181","1214423",0.595510084006956,5446,0.625154728776919,5660,-0.0296446447699634,-214
"10182","2214423",0.532286911498767,8605,0.568780244136096,8846,-0.036493332637329,-241
"10183","3214423",0.489172702685263,10792,0.539986410936316,10476,-0.050813708251053,316
"10184","4214423",0.447698371984723,12648,0.497576035814506,12598,-0.0498776638297827,50
"10185","1314423",0.567530613730179,6819,0.598104161443621,7176,-0.0305735477134417,-357
"10186","2314423",0.504307441221991,10043,0.541729676802798,10373,-0.0374222355808073,-330
"10187","3314423",0.461193232408487,12089,0.512935843603018,11881,-0.0517426111945313,208
"10188","4314423",0.419718901707947,13706,0.470525468481208,13743,-0.050806566773261,-37
"10189","1414423",0.528594115745183,8807,0.557474657475515,9480,-0.0288805417303318,-673
"10190","2414423",0.465370943236995,11882,0.501100172834692,12439,-0.0357292295976975,-557
"10191","3414423",0.422256734423491,13603,0.472306339634913,13675,-0.0500496052114216,-72
"10192","4414423",0.380782403722951,14816,0.429895964513102,14981,-0.0491135607901512,-165
"10193","1124423",0.581488590733532,6123,0.619889696065218,5944,-0.0384011053316868,179
"10194","2124423",0.518265418225343,9331,0.563515211424395,9130,-0.0452497931990524,201
"10195","3124423",0.475151209411839,11464,0.534721378224616,10752,-0.0595701688127764,712
"10196","4124423",0.433676878711299,13204,0.492311003102805,12837,-0.0586341243915059,367
"10197","1224423",0.527530813140536,8866,0.564585417119512,9069,-0.0370546039789766,-203
"10198","2224423",0.464307640632347,11939,0.508210932478689,12104,-0.0439032918463422,-165
"10199","3224423",0.421193431818843,13645,0.479417099278909,13359,-0.0582236674600663,286
"10200","4224423",0.379719101118303,14848,0.437006724157099,14788,-0.0572876230387959,60
"10201","1324423",0.499551342863759,10287,0.537534849786214,10610,-0.0379835069224549,-323
"10202","2324423",0.436328170355571,13084,0.481160365145391,13287,-0.0448321947898204,-203
"10203","3324423",0.393213961542067,14497,0.452366531945612,14334,-0.0591525704035445,163
"10204","4324423",0.351739630841527,15411,0.409956156823801,15403,-0.0582165259822741,8
"10205","1424423",0.460614844878763,12114,0.496905345818108,12625,-0.036290500939345,-511
"10206","2424423",0.397391672370574,14371,0.440530861177285,14698,-0.0431391888067108,-327
"10207","3424423",0.354277463557071,15358,0.411737027977506,15367,-0.0574595644204347,-9
"10208","4424423",0.312803132856531,15926,0.369326652855695,15975,-0.0565235199991643,-49
"10209","1134423",0.538156068568432,8324,0.58142460361719,8110,-0.0432685350487575,214
"10210","2134423",0.474932896060243,11477,0.525050118976366,11245,-0.0501172229161231,232
"10211","3134423",0.43181868724674,13278,0.496256285776587,12659,-0.064437598529847,619
"10212","4134423",0.3903443565462,14584,0.453845910654776,14292,-0.0635015541085768,292
"10213","1234423",0.484198290975436,11038,0.526120324671483,11195,-0.0419220336960475,-157
"10214","2234423",0.420975118467247,13650,0.46974584003066,13772,-0.0487707215634131,-122
"10215","3234423",0.377860909653744,14889,0.440952006830881,14687,-0.0630910971771371,202
"10216","4234423",0.336386578953204,15648,0.39854163170907,15607,-0.0621550527558666,41
"10217","1334423",0.45621882069866,12295,0.499069757338185,12547,-0.0428509366395257,-252
"10218","2334423",0.392995648190471,14504,0.442695272697362,14642,-0.0496996245068913,-138
"10219","3334423",0.349881439376967,15440,0.413901439497583,15327,-0.0640200001206152,113
"10220","4334423",0.308407108676428,15969,0.371491064375772,15961,-0.0630839556993448,8
"10221","1434423",0.417282322713664,13780,0.45844025337008,14140,-0.0411579306564159,-360
"10222","2434423",0.354059150205475,15360,0.402065768729256,15566,-0.0480066185237815,-206
"10223","3434423",0.310944941391971,15947,0.373271935529477,15941,-0.0623269941375054,6
"10224","4434423",0.269470610691431,16222,0.330861560407667,16243,-0.0613909497162352,-21
"10225","1144423",0.489122504113602,10796,0.541026109490106,10421,-0.0519036053765031,375
"10226","2144423",0.425899331605414,13480,0.484651624849282,13153,-0.0587522932438686,327
"10227","3144423",0.38278512279191,14768,0.455857791649503,14218,-0.0730726688575926,550
"10228","4144423",0.34131079209137,15576,0.413447416527692,15339,-0.0721366244363221,237
"10229","1244423",0.435164726520606,13140,0.485721830544399,13111,-0.0505571040237928,29
"10230","2244423",0.371941554012417,15009,0.429347345903576,14994,-0.0574057918911585,15
"10231","3244423",0.328827345198914,15746,0.400553512703797,15583,-0.0717261675048824,163
"10232","4244423",0.287353014498374,16123,0.358143137581986,16072,-0.070790123083612,51
"10233","1344423",0.40718525624383,14096,0.458671263211101,14132,-0.0514860069672712,-36
"10234","2344423",0.343962083735641,15529,0.402296778570278,15560,-0.0583346948346367,-31
"10235","3344423",0.300847874922138,16033,0.373502945370499,15938,-0.0726550704483606,95
"10236","4344423",0.259373544221598,16259,0.331092570248688,16241,-0.0717190260270903,18
"10237","1444423",0.368248758258834,15095,0.418041759242996,15237,-0.0497930009841612,-142
"10238","2444423",0.305025585750645,15996,0.361667274602172,16053,-0.0566416888515269,-57
"10239","3444423",0.261911376937142,16246,0.332873441402393,16232,-0.070962064465251,14
"10240","4444423",0.220437046236602,16347,0.290463066280582,16346,-0.0700260200439806,1
"10241","1111133",0.842688025272094,120,0.865843719340001,82,-0.0231556940679067,38
"10242","2111133",0.779464852763905,458,0.809469234699178,342,-0.0300043819352723,116
"10243","3111133",0.736350643950402,989,0.780675401499398,633,-0.0443247575489963,356
"10244","4111133",0.694876313249862,1817,0.738265026377588,1345,-0.043388713127726,472
"10245","1211133",0.788730247679098,387,0.810539440394295,332,-0.0218091927151967,55
"10246","2211133",0.725507075170909,1171,0.754164955753471,1022,-0.0286578805825622,149
"10247","3211133",0.682392866357406,2158,0.725371122553692,1663,-0.0429782561962863,495
"10248","4211133",0.640918535656866,3526,0.682960747431882,3010,-0.0420422117750159,516
"10249","1311133",0.760750777402322,660,0.783488873060997,592,-0.0227380956586749,68
"10250","2311133",0.697527604894133,1755,0.727114388420174,1608,-0.0295867835260405,147
"10251","3311133",0.65441339608063,3014,0.698320555220394,2467,-0.0439071591397645,547
"10252","4311133",0.61293906538009,4660,0.655910180098584,4149,-0.0429711147184941,511
"10253","1411133",0.721814279417326,1237,0.742859369092891,1249,-0.0210450896755651,-12
"10254","2411133",0.658591106909137,2869,0.686484884452068,2872,-0.0278937775429308,-3
"10255","3411133",0.615476898095634,4527,0.657691051252288,4068,-0.0422141531566548,459
"10256","4411133",0.574002567395094,6480,0.615280676130478,6198,-0.0412781087353844,282
"10257","1121133",0.774708754405674,506,0.805274407682594,378,-0.03056565327692,128
"10258","2121133",0.711485581897485,1437,0.748899923041771,1127,-0.0374143411442855,310
"10259","3121133",0.668371373083982,2562,0.720106089841991,1804,-0.0517347167580096,758
"10260","4121133",0.626897042383442,4039,0.677695714720181,3217,-0.0507986723367392,822
"10261","1221133",0.720750976812678,1260,0.749970128736888,1101,-0.0292191519242099,159
"10262","2221133",0.657527804304489,2903,0.693595644096065,2619,-0.0360678397915755,284
"10263","3221133",0.614413595490986,4588,0.664801810896285,3760,-0.0503882154052995,828
"10264","4221133",0.572939264790446,6536,0.622391435774475,5812,-0.0494521709840291,724
"10265","1321133",0.692771506535902,1883,0.72291956140359,1727,-0.0301480548676881,156
"10266","2321133",0.629548334027713,3932,0.666545076762767,3665,-0.0369967427350537,267
"10267","3321133",0.58643412521421,5856,0.637751243562987,5051,-0.0513171183487777,805
"10268","4321133",0.54495979451367,7965,0.595340868441177,7327,-0.0503810739275073,638
"10269","1421133",0.653835008550906,3039,0.682290057435484,3032,-0.0284550488845783,7
"10270","2421133",0.590611836042717,5656,0.625915572794661,5618,-0.035303736751944,38
"10271","3421133",0.547497627229214,7810,0.597121739594882,7227,-0.049624112365668,583
"10272","4421133",0.506023296528674,9949,0.554711364473071,9638,-0.0486880679443976,311
"10273","1131133",0.731376232240575,1073,0.766809315234565,826,-0.0354330829939907,247
"10274","2131133",0.668153059732386,2569,0.710434830593742,2071,-0.0422817708613563,498
"10275","3131133",0.625038850918882,4126,0.681640997393963,3069,-0.0566021464750803,1057
"10276","4131133",0.583564520218342,6026,0.639230622272152,4968,-0.05566610205381,1058
"10277","1231133",0.677418454647578,2305,0.711505036288859,2029,-0.0340865816412806,276
"10278","2231133",0.61419528213939,4599,0.655130551648036,4182,-0.0409352695086462,417
"10279","3231133",0.571081073325886,6637,0.626336718448256,5599,-0.0552556451223702,1038
"10280","4231133",0.529606742625346,8750,0.583926343326446,7951,-0.0543196007010999,799
"10281","1331133",0.649438984370802,3216,0.684454468955561,2949,-0.0350154845847589,267
"10282","2331133",0.586215811862613,5874,0.628079984314738,5499,-0.0418641724521245,375
"10283","3331133",0.54310160304911,8068,0.599286151114958,7098,-0.0561845480658485,970
"10284","4331133",0.50162727234857,10192,0.556875775993148,9518,-0.0552485036445781,674
"10285","1431133",0.610502486385806,4770,0.643824964987455,4712,-0.033322478601649,58
"10286","2431133",0.547279313877617,7830,0.587450480346632,7745,-0.0401711664690148,85
"10287","3431133",0.504165105064114,10053,0.558656647146853,9414,-0.0544915420827388,639
"10288","4431133",0.462690774363574,12010,0.516246272025042,11703,-0.0535554976614684,307
"10289","1141133",0.682342667785745,2159,0.726410821107481,1628,-0.0440681533217362,531
"10290","2141133",0.619119495277556,4380,0.670036336466658,3508,-0.0509168411891018,872
"10291","3141133",0.576005286464053,6383,0.641242503266878,4860,-0.0652372168028258,1523
"10292","4141133",0.534530955763513,8486,0.598832128145068,7122,-0.0643011723815554,1364
"10293","1241133",0.628384890192749,3989,0.671106542161775,3467,-0.0427216519690261,522
"10294","2241133",0.56516171768456,6927,0.614732057520952,6224,-0.0495703398363917,703
"10295","3241133",0.522047508871057,9145,0.585938224321172,7839,-0.0638907154501157,1306
"10296","4241133",0.480573178170517,11196,0.543527849199362,10260,-0.0629546710288453,936
"10297","1341133",0.600405419915973,5208,0.644055974828477,4694,-0.0436505549125044,514
"10298","2341133",0.537182247407784,8361,0.587681490187654,7725,-0.0504992427798699,636
"10299","3341133",0.49406803859428,10541,0.558887656987874,9401,-0.064819618393594,1140
"10300","4341133",0.45259370789374,12436,0.516477281866064,11692,-0.0638835739723236,744
"10301","1441133",0.561468921930977,7089,0.603426470860371,6853,-0.0419575489293945,236
"10302","2441133",0.498245749422788,10352,0.547051986219548,10054,-0.0488062367967602,298
"10303","3441133",0.455131540609284,12332,0.518258153019769,11600,-0.0631266124104842,732
"10304","4441133",0.413657209908744,13880,0.475847777897958,13515,-0.0621905679892138,365
"10305","1112133",0.809603113510405,251,0.827524737811349,231,-0.0179216243009436,20
"10306","2112133",0.746379941002216,839,0.771150253170526,754,-0.0247703121683092,85
"10307","3112133",0.703265732188713,1625,0.742356419970746,1263,-0.0390906877820332,362
"10308","4112133",0.661791401488173,2763,0.699946044848936,2409,-0.0381546433607628,354
"10309","1212133",0.755645335917409,715,0.772220458865643,737,-0.0165751229482335,-22
"10310","2212133",0.69242216340922,1896,0.715845974224819,1911,-0.0234238108155991,-15
"10311","3212133",0.649307954595717,3220,0.68705214102504,2851,-0.0377441864293231,369
"10312","4212133",0.607833623895177,4898,0.64464176590323,4671,-0.0368081420080527,227
"10313","1312133",0.727665865640633,1122,0.745169891532345,1207,-0.0175040258917117,-85
"10314","2312133",0.664442693132444,2678,0.688795406891521,2783,-0.0243527137590773,-105
"10315","3312133",0.621328484318941,4277,0.660001573691742,3970,-0.0386730893728013,307
"10316","4312133",0.579854153618401,6210,0.617591198569932,6070,-0.037737044951531,140
"10317","1412133",0.688729367655637,1977,0.704540387564239,2259,-0.0158110199086019,-282
"10318","2412133",0.625506195147448,4104,0.648165902923416,4494,-0.0226597077759676,-390
"10319","3412133",0.582391986333945,6070,0.619372069723636,5975,-0.0369800833896916,95
"10320","4412133",0.540917655633405,8184,0.576961694601826,8375,-0.0360440389684212,-191
"10321","1122133",0.741623842643985,896,0.766955426153942,824,-0.0253315835099568,72
"10322","2122133",0.678400670135796,2276,0.710580941513119,2067,-0.0321802713773224,209
"10323","3122133",0.635286461322293,3732,0.681787108313339,3061,-0.0465006469910464,671
"10324","4122133",0.593812130621753,5516,0.639376733191529,4961,-0.045564602569776,555
"10325","1222133",0.687666065050989,2003,0.711651147208236,2022,-0.0239850821572467,-19
"10326","2222133",0.6244428925428,4160,0.655276662567413,4175,-0.0308337700246123,-15
"10327","3222133",0.581328683729297,6129,0.626482829367633,5593,-0.0451541456383363,536
"10328","4222133",0.539854353028757,8237,0.584072454245823,7946,-0.0442181012170659,291
"10329","1322133",0.659686594774213,2822,0.684600579874938,2943,-0.024913985100725,-121
"10330","2322133",0.596463422266024,5393,0.628226095234115,5490,-0.0317626729680905,-97
"10331","3322133",0.553349213452521,7523,0.599432262034335,7088,-0.0460830485818146,435
"10332","4322133",0.511874882751981,9677,0.557021886912525,9508,-0.0451470041605442,169
"10333","1422133",0.620750096789217,4297,0.643971075906832,4698,-0.0232209791176151,-401
"10334","2422133",0.557526924281028,7304,0.587596591266009,7732,-0.0300696669849808,-428
"10335","3422133",0.514412715467525,9539,0.55880275806623,9406,-0.0443900425987048,133
"10336","4422133",0.472938384766985,11568,0.516392382944419,11695,-0.0434539981774344,-127
"10337","1132133",0.698291320478886,1735,0.728490333705913,1573,-0.0301990132270276,162
"10338","2132133",0.635068147970697,3739,0.67211584906509,3433,-0.0370477010943931,306
"10339","3132133",0.591953939157193,5585,0.64332201586531,4745,-0.0513680767081172,840
"10340","4132133",0.550479608456653,7684,0.6009116407435,7004,-0.0504320322868468,680
"10341","1232133",0.64433354288589,3390,0.673186054760207,3389,-0.0288525118743175,1
"10342","2232133",0.581110370377701,6141,0.616811570119384,6120,-0.0357011997416831,21
"10343","3232133",0.537996161564197,8332,0.588017736919604,7711,-0.0500215753554071,621
"10344","4232133",0.496521830863657,10428,0.545607361797794,10136,-0.0490855309341367,292
"10345","1332133",0.616354072609113,4487,0.646135487426909,4602,-0.0297814148177957,-115
"10346","2332133",0.553130900100924,7534,0.589761002786086,7618,-0.0366301026851613,-84
"10347","3332133",0.510016691287421,9758,0.560967169586306,9266,-0.0509504782988853,492
"10348","4332133",0.468542360586881,11756,0.518556794464496,11583,-0.050014433877615,173
"10349","1432133",0.577417574624117,6319,0.605505983458803,6734,-0.0280884088346859,-415
"10350","2432133",0.514194402115928,9555,0.54913149881798,9944,-0.0349370967020516,-389
"10351","3432133",0.471080193302425,11648,0.520337665618201,11477,-0.0492574723157756,171
"10352","4432133",0.429605862601885,13356,0.47792729049639,13422,-0.0483214278945052,-66
"10353","1142133",0.649257756024056,3223,0.688091839578829,2809,-0.038834083554773,414
"10354","2142133",0.586034583515867,5887,0.631717354938006,5332,-0.0456827714221386,555
"10355","3142133",0.542920374702364,8071,0.602923521738226,6883,-0.0600031470358626,1188
"10356","4142133",0.501446044001824,10202,0.560513146616416,9296,-0.0590671026145922,906
"10357","1242133",0.59529997843106,5463,0.632787560633123,5280,-0.0374875822020629,183
"10358","2242133",0.532076805922871,8620,0.5764130759923,8401,-0.0443362700694285,219
"10359","3242133",0.488962597109368,10800,0.54761924279252,10027,-0.0586566456831525,773
"10360","4242133",0.447488266408828,12655,0.50520886767071,12238,-0.0577206012618822,417
"10361","1342133",0.567320508154284,6829,0.605736993299825,6719,-0.0384164851455412,110
"10362","2342133",0.504097335646095,10055,0.549362508659002,9929,-0.0452651730129068,126
"10363","3342133",0.460983126832591,12096,0.520568675459222,11465,-0.0595855486266308,631
"10364","4342133",0.419508796132051,13713,0.478158300337412,13413,-0.0586495042053604,300
"10365","1442133",0.528384010169288,8819,0.565107489331719,9033,-0.0367234791624313,-214
"10366","2442133",0.465160837661099,11898,0.508733004690896,12078,-0.043572167029797,-180
"10367","3442133",0.422046628847595,13610,0.479939171491116,13340,-0.057892542643521,270
"10368","4442133",0.380572298147056,14822,0.437528796369306,14771,-0.0569564982222506,51
"10369","1113133",0.77071993793792,545,0.80202814742211,406,-0.0313082094841902,139
"10370","2113133",0.707496765429731,1535,0.745653662781287,1194,-0.0381568973515558,341
"10371","3113133",0.664382556616227,2683,0.716859829581507,1892,-0.0524772729652798,791
"10372","4113133",0.622908225915687,4221,0.674449454459697,3333,-0.0515412285440093,888
"10373","1213133",0.716762160344924,1325,0.746723868476404,1176,-0.02996170813148,149
"10374","2213133",0.653538987836735,3055,0.69034938383558,2734,-0.0368103959988456,321
"10375","3213133",0.610424779023231,4776,0.661555550635801,3909,-0.0511307716125696,867
"10376","4213133",0.568950448322691,6738,0.61914517551399,5985,-0.0501947271912994,753
"10377","1313133",0.688782690068147,1973,0.719673301143106,1813,-0.0308906110749583,160
"10378","2313133",0.625559517559959,4098,0.663298816502282,3826,-0.0377392989423239,272
"10379","3313133",0.582445308746455,6067,0.634504983302503,5208,-0.0520596745560479,859
"10380","4313133",0.540970978045915,8178,0.592094608180693,7497,-0.0511236301347776,681
"10381","1413133",0.649846192083151,3196,0.679043797175,3171,-0.0291976050918484,25
"10382","2413133",0.586623019574963,5843,0.622669312534177,5798,-0.0360462929592141,45
"10383","3413133",0.543508810761459,8043,0.593875479334397,7413,-0.0503666685729381,630
"10384","4413133",0.502034480060919,10167,0.551465104212587,9818,-0.0494306241516679,349
"10385","1123133",0.7027406670715,1636,0.741458835764703,1281,-0.0387181686932034,355
"10386","2123133",0.639517494563311,3582,0.68508435112388,2924,-0.045566856560569,658
"10387","3123133",0.596403285749807,5400,0.6562905179241,4135,-0.059887232174293,1265
"10388","4123133",0.554928955049267,7453,0.61388014280229,6276,-0.0589511877530225,1177
"10389","1223133",0.648782889478504,3232,0.686154556818997,2886,-0.0373716673404932,346
"10390","2223133",0.585559716970315,5914,0.629780072178174,5421,-0.0442203552078588,493
"10391","3223133",0.542445508156811,8096,0.600986238978394,6999,-0.0585407308215828,1097
"10392","4223133",0.500971177456271,10216,0.558575863856584,9419,-0.0576046864003126,797
"10393","1323133",0.620803419201727,4295,0.659103989485699,4005,-0.0383005702839715,290
"10394","2323133",0.557580246693539,7295,0.602729504844876,6890,-0.0451492581513371,405
"10395","3323133",0.514466037880035,9536,0.573935671645096,8549,-0.0594696337650611,987
"10396","4323133",0.472991707179495,11565,0.531525296523286,10914,-0.0585335893437908,651
"10397","1423133",0.581866921216731,6098,0.618474485517593,6020,-0.0366075643008617,78
"10398","2423133",0.518643748708543,9301,0.56210000087677,9210,-0.0434562521682273,91
"10399","3423133",0.475529539895039,11444,0.53330616767699,10828,-0.0577766277819514,616
"10400","4423133",0.434055209194499,13183,0.49089579255518,12892,-0.056840583360681,291
"10401","1133133",0.6594081449064,2835,0.702993743316674,2316,-0.0435855984102741,519
"10402","2133133",0.596184972398211,5414,0.646619258675851,4577,-0.0504342862776397,837
"10403","3133133",0.553070763584708,7539,0.617825425476071,6055,-0.0647546618913637,1484
"10404","4133133",0.511596432884168,9689,0.575415050354261,8463,-0.0638186174700934,1226
"10405","1233133",0.605450367313404,4990,0.647689464370968,4520,-0.0422390970575641,470
"10406","2233133",0.542227194805215,8109,0.591314979730145,7538,-0.0490877849249297,571
"10407","3233133",0.499112985991711,10313,0.562521146530365,9192,-0.0634081605386537,1121
"10408","4233133",0.457638655291172,12237,0.520110771408555,11488,-0.0624721161173832,749
"10409","1333133",0.577470897036628,6316,0.62063889703767,5906,-0.0431680000010424,410
"10410","2333133",0.514247724528439,9550,0.564264412396847,9089,-0.050016687868408,461
"10411","3333133",0.471133515714935,11645,0.535470579197067,10712,-0.064337063482132,933
"10412","4333133",0.429659185014395,13353,0.493060204075257,12798,-0.0634010190608614,555
"10413","1433133",0.538534399051632,8297,0.580009393069564,8196,-0.0414749940179325,101
"10414","2433133",0.475311226543443,11451,0.523634908428741,11315,-0.0483236818852982,136
"10415","3433133",0.432197017729939,13259,0.494841075228962,12723,-0.0626440574990222,536
"10416","4433133",0.3907226870294,14570,0.452430700107151,14331,-0.0617080130777517,239
"10417","1143133",0.61037458045157,4782,0.66259524918959,3854,-0.0522206687380197,928
"10418","2143133",0.547151407943382,7843,0.606220764548767,6687,-0.0590693566053853,1156
"10419","3143133",0.504037199129878,10061,0.577426931348987,8353,-0.0733897322191093,1708
"10420","4143133",0.462562868429338,12018,0.535016556227177,10735,-0.0724536877978388,1283
"10421","1243133",0.556416802858574,7377,0.607290970243884,6636,-0.0508741673853095,741
"10422","2243133",0.493193630350386,10588,0.550916485603061,9848,-0.0577228552526751,740
"10423","3243133",0.450079421536882,12540,0.522122652403281,11395,-0.0720432308663991,1145
"10424","4243133",0.408605090836342,14039,0.479712277281471,13344,-0.0711071864451288,695
"10425","1343133",0.528437332581798,8816,0.580240402910586,8175,-0.0518030703287877,641
"10426","2343133",0.465214160073609,11893,0.523865918269763,11304,-0.0586517581961533,589
"10427","3343133",0.422099951260106,13607,0.495072085069983,12715,-0.0729721338098773,892
"10428","4343133",0.380625620559566,14820,0.452661709948173,14326,-0.072036089388607,494
"10429","1443133",0.489500834596802,10771,0.53961089894248,10492,-0.0501100643456779,279
"10430","2443133",0.426277662088613,13462,0.483236414301657,13209,-0.0569587522130435,253
"10431","3443133",0.38316345327511,14754,0.454442581101877,14271,-0.0712791278267675,483
"10432","4443133",0.34168912257457,15566,0.412032205980067,15363,-0.0703430834054972,203
"10433","1114133",0.71851286596735,1299,0.757377534048454,974,-0.0388646680811041,325
"10434","2114133",0.655289693459161,2982,0.701003049407631,2381,-0.0457133559484697,601
"10435","3114133",0.612175484645658,4699,0.672209216207851,3431,-0.0600337315621937,1268
"10436","4114133",0.570701153945118,6650,0.629798841086041,5419,-0.0590976871409233,1231
"10437","1214133",0.664555088374354,2676,0.702073255102748,2357,-0.037518166728394,319
"10438","2214133",0.601331915866165,5174,0.645698770461924,4620,-0.0443668545957596,554
"10439","3214133",0.558217707052661,7268,0.616904937262145,6112,-0.0586872302094836,1156
"10440","4214133",0.516743376352121,9426,0.574494562140335,8520,-0.0577511857882133,906
"10441","1314133",0.636575618097578,3692,0.67502268776945,3317,-0.0384470696718723,375
"10442","2314133",0.573352445589389,6517,0.618648203128627,6009,-0.0452957575392379,508
"10443","3314133",0.530238236775885,8721,0.589854369928847,7610,-0.0596161331529619,1111
"10444","4314133",0.488763906075345,10811,0.547443994807037,10034,-0.0586800887316915,777
"10445","1414133",0.597639120112582,5343,0.634393183801344,5213,-0.0367540636887624,130
"10446","2414133",0.534415947604393,8495,0.578018699160521,8318,-0.0436027515561281,177
"10447","3414133",0.491301738790889,10677,0.549224865960741,9939,-0.0579231271698522,738
"10448","4414133",0.449827408090349,12555,0.506814490838931,12171,-0.0569870827485818,384
"10449","1124133",0.65053359510093,3166,0.696808222391047,2511,-0.0462746272901173,655
"10450","2124133",0.587310422592741,5813,0.640433737750224,4895,-0.0531233151574829,918
"10451","3124133",0.544196213779238,8007,0.611639904550444,6412,-0.0674436907712069,1595
"10452","4124133",0.502721883078698,10128,0.569229529428634,8817,-0.0665076463499366,1311
"10453","1224133",0.596575817507934,5386,0.641503943445341,4847,-0.0449281259374072,539
"10454","2224133",0.533352644999745,8548,0.585129458804518,7881,-0.0517768138047728,667
"10455","3224133",0.490238436186241,10730,0.556335625604738,9555,-0.0660971894184968,1175
"10456","4224133",0.448764105485701,12604,0.513925250482928,11836,-0.0651611449972265,768
"10457","1324133",0.568596347231158,6757,0.614453376112043,6238,-0.0458570288808855,519
"10458","2324133",0.505373174722969,9982,0.55807889147122,9441,-0.0527057167482511,541
"10459","3324133",0.462258965909465,12033,0.52928505827144,11039,-0.0670260923619751,994
"10460","4324133",0.420784635208925,13657,0.48687468314963,13056,-0.0660900479407047,601
"10461","1424133",0.529659849246162,8747,0.573823872143937,8552,-0.0441640228977757,195
"10462","2424133",0.466436676737973,11837,0.517449387503114,11642,-0.0510127107651414,195
"10463","3424133",0.423322467924469,13568,0.488655554303335,12992,-0.0653330863788653,576
"10464","4424133",0.381848137223929,14782,0.446245179181524,14535,-0.0643970419575949,247
"10465","1134133",0.60720107293583,4923,0.658343129943018,4037,-0.0511420570071881,886
"10466","2134133",0.543977900427641,8019,0.601968645302195,6935,-0.0579907448745537,1084
"10467","3134133",0.500863691614138,10220,0.573174812102416,8588,-0.0723111204882777,1632
"10468","4134133",0.459389360913598,12172,0.530764436980605,10953,-0.0713750760670073,1219
"10469","1234133",0.553243295342834,7531,0.603038850997312,6878,-0.049795555654478,653
"10470","2234133",0.490020122834645,10745,0.546664366356489,10072,-0.0566442435218436,673
"10471","3234133",0.446905914021142,12685,0.517870533156709,11621,-0.0709646191355676,1064
"10472","4234133",0.405431583320602,14153,0.475460158034899,13531,-0.0700285747142972,622
"10473","1334133",0.525263825066058,8988,0.575988283664014,8425,-0.0507244585979563,563
"10474","2334133",0.462040652557869,12046,0.519613799023191,11522,-0.0575731464653219,524
"10475","3334133",0.418926443744366,13728,0.490819965823411,12898,-0.0718935220790458,830
"10476","4334133",0.377452113043826,14898,0.448409590701601,14464,-0.0709574776577754,434
"10477","1434133",0.486327327081062,10937,0.535358779695908,10721,-0.0490314526148464,216
"10478","2434133",0.423104154572873,13579,0.478984295055085,13376,-0.0558801404822121,203
"10479","3434133",0.37998994575937,14840,0.450190461855306,14415,-0.0702005160959361,425
"10480","4434133",0.33851561505883,15623,0.407780086733495,15448,-0.0692644716746657,175
"10481","1144133",0.558167508481001,7270,0.617944635815934,6052,-0.0597771273349336,1218
"10482","2144133",0.494944335972812,10501,0.561570151175111,9240,-0.0666258152022992,1261
"10483","3144133",0.451830127159308,12465,0.532776317975332,10864,-0.0809461908160232,1601
"10484","4144133",0.410355796458768,13986,0.490365942853521,12915,-0.0800101463947527,1071
"10485","1244133",0.504209730888005,10050,0.562640356870228,9184,-0.0584306259822235,866
"10486","2244133",0.440986558379816,12905,0.506265872229405,12194,-0.0652793138495891,711
"10487","3244133",0.397872349566312,14359,0.477472039029625,13449,-0.079599689463313,910
"10488","4244133",0.356398018865772,15322,0.435061663907815,14841,-0.0786636450420427,481
"10489","1344133",0.476230260611228,11412,0.53558978953693,10703,-0.0593595289257017,709
"10490","2344133",0.41300708810304,13902,0.479215304896107,13366,-0.0662082167930673,536
"10491","3344133",0.369892879289536,15050,0.450421471696327,14405,-0.0805285924067913,645
"10492","4344133",0.328418548588996,15751,0.408011096574517,15442,-0.0795925479855209,309
"10493","1444133",0.437293762626232,13045,0.494960285568824,12718,-0.0576665229425918,327
"10494","2444133",0.374070590118044,14962,0.438585800928001,14746,-0.0645152108099575,216
"10495","3444133",0.33095638130454,15716,0.409791967728222,15410,-0.0788355864236815,306
"10496","4444133",0.289482050604,16103,0.367381592606411,15999,-0.0778995420024112,104
"10497","1111233",0.796839191123884,331,0.820508872685219,267,-0.023669681561335,64
"10498","2111233",0.733616018615695,1033,0.764134388044396,869,-0.0305183694287006,164
"10499","3111233",0.690501809802192,1943,0.735340554844616,1414,-0.0448387450424246,529
"10500","4111233",0.649027479101652,3227,0.692930179722806,2646,-0.0439027006211542,581
"10501","1211233",0.742881413530888,882,0.765204593739513,852,-0.0223231802086249,30
"10502","2211233",0.679658241022699,2237,0.70883010909869,2121,-0.0291718680759905,116
"10503","3211233",0.636544032209196,3696,0.68003627589891,3137,-0.0434922436897145,559
"10504","4211233",0.595069701508656,5468,0.6376259007771,5055,-0.0425561992684441,413
"10505","1311233",0.714901943254112,1368,0.738154026406215,1348,-0.0232520831521031,20
"10506","2311233",0.651678770745923,3132,0.681779541765392,3063,-0.0301007710194687,69
"10507","3311233",0.608564561932419,4870,0.652985708565612,4281,-0.0444211466331927,589
"10508","4311233",0.567090231231879,6840,0.610575333443802,6454,-0.0434851022119224,386
"10509","1411233",0.675965445269116,2342,0.697524522438109,2485,-0.0215590771689933,-143
"10510","2411233",0.612742272760927,4672,0.641150037797286,4868,-0.028407765036359,-196
"10511","3411233",0.569628063947423,6712,0.612356204597506,6368,-0.042728140650083,344
"10512","4411233",0.528153733246883,8841,0.569945829475696,8780,-0.0417920962288126,61
"10513","1121233",0.728859920257464,1106,0.759939561027812,934,-0.0310796407703482,172
"10514","2121233",0.665636747749275,2641,0.703565076386989,2292,-0.0379283286377138,349
"10515","3121233",0.622522538935772,4242,0.67477124318721,3326,-0.0522487042514378,916
"10516","4121233",0.581048208235232,6146,0.632360868065399,5294,-0.0513126598301674,852
"10517","1221233",0.674902142664468,2365,0.704635282082106,2256,-0.0297331394176381,109
"10518","2221233",0.611678970156279,4714,0.648260797441283,4486,-0.0365818272850037,228
"10519","3221233",0.568564761342776,6761,0.619466964241503,5969,-0.0509022028987277,792
"10520","4221233",0.527090430642236,8900,0.577056589119693,8369,-0.0499661584774573,531
"10521","1321233",0.646922672387692,3303,0.677584714748808,3223,-0.0306620423611164,80
"10522","2321233",0.583699499879503,6012,0.621210230107985,5877,-0.037510730228482,135
"10523","3321233",0.540585291065999,8204,0.592416396908205,7482,-0.051831105842206,722
"10524","4321233",0.499110960365459,10316,0.550006021786395,9893,-0.0508950614209356,423
"10525","1421233",0.607986174402696,4893,0.636955210780702,5076,-0.0289690363780065,-183
"10526","2421233",0.544763001894507,7978,0.580580726139879,8157,-0.0358177242453722,-179
"10527","3421233",0.501648793081003,10190,0.5517868929401,9806,-0.0501380998590962,384
"10528","4421233",0.460174462380463,12133,0.509376517818289,12046,-0.0492020554378259,87
"10529","1131233",0.685527398092364,2068,0.721474468579783,1770,-0.035947070487419,298
"10530","2131233",0.622304225584176,4255,0.66509998393896,3747,-0.0427957583547846,508
"10531","3131233",0.579190016770672,6248,0.636306150739181,5107,-0.0571161339685086,1141
"10532","4131233",0.537715686070132,8342,0.59389577561737,7412,-0.0561800895472382,930
"10533","1231233",0.631569620499368,3858,0.666170189634077,3686,-0.0346005691347089,172
"10534","2231233",0.568346447991179,6779,0.609795704993254,6504,-0.0414492570020745,275
"10535","3231233",0.525232239177676,8992,0.581001871793474,8132,-0.0557696326157985,860
"10536","4231233",0.483757908477136,11065,0.538591496671664,10544,-0.0548335881945281,521
"10537","1331233",0.603590150222592,5059,0.639119622300779,4978,-0.0355294720781871,81
"10538","2331233",0.540366977714403,8215,0.582745137659956,8037,-0.0423781599455527,178
"10539","3331233",0.4972527689009,10402,0.553951304460176,9686,-0.0566985355592767,716
"10540","4331233",0.45577843820036,12313,0.511540929338366,11955,-0.0557624911380064,358
"10541","1431233",0.564653652237596,6942,0.598490118332673,7143,-0.0338364660950773,-201
"10542","2431233",0.501430479729407,10204,0.54211563369185,10347,-0.040685153962443,-143
"10543","3431233",0.458316270915904,12220,0.513321800492071,11864,-0.055005529576167,356
"10544","4431233",0.416841940215364,13788,0.47091142537026,13727,-0.0540694851548966,61
"10545","1141233",0.636493833637535,3700,0.681075974452699,3090,-0.0445821408151644,610
"10546","2141233",0.573270661129346,6525,0.624701489811876,5682,-0.05143082868253,843
"10547","3141233",0.530156452315843,8726,0.595907656612097,7299,-0.065751204296254,1427
"10548","4141233",0.488682121615303,10816,0.553497281490286,9716,-0.0648151598749837,1100
"10549","1241233",0.582536056044539,6062,0.625771695506993,5624,-0.0432356394624543,438
"10550","2241233",0.51931288353635,9267,0.56939721086617,8808,-0.0500843273298199,459
"10551","3241233",0.476198674722846,11415,0.54060337766639,10447,-0.064404702943544,968
"10552","4241233",0.434724344022306,13158,0.49819300254458,12573,-0.0634686585222735,585
"10553","1341233",0.554556585767763,7473,0.598721128173695,7130,-0.0441645424059326,343
"10554","2341233",0.491333413259574,10672,0.542346643532872,10330,-0.0510132302732982,342
"10555","3341233",0.44821920444607,12627,0.513552810333092,11854,-0.0653336058870222,773
"10556","4341233",0.40674487374553,14107,0.471142435211282,13717,-0.0643975614657518,390
"10557","1441233",0.515620087782767,9492,0.558091624205589,9440,-0.0424715364228228,52
"10558","2441233",0.452396915274578,12446,0.501717139564766,12413,-0.0493202242901885,33
"10559","3441233",0.409282706461074,14022,0.472923306364987,13651,-0.0636405999039124,371
"10560","4441233",0.367808375760534,15103,0.430512931243176,14966,-0.062704555482642,137
"10561","1112233",0.763754279362195,622,0.782189891156567,609,-0.0184356117943718,13
"10562","2112233",0.700531106854006,1682,0.725815406515744,1647,-0.0252842996617374,35
"10563","3112233",0.657416898040503,2911,0.697021573315964,2506,-0.0396046752754614,405
"10564","4112233",0.615942567339963,4501,0.654611198194154,4207,-0.038668630854191,294
"10565","1212233",0.709796501769199,1475,0.726885612210861,1617,-0.0170891104416617,-142
"10566","2212233",0.64657332926101,3313,0.670511127570037,3488,-0.0239377983090273,-175
"10567","3212233",0.603459120447507,5067,0.641717294370258,4832,-0.0382581739227513,235
"10568","4212233",0.561984789746967,7064,0.599306919248448,7094,-0.037322129501481,-30
"10569","1312233",0.681817031492423,2172,0.699835044877563,2414,-0.01801801338514,-242
"10570","2312233",0.618593858984234,4400,0.64346056023674,4738,-0.0248667012525056,-338
"10571","3312233",0.57547965017073,6401,0.61466672703696,6227,-0.0391870768662296,174
"10572","4312233",0.53400531947019,8510,0.57225635191515,8637,-0.0382510324449592,-127
"10573","1412233",0.642880533507427,3447,0.659205540909457,4000,-0.0163250074020301,-553
"10574","2412233",0.579657360999238,6222,0.602831056268634,6887,-0.0231736952693958,-665
"10575","3412233",0.536543152185734,8391,0.574037223068854,8546,-0.0374940708831198,-155
"10576","4412233",0.495068821485194,10496,0.531626847947044,10908,-0.0365580264618495,-412
"10577","1122233",0.695775008495775,1800,0.72162057949916,1764,-0.025845571003385,36
"10578","2122233",0.632551835987586,3824,0.665246094858337,3733,-0.0326942588707506,91
"10579","3122233",0.589437627174083,5714,0.636452261658557,5100,-0.0470146344844746,614
"10580","4122233",0.547963296473543,7794,0.594041886536747,7400,-0.0460785900632042,394
"10581","1222233",0.641817230902779,3489,0.666316300553454,3675,-0.0244990696506749,-186
"10582","2222233",0.57859405839459,6269,0.609941815912631,6487,-0.0313477575180405,-218
"10583","3222233",0.535479849581087,8441,0.581147982712851,8123,-0.0456681331317645,318
"10584","4222233",0.494005518880547,10543,0.538737607591041,10534,-0.0447320887104942,9
"10585","1322233",0.613837760626003,4622,0.639265733220156,4966,-0.0254279725941532,-344
"10586","2322233",0.550614588117814,7670,0.582891248579333,8026,-0.0322766604615188,-356
"10587","3322233",0.50750037930431,9875,0.554097415379553,9675,-0.0465970360752428,200
"10588","4322233",0.46602604860377,11860,0.511687040257743,11948,-0.0456609916539724,-88
"10589","1422233",0.574901262641007,6443,0.59863622925205,7135,-0.0237349666110434,-692
"10590","2422233",0.511678090132818,9685,0.542261744611227,10336,-0.030583654478409,-651
"10591","3422233",0.468563881319314,11754,0.513467911411448,11859,-0.0449040300921331,-105
"10592","4422233",0.427089550618775,13434,0.471057536289637,13721,-0.0439679856708626,-287
"10593","1132233",0.652442486330675,3104,0.683155487051131,3005,-0.0307130007204558,99
"10594","2132233",0.589219313822487,5724,0.626781002410308,5578,-0.0375616885878214,146
"10595","3132233",0.546105105008983,7900,0.597987169210529,7180,-0.0518820642015454,720
"10596","4132233",0.504630774308443,10027,0.555576794088718,9599,-0.050946019780275,428
"10597","1232233",0.598484708737679,5300,0.627851208105425,5517,-0.0293664993677457,-217
"10598","2232233",0.53526153622949,8451,0.571476723464602,8696,-0.0362151872351113,-245
"10599","3232233",0.492147327415987,10637,0.542682890264822,10307,-0.0505355628488353,330
"10600","4232233",0.450672996715447,12517,0.500272515143012,12481,-0.0495995184275649,36
"10601","1332233",0.570505238460903,6661,0.600800640772127,7017,-0.030295402311224,-356
"10602","2332233",0.507282065952714,9885,0.544426156131304,10215,-0.0371440901785896,-330
"10603","3332233",0.464167857139211,11948,0.515632322931524,11742,-0.0514644657923136,206
"10604","4332233",0.422693526438671,13589,0.473221947809714,13637,-0.0505284213710431,-48
"10605","1432233",0.531568740475907,8645,0.560171136804021,9320,-0.0286023963281141,-675
"10606","2432233",0.468345567967718,11765,0.503796652163198,12310,-0.0354510841954798,-545
"10607","3432233",0.425231359154215,13502,0.475002818963419,13551,-0.0497714598092038,-49
"10608","4432233",0.383757028453675,14739,0.432592443841608,14913,-0.0488354153879334,-174
"10609","1142233",0.603408921875846,5074,0.642756992924047,4777,-0.0393480710482013,297
"10610","2142233",0.540185749367657,8223,0.586382508283224,7812,-0.0461967589155668,411
"10611","3142233",0.497071540554154,10407,0.557588675083444,9472,-0.0605171345292909,935
"10612","4142233",0.455597209853614,12318,0.515178299961634,11767,-0.0595810901080205,551
"10613","1242233",0.54945114428285,7725,0.587452713978341,7744,-0.0380015696954912,-19
"10614","2242233",0.486227971774661,10944,0.531078229337518,10936,-0.0448502575628568,8
"10615","3242233",0.443113762961157,12823,0.502284396137738,12380,-0.0591706331765808,443
"10616","4242233",0.401639432260617,14260,0.459874021015928,14085,-0.0582345887553103,175
"10617","1342233",0.521471674006074,9174,0.560402146645043,9302,-0.0389304726389694,-128
"10618","2342233",0.458248501497885,12221,0.50402766200422,12299,-0.045779160506335,-78
"10619","3342233",0.415134292684381,13842,0.47523382880444,13541,-0.060099536120059,301
"10620","4342233",0.373659961983841,14972,0.43282345368263,14900,-0.0591634916987886,72
"10621","1442233",0.482535176021078,11116,0.519772642676937,11510,-0.0372374666558596,-394
"10622","2442233",0.419312003512889,13718,0.463398158036114,13964,-0.0440861545232252,-246
"10623","3442233",0.376197794699385,14920,0.434604324836335,14852,-0.0584065301369492,68
"10624","4442233",0.334723463998845,15673,0.392193949714524,15697,-0.0574704857156789,-24
"10625","1113233",0.724871103789709,1181,0.756693300767328,983,-0.0318221969776185,198
"10626","2113233",0.66164793128152,2768,0.700318816126505,2397,-0.038670884844984,371
"10627","3113233",0.618533722468017,4404,0.671524982926725,3454,-0.0529912604587081,950
"10628","4113233",0.577059391767477,6337,0.629114607804915,5451,-0.0520552160374376,886
"10629","1213233",0.670913326196713,2473,0.701389021821622,2372,-0.0304756956249083,101
"10630","2213233",0.607690153688525,4904,0.645014537180798,4654,-0.0373243834922738,250
"10631","3213233",0.564575944875021,6945,0.616220703981019,6159,-0.0516447591059979,786
"10632","4213233",0.523101614174481,9086,0.573810328859209,8554,-0.0507087146847276,532
"10633","1313233",0.642933855919937,3443,0.674338454488324,3337,-0.0314045985683865,106
"10634","2313233",0.579710683411748,6218,0.6179639698475,6051,-0.0382532864357521,167
"10635","3313233",0.536596474598245,8386,0.589170136647721,7649,-0.0525736620494761,737
"10636","4313233",0.495122143897705,10490,0.546759761525911,10066,-0.0516376176282058,424
"10637","1413233",0.603997357934941,5051,0.633708950520218,5236,-0.0297115925852767,-185
"10638","2413233",0.540774185426752,8190,0.577334465879395,8358,-0.0365602804526424,-168
"10639","3413233",0.497659976613249,10379,0.548540632679615,9976,-0.0508806560663664,403
"10640","4413233",0.456185645912709,12299,0.506130257557805,12201,-0.0499446116450961,98
"10641","1123233",0.65689183292329,2923,0.696123989109921,2534,-0.0392321561866317,389
"10642","2123233",0.593668660415101,5522,0.639749504469098,4934,-0.0460808440539973,588
"10643","3123233",0.550554451601597,7673,0.610955671269318,6438,-0.0604012196677213,1235
"10644","4123233",0.509080120901057,9796,0.568545296147508,8858,-0.0594651752464508,938
"10645","1223233",0.602934055330293,5092,0.640819710164215,4881,-0.0378856548339215,211
"10646","2223233",0.539710882822105,8243,0.584445225523392,7921,-0.0447343427012871,322
"10647","3223233",0.496596674008601,10423,0.555651392323612,9592,-0.0590547183150111,831
"10648","4223233",0.455122343308061,12333,0.513241017201802,11870,-0.0581186738937408,463
"10649","1323233",0.574954585053517,6438,0.613769142830917,6285,-0.0388145577773997,153
"10650","2323233",0.511731412545328,9682,0.557394658190094,9485,-0.0456632456447653,197
"10651","3323233",0.468617203731825,11752,0.528600824990314,11071,-0.0599836212584893,681
"10652","4323233",0.427142873031285,13432,0.486190449868504,13087,-0.059047576837219,345
"10653","1423233",0.536018087068521,8422,0.573139638862811,8592,-0.0371215517942899,-170
"10654","2423233",0.472794914560332,11574,0.516765154221988,11679,-0.0439702396616556,-105
"10655","3423233",0.429680705746829,13352,0.487971321022208,13021,-0.0582906152753795,331
"10656","4423233",0.388206375046289,14630,0.445560945900398,14553,-0.0573545708541093,77
"10657","1133233",0.61355931075819,4634,0.657658896661892,4071,-0.0440995859037023,563
"10658","2133233",0.550336138250001,7689,0.601284412021069,6981,-0.0509482737710679,708
"10659","3133233",0.507221929436498,9890,0.57249057882129,8621,-0.0652686493847919,1269
"10660","4133233",0.465747598735958,11867,0.530080203699479,10999,-0.0643326049635217,868
"10661","1233233",0.559601533165194,7191,0.602354617716186,6912,-0.0427530845509924,279
"10662","2233233",0.496378360657005,10438,0.545980133075363,10116,-0.049601772418358,322
"10663","3233233",0.453264151843501,12418,0.517186299875583,11656,-0.063922148032082,762
"10664","4233233",0.411789821142961,13947,0.474775924753773,13563,-0.0629861036108114,384
"10665","1333233",0.531622062888418,8640,0.575304050382888,8472,-0.0436819874944706,168
"10666","2333233",0.468398890380229,11762,0.518929565742065,11561,-0.0505306753618362,201
"10667","3333233",0.425284681566725,13497,0.490135732542285,12927,-0.0648510509755602,570
"10668","4333233",0.383810350866185,14737,0.447725357420475,14493,-0.0639150065542897,244
"10669","1433233",0.492685564903422,10611,0.534674546414782,10754,-0.0419889815113608,-143
"10670","2433233",0.429462392395233,13359,0.478300061773959,13408,-0.0488376693787264,-49
"10671","3433233",0.386348183581729,14670,0.44950622857418,14436,-0.0631580449924504,234
"10672","4433233",0.344873852881189,15513,0.407095853452369,15466,-0.0622220005711799,47
"10673","1143233",0.56452574630336,6950,0.617260402534808,6094,-0.0527346562314479,856
"10674","2143233",0.501302573795171,10208,0.560885917893985,9271,-0.0595833440988135,937
"10675","3143233",0.458188364981668,12223,0.532092084694205,10886,-0.0739037197125375,1337
"10676","4143233",0.416714034281128,13792,0.489681709572395,12949,-0.072967675291267,843
"10677","1243233",0.510567968710364,9738,0.561956123589102,9219,-0.0513881548787377,519
"10678","2243233",0.447344796202175,12664,0.505581638948279,12221,-0.0582368427461033,443
"10679","3243233",0.404230587388672,14182,0.476787805748499,13480,-0.0725572183598273,702
"10680","4243233",0.362756256688132,15213,0.434377430626689,14857,-0.071621173938557,356
"10681","1343233",0.482588498433588,11112,0.534905556255804,10744,-0.052317057822216,368
"10682","2343233",0.419365325925399,13716,0.478531071614981,13393,-0.0591657456895815,323
"10683","3343233",0.376251117111896,14918,0.449737238415201,14427,-0.0734861213033055,491
"10684","4343233",0.334776786411356,15672,0.407326863293391,15458,-0.0725500768820352,214
"10685","1443233",0.443652000448592,12811,0.494276052287698,12748,-0.0506240518391061,63
"10686","2443233",0.380428827940403,14825,0.437901567646875,14763,-0.0574727397064718,62
"10687","3443233",0.3373146191269,15638,0.409107734447096,15422,-0.0717931153201958,216
"10688","4443233",0.29584028842636,16069,0.366697359325285,16003,-0.0708570708989254,66
"10689","1114233",0.67266403181914,2421,0.712042687393672,2007,-0.0393786555745324,414
"10690","2114233",0.609440859310951,4826,0.655668202752849,4161,-0.0462273434418979,665
"10691","3114233",0.566326650497447,6870,0.626874369553069,5569,-0.060547719055622,1301
"10692","4114233",0.524852319796907,9004,0.584463994431259,7919,-0.0596116746343516,1085
"10693","1214233",0.618706254226144,4390,0.656738408447966,4116,-0.0380321542218223,274
"10694","2214233",0.555483081717955,7427,0.600363923807143,7042,-0.0448808420891879,385
"10695","3214233",0.512368872904451,9650,0.571570090607363,8686,-0.0592012177029119,964
"10696","4214233",0.470894542203911,11652,0.529159715485553,11044,-0.0582651732816415,608
"10697","1314233",0.590726783949367,5643,0.629687841114668,5423,-0.0389610571653005,220
"10698","2314233",0.527503611441179,8867,0.573313356473845,8584,-0.0458097450326661,283
"10699","3314233",0.484389402627675,11020,0.544519523274065,10205,-0.0601301206463901,815
"10700","4314233",0.442915071927135,12830,0.502109148152255,12389,-0.0591940762251197,441
"10701","1414233",0.551790285964371,7608,0.589058337146562,7655,-0.0372680511821907,-47
"10702","2414233",0.488567113456183,10822,0.532683852505739,10866,-0.0441167390495564,-44
"10703","3414233",0.445452904642679,12734,0.503890019305959,12304,-0.0584371146632804,430
"10704","4414233",0.403978573942139,14194,0.461479644184149,14033,-0.05750107024201,161
"10705","1124233",0.60468476095272,5016,0.651473375736265,4340,-0.0467886147835456,676
"10706","2124233",0.541461588444531,8146,0.595098891095442,7338,-0.0536373026509112,808
"10707","3124233",0.498347379631027,10343,0.566305057895663,8975,-0.0679576782646352,1368
"10708","4124233",0.456873048930487,12266,0.523894682773852,11302,-0.0670216338433648,964
"10709","1224233",0.550726983359724,7664,0.596169096790559,7282,-0.0454421134308355,382
"10710","2224233",0.487503810851535,10880,0.539794612149736,10482,-0.0522908012982011,398
"10711","3224233",0.444389602038031,12781,0.511000778949956,11983,-0.0666111769119251,798
"10712","4224233",0.402915271337491,14215,0.468590403828146,13806,-0.0656751324906547,409
"10713","1324233",0.522747513082947,9104,0.569118529457261,8825,-0.0463710163743137,279
"10714","2324233",0.459524340574759,12161,0.512744044816438,11891,-0.0532197042416793,270
"10715","3324233",0.416410131761255,13798,0.483950211616658,13183,-0.0675400798554033,615
"10716","4324233",0.374935801060715,14942,0.441539836494848,14669,-0.0666040354341329,273
"10717","1424233",0.483811015097951,11060,0.528489025489155,11076,-0.0446780103912039,-16
"10718","2424233",0.420587842589763,13666,0.472114540848332,13684,-0.0515266982585695,-18
"10719","3424233",0.377473633776259,14896,0.443320707648553,14627,-0.0658470738722935,269
"10720","4424233",0.335999303075719,15653,0.400910332526742,15578,-0.0649110294510232,75
"10721","1134233",0.56135223878762,7097,0.613008283288236,6330,-0.0516560445006163,767
"10722","2134233",0.498129066279431,10358,0.556633798647413,9537,-0.0585047323679819,821
"10723","3134233",0.455014857465928,12341,0.527839965447634,11105,-0.0728251079817059,1236
"10724","4134233",0.413540526765388,13882,0.485429590325823,13125,-0.0718890635604355,757
"10725","1234233",0.507394461194624,9879,0.55770400434253,9464,-0.0503095431479063,415
"10726","2234233",0.444171288686435,12794,0.501329519701707,12428,-0.0571582310152718,366
"10727","3234233",0.401057079872932,14277,0.472535686501927,13665,-0.0714786066289958,612
"10728","4234233",0.359582749172392,15265,0.430125311380117,14974,-0.0705425622077254,291
"10729","1334233",0.479414990917848,11243,0.530653437009232,10960,-0.0512384460913845,283
"10730","2334233",0.416191818409659,13806,0.474278952368409,13585,-0.05808713395875,221
"10731","3334233",0.373077609596155,14982,0.44548511916863,14557,-0.072407509572474,425
"10732","4334233",0.331603278895615,15706,0.403074744046819,15539,-0.0714714651512037,167
"10733","1434233",0.440478492932852,12926,0.490023933041126,12933,-0.0495454401082746,-7
"10734","2434233",0.377255320424663,14902,0.433649448400303,14877,-0.0563941279756403,25
"10735","3434233",0.334141111611159,15677,0.404855615200524,15508,-0.0707145035893643,169
"10736","4434233",0.29266678091062,16087,0.362445240078713,16049,-0.0697784591680939,38
"10737","1144233",0.512318674332791,9656,0.572609789161152,8615,-0.0602911148283618,1041
"10738","2144233",0.449095501824602,12592,0.516235304520329,11704,-0.0671398026957274,888
"10739","3144233",0.405981293011098,14133,0.48744147132055,13036,-0.0814601783094513,1097
"10740","4144233",0.364506962310558,15173,0.445031096198739,14572,-0.080524133888181,601
"10741","1244233",0.458360896739794,12217,0.517305510215446,11649,-0.0589446134756517,568
"10742","2244233",0.395137724231606,14444,0.460931025574623,14052,-0.0657933013430173,392
"10743","3244233",0.352023515418102,15405,0.432137192374843,14927,-0.0801136769567413,478
"10744","4244233",0.310549184717562,15950,0.389726817253033,15734,-0.0791776325354709,216
"10745","1344233",0.430381426463018,13327,0.490254942882148,12919,-0.0598735164191299,408
"10746","2344233",0.367158253954829,15117,0.433880458241325,14870,-0.0667222042864955,247
"10747","3344233",0.324044045141326,15800,0.405086625041545,15502,-0.0810425799002195,298
"10748","4344233",0.282569714440786,16151,0.362676249919735,16043,-0.0801065354789491,108
"10749","1444233",0.391444928478022,14556,0.449625438914042,14431,-0.0581805104360201,125
"10750","2444233",0.328221755969833,15753,0.393250954273219,15682,-0.0650291983033858,71
"10751","3444233",0.28510754715633,16136,0.36445712107344,16025,-0.0793495739171098,111
"10752","4444233",0.24363321645579,16308,0.322046745951629,16273,-0.0784135294958394,35
"10753","1111333",0.774385212118576,510,0.802458882757544,403,-0.0280736706389684,107
"10754","2111333",0.711162039610387,1445,0.746084398116721,1184,-0.034922358506334,261
"10755","3111333",0.668047830796884,2572,0.717290564916942,1883,-0.049242734120058,689
"10756","4111333",0.626573500096344,4052,0.674880189795131,3322,-0.0483066896987877,730
"10757","1211333",0.72042743452558,1269,0.747154603811838,1166,-0.0267271692862584,103
"10758","2211333",0.657204262017391,2916,0.690780119171015,2716,-0.033575857153624,200
"10759","3211333",0.614090053203887,4609,0.661986285971235,3886,-0.047896232767348,723
"10760","4211333",0.572615722503348,6554,0.619575910849425,5963,-0.0469601883460775,591
"10761","1311333",0.692447964248804,1895,0.72010403647854,1805,-0.0276560722297367,90
"10762","2311333",0.629224791740615,3954,0.663729551837717,3809,-0.0345047600971022,145
"10763","3311333",0.586110582927111,5883,0.634935718637938,5185,-0.0488251357108263,698
"10764","4311333",0.544636252226571,7986,0.592525343516127,7476,-0.0478890912895558,510
"10765","1411333",0.653511466263808,3059,0.679474532510434,3158,-0.0259630662466268,-99
"10766","2411333",0.590288293755619,5680,0.623100047869611,5777,-0.0328117541139925,-97
"10767","3411333",0.547174084942115,7841,0.594306214669832,7387,-0.0471321297277165,454
"10768","4411333",0.505699754241575,9966,0.551895839548021,9800,-0.046196085306446,166
"10769","1121333",0.706405941252156,1562,0.741889571100138,1271,-0.0354836298479816,291
"10770","2121333",0.643182768743967,3432,0.685515086459314,2909,-0.0423323177153472,523
"10771","3121333",0.600068559930464,5232,0.656721253259535,4119,-0.0566526933290712,1113
"10772","4121333",0.558594229229924,7248,0.614310878137725,6247,-0.0557166489078009,1001
"10773","1221333",0.65244816365916,3102,0.686585292154431,2868,-0.0341371284952716,234
"10774","2221333",0.589224991150971,5723,0.630210807513608,5397,-0.0409858163626372,326
"10775","3221333",0.546110782337467,7899,0.601416974313829,6970,-0.0553061919763612,929
"10776","4221333",0.504636451636928,10025,0.559006599192018,9397,-0.0543701475550907,628
"10777","1321333",0.624468693382384,4156,0.659534724821134,3990,-0.0350660314387499,166
"10778","2321333",0.561245520874195,7107,0.60316024018031,6870,-0.0419147193061155,237
"10779","3321333",0.518131312060691,9342,0.574366406980531,8531,-0.0562350949198395,811
"10780","4321333",0.476656981360151,11391,0.53195603185872,10893,-0.055299050498569,498
"10781","1421333",0.585532195397388,5919,0.618905220853028,5997,-0.03337302545564,-78
"10782","2421333",0.522309022889199,9131,0.562530736212205,9190,-0.0402217133230057,-59
"10783","3421333",0.479194814075695,11262,0.533736903012425,10812,-0.0545420889367297,450
"10784","4421333",0.437720483375155,13028,0.491326527890615,12873,-0.0536060445154592,155
"10785","1131333",0.663073419087056,2728,0.703424478652109,2300,-0.0403510595650525,428
"10786","2131333",0.599850246578867,5236,0.647049994011285,4556,-0.0471997474324181,680
"10787","3131333",0.556736037765364,7355,0.618256160811506,6035,-0.0615201230461421,1320
"10788","4131333",0.515261707064824,9511,0.575845785689696,8436,-0.0605840786248716,1075
"10789","1231333",0.60911564149406,4843,0.648120199706403,4496,-0.0390045582123423,347
"10790","2231333",0.545892468985871,7910,0.591745715065579,7511,-0.0458532460797079,399
"10791","3231333",0.502778260172368,10126,0.5629518818658,9165,-0.0601736216934319,961
"10792","4231333",0.461303929471828,12083,0.520541506743989,11466,-0.0592375772721616,617
"10793","1331333",0.581136171217284,6138,0.621069632373105,5883,-0.0399334611558205,255
"10794","2331333",0.517912998709095,9354,0.564695147732281,9057,-0.0467821490231861,297
"10795","3331333",0.474798789895592,11485,0.535901314532502,10691,-0.0611025246369101,794
"10796","4331333",0.433324459195052,13219,0.493490939410691,12775,-0.0601664802156398,444
"10797","1431333",0.542199673232288,8111,0.580440128404999,8162,-0.0382404551727107,-51
"10798","2431333",0.478976500724099,11276,0.524065643764176,11293,-0.0450891430400764,-17
"10799","3431333",0.435862291910596,13107,0.495271810564396,12707,-0.0594095186538003,400
"10800","4431333",0.394387961210056,14467,0.452861435442586,14315,-0.0584734742325301,152
"10801","1141333",0.614039854632227,4611,0.663025984525025,3840,-0.0489861298927978,771
"10802","2141333",0.550816682124038,7661,0.606651499884201,6666,-0.0558348177601634,995
"10803","3141333",0.507702473310535,9867,0.577857666684422,8332,-0.0701551933738874,1535
"10804","4141333",0.466228142609994,11850,0.535447291562612,10713,-0.0692191489526172,1137
"10805","1241333",0.560082077039231,7172,0.607721705579318,6619,-0.0476396285400879,553
"10806","2241333",0.496858904531042,10415,0.551347220938495,9826,-0.0544883164074534,589
"10807","3241333",0.453744695717538,12398,0.522553387738716,11369,-0.0688086920211775,1029
"10808","4241333",0.412270365016998,13933,0.480143012616905,13330,-0.0678726475999069,603
"10809","1341333",0.532102606762454,8618,0.580671138246021,8152,-0.0485685314835661,466
"10810","2341333",0.468879434254266,11745,0.524296653605197,11284,-0.0554172193509317,461
"10811","3341333",0.425765225440762,13484,0.495502820405418,12694,-0.0697375949646556,790
"10812","4341333",0.384290894740222,14724,0.453092445283607,14308,-0.0688015505433852,416
"10813","1441333",0.493166108777458,10594,0.540041634277915,10471,-0.0468755255004563,123
"10814","2441333",0.42994293626927,13345,0.483667149637092,13196,-0.0537242133678219,149
"10815","3441333",0.386828727455766,14661,0.454873316437312,14256,-0.0680445889815459,405
"10816","4441333",0.345354396755226,15504,0.412462941315502,15355,-0.0671085445602754,149
"10817","1112333",0.741300300356887,906,0.764139901228892,868,-0.0228396008720052,38
"10818","2112333",0.678077127848698,2287,0.707765416588069,2154,-0.0296882887393708,133
"10819","3112333",0.634962919035195,3741,0.67897158338829,3178,-0.0440086643530948,563
"10820","4112333",0.593488588334655,5534,0.636561208266479,5097,-0.0430726199318245,437
"10821","1212333",0.687342522763891,2017,0.708835622283186,2120,-0.0214930995192952,-103
"10822","2212333",0.624119350255702,4176,0.652461137642363,4304,-0.0283417873866608,-128
"10823","3212333",0.581005141442199,6147,0.623667304442583,5747,-0.0426621630003848,400
"10824","4212333",0.539530810741659,8252,0.581256929320773,8120,-0.0417261185791143,132
"10825","1312333",0.659363052487115,2836,0.681785054949888,3062,-0.0224220024627735,-226
"10826","2312333",0.596139879978926,5417,0.625410570309065,5646,-0.0292706903301391,-229
"10827","3312333",0.553025671165422,7541,0.596616737109285,7260,-0.0435910659438631,281
"10828","4312333",0.511551340464882,9691,0.554206361987475,9671,-0.0426550215225926,20
"10829","1412333",0.620426554502119,4320,0.641155550981782,4867,-0.0207289964796636,-547
"10830","2412333",0.55720338199393,7333,0.584781066340959,7900,-0.0275776843470293,-567
"10831","3412333",0.514089173180426,9561,0.55598723314118,9580,-0.0418980599607534,-19
"10832","4412333",0.472614842479886,11586,0.513576858019369,11853,-0.0409620155394829,-267
"10833","1122333",0.673321029490467,2409,0.703570589571486,2291,-0.0302495600810184,118
"10834","2122333",0.610097856982278,4794,0.647196104930662,4549,-0.037098247948384,245
"10835","3122333",0.566983648168775,6844,0.618402271730883,6025,-0.051418623562108,819
"10836","4122333",0.525509317468235,8979,0.575991896609072,8424,-0.0504825791408378,555
"10837","1222333",0.619363251897471,4367,0.648266310625779,4485,-0.0289030587283085,-118
"10838","2222333",0.556140079389282,7391,0.591891825984956,7507,-0.035751746595674,-116
"10839","3222333",0.513025870575779,9623,0.563097992785177,9157,-0.050072122209398,466
"10840","4222333",0.471551539875239,11632,0.520687617663366,11461,-0.0491360777881276,171
"10841","1322333",0.591383781620695,5613,0.621215743292481,5876,-0.0298319616717867,-263
"10842","2322333",0.528160609112506,8840,0.564841258651658,9050,-0.0366806495391523,-210
"10843","3322333",0.485046400299002,10994,0.536047425451879,10682,-0.0510010251528763,312
"10844","4322333",0.443572069598463,12814,0.493637050330068,12770,-0.0500649807316058,44
"10845","1422333",0.552447283635699,7569,0.580586239324376,8156,-0.0281389556886769,-587
"10846","2422333",0.48922411112751,10786,0.524211754683552,11289,-0.0349876435560426,-503
"10847","3422333",0.446109902314006,12711,0.495417921483773,12700,-0.0493080191697665,11
"10848","4422333",0.404635571613467,14176,0.453007546361963,14312,-0.048371974748496,-136
"10849","1132333",0.629988507325367,3914,0.665105497123457,3746,-0.0351169897980893,168
"10850","2132333",0.566765334817179,6851,0.608731012482633,6572,-0.0419656776654549,279
"10851","3132333",0.523651126003675,9057,0.579937179282854,8203,-0.0562860532791789,854
"10852","4132333",0.482176795303135,11134,0.537526804161044,10611,-0.0553500088579084,523
"10853","1232333",0.576030729732371,6382,0.60980121817775,6503,-0.0337704884453791,-121
"10854","2232333",0.512807557224182,9638,0.553426733536927,9722,-0.0406191763127447,-84
"10855","3232333",0.469693348410679,11706,0.524632900337148,11269,-0.0549395519264687,437
"10856","4232333",0.428219017710139,13396,0.482222525215337,13246,-0.0540035075051984,150
"10857","1332333",0.548051259455595,7789,0.582750650844453,8036,-0.0346993913888574,-247
"10858","2332333",0.484828086947406,11004,0.526376166203629,11179,-0.041548079256223,-175
"10859","3332333",0.441713878133903,12873,0.49758233300385,12597,-0.0558684548699469,276
"10860","4332333",0.400239547433363,14292,0.455171957882039,14241,-0.0549324104486766,51
"10861","1432333",0.509114761470599,9794,0.542121146876347,10346,-0.0330063854057475,-552
"10862","2432333",0.44589158896241,12722,0.485746662235523,13108,-0.0398550732731132,-386
"10863","3432333",0.402777380148907,14223,0.456952829035744,14183,-0.0541754488868372,40
"10864","4432333",0.361303049448367,15234,0.414542453913934,15314,-0.0532394044655669,-80
"10865","1142333",0.580954942870538,6150,0.624707002996373,5681,-0.0437520601258347,469
"10866","2142333",0.517731770362349,9363,0.568332518355549,8868,-0.0506007479932002,495
"10867","3142333",0.474617561548846,11489,0.53953868515577,10498,-0.0649211236069243,991
"10868","4142333",0.433143230848306,13228,0.497128310033959,12615,-0.0639850791856539,613
"10869","1242333",0.526997165277542,8904,0.569402724050666,8807,-0.0424055587731247,97
"10870","2242333",0.463773992769353,11967,0.513028239409843,11877,-0.0492542466404903,90
"10871","3242333",0.420659783955849,13663,0.484234406210064,13173,-0.0635746222542142,490
"10872","4242333",0.37918545325531,14854,0.441824031088253,14663,-0.0626385778329437,191
"10873","1342333",0.499017695000766,10319,0.542352156717368,10329,-0.0433344617166029,-10
"10874","2342333",0.435794522492577,13113,0.485977672076545,13097,-0.0501831495839685,16
"10875","3342333",0.392680313679073,14515,0.457183838876766,14173,-0.0645035251976925,342
"10876","4342333",0.351205982978533,15418,0.414773463754955,15306,-0.063567480776422,112
"10877","1442333",0.46008119701577,12139,0.501722652749263,12412,-0.0416414557334931,-273
"10878","2442333",0.396858024507581,14392,0.445348168108439,14562,-0.0484901436008587,-170
"10879","3442333",0.353743815694077,15367,0.41655433490866,15269,-0.0628105192145827,98
"10880","4442333",0.312269484993537,15929,0.37414395978685,15932,-0.0618744747933123,-3
"10881","1113333",0.702417124784401,1650,0.738643310839653,1341,-0.0362261860552519,309
"10882","2113333",0.639193952276213,3599,0.68226882619883,3034,-0.0430748739226174,565
"10883","3113333",0.596079743462709,5421,0.65347499299905,4263,-0.0573952495363415,1158
"10884","4113333",0.554605412762169,7466,0.61106461787724,6435,-0.056459205115071,1031
"10885","1213333",0.648459347191405,3251,0.683339031893947,2994,-0.0348796847025417,257
"10886","2213333",0.585236174683217,5942,0.626964547253124,5565,-0.0417283725699072,377
"10887","3213333",0.542121965869713,8117,0.598170714053344,7171,-0.0560487481836313,946
"10888","4213333",0.500647635169173,10229,0.555760338931534,9589,-0.055112703762361,640
"10889","1313333",0.620479876914629,4316,0.656288464560649,4136,-0.0358085876460199,180
"10890","2313333",0.55725670440644,7327,0.599913979919826,7061,-0.0426572755133855,266
"10891","3313333",0.514142495592937,9559,0.571120146720046,8721,-0.0569776511271095,838
"10892","4313333",0.472668164892397,11582,0.528709771598236,11067,-0.0560416067058392,515
"10893","1413333",0.581543378929633,6118,0.615658960592543,6183,-0.0341155816629101,-65
"10894","2413333",0.518320206421444,9323,0.55928447595172,9375,-0.0409642695302758,-52
"10895","3413333",0.475205997607941,11460,0.530490642751941,10974,-0.0552846451439998,486
"10896","4413333",0.433731666907401,13199,0.48808026763013,13018,-0.0543486007227295,181
"10897","1123333",0.634437853917981,3764,0.678073999182247,3206,-0.0436361452642651,558
"10898","2123333",0.571214681409793,6627,0.621699514541423,5846,-0.0504848331316307,781
"10899","3123333",0.528100472596289,8843,0.592905681341644,7461,-0.0648052087453547,1382
"10900","4123333",0.486626141895749,10924,0.550495306219833,9868,-0.0638691643240842,1056
"10901","1223333",0.580480076324985,6176,0.62276972023654,5796,-0.0422896439115549,380
"10902","2223333",0.517256903816797,9397,0.566395235595717,8972,-0.0491383317789205,425
"10903","3223333",0.474142695003293,11517,0.537601402395938,10603,-0.0634587073926445,914
"10904","4223333",0.432668364302753,13242,0.495191027274127,12711,-0.0625226629713742,531
"10905","1323333",0.552500606048209,7565,0.595719152903242,7311,-0.0432185468550331,254
"10906","2323333",0.48927743354002,10782,0.539344668262419,10508,-0.0500672347223987,274
"10907","3323333",0.446163224726517,12710,0.51055083506264,12008,-0.0643876103361227,702
"10908","4323333",0.404688894025977,14175,0.468140459940829,13818,-0.0634515659148524,357
"10909","1423333",0.513564108063213,9589,0.555089648935137,9623,-0.0415255408719233,-34
"10910","2423333",0.450340935555024,12530,0.498715164294313,12559,-0.0483742287392889,-29
"10911","3423333",0.407226726741521,14093,0.469921331094534,13767,-0.0626946043530129,326
"10912","4423333",0.365752396040981,15153,0.427510955972724,15031,-0.0617585599317427,122
"10913","1133333",0.591105331752882,5628,0.639608906734218,4945,-0.0485035749813357,683
"10914","2133333",0.527882159244693,8850,0.583234422093394,7997,-0.0553522628487013,853
"10915","3133333",0.48476795043119,11006,0.554440588893615,9656,-0.0696726384624253,1350
"10916","4133333",0.44329361973065,12817,0.512030213771805,11930,-0.0687365940411551,887
"10917","1233333",0.537147554159886,8367,0.584304627788511,7931,-0.0471570736286258,436
"10918","2233333",0.473924381651697,11530,0.527930143147688,11098,-0.0540057614959913,432
"10919","3233333",0.430810172838193,13312,0.499136309947909,12542,-0.0683261371097153,770
"10920","4233333",0.389335842137653,14604,0.456725934826098,14189,-0.0673900926884448,415
"10921","1333333",0.50916808388311,9790,0.557254060455214,9496,-0.048085976572104,294
"10922","2333333",0.445944911374921,12718,0.50087957581439,12448,-0.0549346644394696,270
"10923","3333333",0.402830702561417,14220,0.472085742614611,13687,-0.0692550400531936,533
"10924","4333333",0.361356371860877,15232,0.4296753674928,14987,-0.0683189956319231,245
"10925","1433333",0.470231585898114,11682,0.516624556487108,11685,-0.0463929705889942,-3
"10926","2433333",0.407008413389925,14100,0.460250071846284,14073,-0.0532416584563598,27
"10927","3433333",0.363894204576421,15187,0.431456238646505,14950,-0.0675620340700838,237
"10928","4433333",0.322419873875881,15819,0.389045863524695,15745,-0.0666259896488133,74
"10929","1143333",0.542071767298052,8121,0.599210412607134,7104,-0.0571386453090813,1017
"10930","2143333",0.478848594789863,11283,0.54283592796631,10295,-0.0639873331764469,988
"10931","3143333",0.43573438597636,13115,0.514042094766531,11830,-0.0783077087901709,1285
"10932","4143333",0.39426005527582,14470,0.47163171964472,13701,-0.0773716643689004,769
"10933","1243333",0.488113989705056,10851,0.543906133661427,10242,-0.0557921439563711,609
"10934","2243333",0.424890817196867,13518,0.487531649020604,13033,-0.0626408318237366,485
"10935","3243333",0.381776608383364,14786,0.458737815820825,14129,-0.0769612074374607,657
"10936","4243333",0.340302277682824,15591,0.416327440699014,15275,-0.0760251630161904,316
"10937","1343333",0.46013451942828,12134,0.516855566328129,11675,-0.0567210468998494,459
"10938","2343333",0.396911346920091,14389,0.460481081687306,14065,-0.0635697347672149,324
"10939","3343333",0.353797138106588,15366,0.431687248487527,14942,-0.0778901103809389,424
"10940","4343333",0.312322807406048,15928,0.389276873365716,15741,-0.0769540659596686,187
"10941","1443333",0.421198021443284,13644,0.476226062360024,13504,-0.0550280409167395,140
"10942","2443333",0.357974848935095,15292,0.4198515777192,15204,-0.0618767287841052,88
"10943","3443333",0.314860640121592,15899,0.391057744519421,15719,-0.0761971043978292,180
"10944","4443333",0.273386309421052,16201,0.348647369397611,16143,-0.0752610599765589,58
"10945","1114333",0.650210052813832,3186,0.693992697465997,2609,-0.0437826446521659,577
"10946","2114333",0.586986880305643,5828,0.637618212825174,5056,-0.0506313325195314,772
"10947","3114333",0.543872671492139,8023,0.608824379625395,6566,-0.0649517081332555,1457
"10948","4114333",0.502398340791599,10143,0.566414004503584,8969,-0.064015663711985,1174
"10949","1214333",0.596252275220836,5411,0.638688418520291,5006,-0.0424361432994557,405
"10950","2214333",0.533029102712647,8575,0.582313933879468,8065,-0.0492848311668213,510
"10951","3214333",0.489914893899143,10750,0.553520100679688,9714,-0.0636052067805453,1036
"10952","4214333",0.448440563198603,12619,0.511109725557878,11979,-0.062669162359275,640
"10953","1314333",0.568272804944059,6787,0.611637851186993,6413,-0.0433650462429339,374
"10954","2314333",0.505049632435871,10003,0.55526336654617,9614,-0.0502137341102995,389
"10955","3314333",0.461935423622367,12051,0.526469533346391,11172,-0.0645341097240235,879
"10956","4314333",0.420461092921827,13675,0.48405915822458,13178,-0.0635980653027532,497
"10957","1414333",0.529336306959063,8776,0.571008347218887,8726,-0.0416720402598241,50
"10958","2414333",0.466113134450875,11856,0.514633862578064,11798,-0.0485207281271898,58
"10959","3414333",0.422998925637371,13583,0.485840029378285,13104,-0.0628411037409137,479
"10960","4414333",0.381524594936831,14793,0.443429654256474,14621,-0.0619050593196435,172
"10961","1124333",0.582230781947412,6084,0.633423385808591,5249,-0.0511926038611791,835
"10962","2124333",0.519007609439223,9283,0.577048901167767,8370,-0.0580412917285447,913
"10963","3124333",0.475893400625719,11433,0.548255067967988,9995,-0.0723616673422687,1438
"10964","4124333",0.434419069925179,13172,0.505844692846178,12210,-0.0714256229209982,962
"10965","1224333",0.528273004354416,8826,0.578119106862884,8314,-0.0498461025084689,512
"10966","2224333",0.465049831846227,11902,0.521744622222061,11411,-0.0566947903758345,491
"10967","3224333",0.421935623032723,13617,0.492950789022282,12805,-0.0710151659895584,812
"10968","4224333",0.380461292332183,14824,0.450540413900471,14399,-0.0700791215682882,425
"10969","1324333",0.500293534077639,10250,0.551068539529587,9845,-0.0507750054519471,405
"10970","2324333",0.437070361569451,13055,0.494694054888763,12730,-0.0576236933193127,325
"10971","3324333",0.393956152755947,14479,0.465900221688984,13894,-0.0719440689330367,585
"10972","4324333",0.352481822055407,15399,0.423489846567173,15116,-0.0710080245117664,283
"10973","1424333",0.461357036092643,12076,0.510439035561481,12013,-0.0490819994688373,63
"10974","2424333",0.398133863584455,14346,0.454064550920658,14283,-0.0559306873362029,63
"10975","3424333",0.355019654770951,15348,0.425270717720878,15081,-0.070251062949927,267
"10976","4424333",0.313545324070411,15918,0.382860342599068,15821,-0.0693150185286566,97
"10977","1134333",0.538898259782312,8284,0.594958293360562,7345,-0.0560600335782497,939
"10978","2134333",0.475675087274123,11438,0.538583808719739,10545,-0.0629087214456153,893
"10979","3134333",0.43256087846062,13245,0.509789975519959,12037,-0.0772290970593393,1208
"10980","4134333",0.39108654776008,14561,0.467379600398149,13840,-0.076293052638069,721
"10981","1234333",0.484940482189316,11001,0.539654014414856,10490,-0.0547135322255398,511
"10982","2234333",0.421717309681127,13628,0.483279529774032,13207,-0.0615622200929053,421
"10983","3234333",0.378603100867623,14867,0.454485696574253,14269,-0.0758825957066293,598
"10984","4234333",0.337128770167084,15642,0.412075321452442,15362,-0.0749465512853588,280
"10985","1334333",0.45696101191254,12264,0.512603447081558,11897,-0.055642435169018,367
"10986","2334333",0.393737839404351,14483,0.456228962440734,14199,-0.0624911230363835,284
"10987","3334333",0.350623630590847,15427,0.427435129240955,15035,-0.0768114986501076,392
"10988","4334333",0.309149299890307,15964,0.385024754119145,15793,-0.0758754542288371,171
"10989","1434333",0.418024513927544,13753,0.471973943113452,13691,-0.0539494291859081,62
"10990","2434333",0.354801341419355,15352,0.415599458472629,15287,-0.0607981170532738,65
"10991","3434333",0.311687132605851,15937,0.386805625272849,15772,-0.0751184926669977,165
"10992","4434333",0.270212801905311,16219,0.344395250151039,16170,-0.0741824482457275,49
"10993","1144333",0.489864695327482,10753,0.554559799233478,9647,-0.0646951039059953,1106
"10994","2144333",0.426641522819294,13449,0.498185314592654,12574,-0.0715437917733608,875
"10995","3144333",0.38352731400579,14745,0.469391481392875,13785,-0.0858641673870849,960
"10996","4144333",0.34205298330525,15561,0.426981106271065,15043,-0.0849281229658144,518
"10997","1244333",0.435906917734486,13105,0.499255520287771,12533,-0.0633486025532851,572
"10998","2244333",0.372683745226298,14995,0.442881035646948,14637,-0.0701972904206506,358
"10999","3244333",0.329569536412794,15732,0.414087202447169,15323,-0.0845176660343747,409
"11000","4244333",0.288095205712254,16116,0.371676827325358,15959,-0.0835816216131043,157
"11001","1344333",0.40792744745771,14071,0.472204952954474,13680,-0.0642775054967633,391
"11002","2344333",0.344704274949521,15516,0.41583046831365,15281,-0.0711261933641289,235
"11003","3344333",0.301590066136018,16023,0.387036635113871,15768,-0.0854465689778529,255
"11004","4344333",0.260115735435478,16254,0.34462625999206,16168,-0.0845105245565826,86
"11005","1444333",0.368990949472714,15076,0.431575448986368,14945,-0.0625844995136535,131
"11006","2444333",0.305767776964525,15990,0.375200964345545,15921,-0.0694331873810192,69
"11007","3444333",0.262653568151022,16242,0.346407131145765,16156,-0.0837535629947433,86
"11008","4444333",0.221179237450482,16344,0.303996756023955,16325,-0.0828175185734729,19
"11009","1111433",0.744593195106429,859,0.768333742920429,794,-0.0237405478140006,65
"11010","2111433",0.68137002259824,2190,0.711959258279606,2013,-0.0305892356813662,177
"11011","3111433",0.638255813784736,3628,0.683165425079826,3004,-0.0449096112950902,624
"11012","4111433",0.596781483084196,5379,0.640755049958016,4882,-0.0439735668738198,497
"11013","1211433",0.690635417513432,1940,0.713029463974723,1983,-0.0223940464612905,-43
"11014","2211433",0.627412245005244,4023,0.6566549793339,4123,-0.0292427343286561,-100
"11015","3211433",0.58429803619174,5991,0.62786114613412,5516,-0.0435631099423801,475
"11016","4211433",0.5428237054912,8078,0.58545077101231,7862,-0.0426270655211097,216
"11017","1311433",0.662655947236656,2741,0.685978896641425,2892,-0.0233229494047688,-151
"11018","2311433",0.599432774728467,5259,0.629604412000602,5429,-0.0301716372721343,-170
"11019","3311433",0.556318565914964,7382,0.600810578800822,7015,-0.0444920128858584,367
"11020","4311433",0.514844235214424,9522,0.558400203679012,9427,-0.043555968464588,95
"11021","1411433",0.62371944925166,4193,0.645349392673319,4632,-0.0216299434216589,-439
"11022","2411433",0.560496276743471,7150,0.588974908032496,7658,-0.0284786312890246,-508
"11023","3411433",0.517382067929968,9391,0.560181074832717,9318,-0.0427990069027486,73
"11024","4411433",0.475907737229428,11432,0.517770699710906,11626,-0.0418629624814782,-194
"11025","1121433",0.676613924240009,2328,0.707764431263022,2155,-0.0311505070230138,173
"11026","2121433",0.61339075173182,4646,0.651389946622199,4347,-0.0379991948903794,299
"11027","3121433",0.570276542918316,6678,0.62259611342242,5804,-0.0523195705041034,874
"11028","4121433",0.528802212217776,8799,0.580185738300609,8177,-0.051383526082833,622
"11029","1221433",0.622656146647012,4231,0.652460152317316,4305,-0.0298040056703037,-74
"11030","2221433",0.559432974138824,7198,0.596085667676493,7285,-0.0366526935376693,-87
"11031","3221433",0.51631876532532,9452,0.567291834476713,8923,-0.0509730691513933,529
"11032","4221433",0.47484443462478,11482,0.524881459354903,11253,-0.050037024730123,229
"11033","1321433",0.594676676370236,5485,0.625409584984018,5647,-0.030732908613782,-162
"11034","2321433",0.531453503862047,8654,0.569035100343195,8831,-0.0375815964811476,-177
"11035","3321433",0.488339295048544,10838,0.540241267143415,10463,-0.0519019720948716,375
"11036","4321433",0.446864964348004,12687,0.497830892021605,12586,-0.0509659276736011,101
"11037","1421433",0.55574017838524,7413,0.584780081015912,7901,-0.0290399026306721,-488
"11038","2421433",0.492517005877051,10621,0.528405596375089,11082,-0.0358885904980378,-461
"11039","3421433",0.449402797063548,12578,0.49961176317531,12516,-0.0502089661117618,62
"11040","4421433",0.407928466363008,14070,0.457201388053499,14170,-0.0492729216904914,-100
"11041","1131433",0.633281402074909,3800,0.669299338814993,3550,-0.0360179367400846,250
"11042","2131433",0.57005822956672,6689,0.61292485417417,6337,-0.0428666246074502,352
"11043","3131433",0.526944020753217,8907,0.584131020974391,7941,-0.0571870002211742,966
"11044","4131433",0.485469690052677,10978,0.54172064585258,10374,-0.0562509557999038,604
"11045","1231433",0.579323624481913,6241,0.613995059869287,6270,-0.0346714353873745,-29
"11046","2231433",0.516100451973724,9463,0.557620575228464,9469,-0.0415201232547401,-6
"11047","3231433",0.47298624316022,11566,0.528826742028685,11062,-0.0558404988684641,504
"11048","4231433",0.43151191245968,13287,0.486416366906874,13077,-0.0549044544471937,210
"11049","1331433",0.551344154205137,7633,0.586944492535989,7781,-0.0356003383308527,-148
"11050","2331433",0.488120981696948,10848,0.530570007895166,10966,-0.0424490261982183,-118
"11051","3331433",0.445006772883444,12757,0.501776174695387,12408,-0.0567694018119423,349
"11052","4331433",0.403532442182904,14204,0.459365799573576,14108,-0.0558333573906719,96
"11053","1431433",0.512407656220141,9648,0.546314988567884,10092,-0.0339073323477429,-444
"11054","2431433",0.449184483711952,12589,0.48994050392706,12937,-0.0407560202151085,-348
"11055","3431433",0.406070274898448,14129,0.461146670727281,14045,-0.0550763958288326,84
"11056","4431433",0.364595944197908,15171,0.41873629560547,15222,-0.0541403514075622,-51
"11057","1141433",0.584247837620079,5994,0.628900844687909,5458,-0.04465300706783,536
"11058","2141433",0.52102466511189,9196,0.572526360047086,8619,-0.0515016949351956,577
"11059","3141433",0.477910456298387,11322,0.543732526847307,10251,-0.0658220705489196,1071
"11060","4141433",0.436436125597847,13078,0.501322151725496,12429,-0.0648860261276493,649
"11061","1241433",0.530290060027083,8719,0.573596565742203,8568,-0.04330650571512,151
"11062","2241433",0.467066887518894,11809,0.51722208110138,11653,-0.0501551935824855,156
"11063","3241433",0.423952678705391,13547,0.4884282479016,13003,-0.0644755691962095,544
"11064","4241433",0.382478348004851,14773,0.44601787277979,14541,-0.0635395247749391,232
"11065","1341433",0.502310589750307,10149,0.546545998408905,10083,-0.0442354086585982,66
"11066","2341433",0.439087417242118,12974,0.490171513768082,12926,-0.0510840965259637,48
"11067","3341433",0.395973208428615,14417,0.461377680568302,14038,-0.0654044721396878,379
"11068","4341433",0.354498877728075,15354,0.418967305446492,15218,-0.0644684277184174,136
"11069","1441433",0.463374091765311,11984,0.505916494440799,12206,-0.0425424026754884,-222
"11070","2441433",0.400150919257122,14296,0.449542009799976,14434,-0.049391090542854,-138
"11071","3441433",0.357036710443619,15311,0.420748176600197,15183,-0.063711466156578,128
"11072","4441433",0.315562379743079,15893,0.378337801478386,15882,-0.0627754217353075,11
"11073","1112433",0.71150828334474,1435,0.730014761391777,1532,-0.0185064780470374,-97
"11074","2112433",0.648285110836551,3255,0.673640276750954,3368,-0.025355165914403,-113
"11075","3112433",0.605170902023047,5000,0.644846443551174,4662,-0.039675541528127,338
"11076","4112433",0.563696571322507,6971,0.602436068429364,6906,-0.0387394971068566,65
"11077","1212433",0.657550505751743,2901,0.674710482446071,3331,-0.0171599766943273,-430
"11078","2212433",0.594327333243555,5499,0.618335997805248,6029,-0.0240086645616929,-530
"11079","3212433",0.551213124430051,7642,0.589542164605468,7632,-0.0383290401754169,10
"11080","4212433",0.509738793729511,9765,0.547131789483658,10049,-0.0373929957541466,-284
"11081","1312433",0.629571035474967,3930,0.647659915112773,4525,-0.0180888796378056,-595
"11082","2312433",0.566347862966778,6868,0.59128543047195,7540,-0.0249375675051712,-672
"11083","3312433",0.523233654153275,9075,0.56249159727217,9194,-0.0392579431188952,-119
"11084","4312433",0.481759323452735,11145,0.52008122215036,11491,-0.0383218986976248,-346
"11085","1412433",0.590634537489971,5654,0.607030411144667,6651,-0.0163958736546957,-997
"11086","2412433",0.527411364981782,8876,0.550655926503844,9861,-0.0232445615220614,-985
"11087","3412433",0.484297156168279,11027,0.521862093304064,11407,-0.0375649371357855,-380
"11088","4412433",0.442822825467739,12837,0.479451718182254,13356,-0.036628892714515,-519
"11089","1122433",0.64352901247832,3413,0.66944544973437,3543,-0.0259164372560506,-130
"11090","2122433",0.580305839970131,6188,0.613070965093547,6326,-0.0327651251234162,-138
"11091","3122433",0.537191631156627,8360,0.584277131893768,7934,-0.0470855007371402,426
"11092","4122433",0.495717300456087,10460,0.541866756771957,10365,-0.0461494563158699,95
"11093","1222433",0.589571234885323,5704,0.614141170788664,6260,-0.0245699359033406,-556
"11094","2222433",0.526348062377135,8938,0.557766686147841,9459,-0.0314186237707061,-521
"11095","3222433",0.483233853563631,11085,0.528972852948061,11054,-0.0457389993844302,31
"11096","4222433",0.441759522863091,12870,0.486562477826251,13072,-0.0448029549631597,-202
"11097","1322433",0.561591764608547,7083,0.587090603455366,7770,-0.0254988388468188,-687
"11098","2322433",0.498368592100358,10340,0.530716118814543,10957,-0.0323475267141844,-617
"11099","3322433",0.455254383286855,12327,0.501922285614763,12400,-0.0466679023279084,-73
"11100","4322433",0.413780052586315,13876,0.459511910492953,14101,-0.045731857906638,-225
"11101","1422433",0.522655266623551,9111,0.54646109948726,10088,-0.023805832863709,-977
"11102","2422433",0.459432094115362,12166,0.490086614846437,12931,-0.0306545207310746,-765
"11103","3422433",0.416317885301859,13802,0.461292781646658,14041,-0.0449748963447986,-239
"11104","4422433",0.374843554601319,14945,0.418882406524847,15221,-0.0440388519235282,-276
"11105","1132433",0.60019649031322,5224,0.630980357286341,5364,-0.0307838669731214,-140
"11106","2132433",0.536973317805031,8372,0.574605872645518,8515,-0.037632554840487,-143
"11107","3132433",0.493859108991528,10551,0.545812039445739,10124,-0.051952930454211,427
"11108","4132433",0.452384778290988,12448,0.503401664323928,12328,-0.0510168860329406,120
"11109","1232433",0.546238712720224,7888,0.575676078340635,8454,-0.0294373656204113,-566
"11110","2232433",0.483015540212035,11094,0.519301593699812,11542,-0.0362860534877769,-448
"11111","3232433",0.439901331398531,12947,0.490507760500032,12910,-0.0506064291015009,37
"11112","4232433",0.398427000697992,14338,0.448097385378222,14479,-0.0496703846802305,-141
"11113","1332433",0.518259242443448,9332,0.548625511007337,9973,-0.0303662685638896,-641
"11114","2332433",0.455036069935259,12337,0.492251026366514,12838,-0.0372149564312551,-501
"11115","3332433",0.411921861121755,13940,0.463457193166734,13962,-0.0515353320449791,-22
"11116","4332433",0.370447530421215,15039,0.421046818044924,15172,-0.0505992876237087,-133
"11117","1432433",0.479322744458452,11253,0.507996007039231,12115,-0.0286732625807797,-862
"11118","2432433",0.416099571950263,13812,0.451621522398408,14359,-0.0355219504481454,-547
"11119","3432433",0.372985363136759,14987,0.422827689198629,15131,-0.0498423260618694,-144
"11120","4432433",0.33151103243622,15710,0.380417314076818,15859,-0.0489062816405989,-149
"11121","1142433",0.55116292585839,7648,0.590581863159257,7570,-0.0394189373008669,78
"11122","2142433",0.487939753350202,10858,0.534207378518434,10779,-0.0462676251682325,79
"11123","3142433",0.444825544536698,12764,0.505413545318655,12231,-0.0605880007819565,533
"11124","4142433",0.403351213836158,14206,0.463003170196844,13977,-0.059651956360686,229
"11125","1242433",0.497205148265394,10403,0.535277584213551,10726,-0.0380724359481568,-323
"11126","2242433",0.433981975757205,13185,0.478903099572728,13377,-0.0449211238155223,-192
"11127","3242433",0.390867766943702,14567,0.450109266372948,14417,-0.0592414994292463,150
"11128","4242433",0.349393436243162,15446,0.407698891251138,15450,-0.058305455007976,-4
"11129","1342433",0.469225677988618,11731,0.508227016880253,12102,-0.039001338891635,-371
"11130","2342433",0.406002505480429,14130,0.45185253223943,14353,-0.0458500267590006,-223
"11131","3342433",0.362888296666926,15209,0.42305869903965,15127,-0.0601704023727246,82
"11132","4342433",0.321413965966386,15830,0.38064832391784,15851,-0.0592343579514541,-21
"11133","1442433",0.430289180003622,13333,0.467597512912147,13836,-0.0373083329085251,-503
"11134","2442433",0.367066007495433,15121,0.411223028271324,15377,-0.0441570207758908,-256
"11135","3442433",0.32395179868193,15802,0.382429195071545,15828,-0.0584773963896147,-26
"11136","4442433",0.28247746798139,16153,0.340018819949734,16194,-0.0575413519683443,-41
"11137","1113433",0.672625107772254,2425,0.704518171002538,2262,-0.0318930632302841,163
"11138","2113433",0.609401935264065,4828,0.648143686361715,4495,-0.0387417510976497,333
"11139","3113433",0.566287726450562,6875,0.619349853161935,5977,-0.0530621267113737,898
"11140","4113433",0.524813395750022,9007,0.576939478040125,8376,-0.0521260822901032,631
"11141","1213433",0.618667330179258,4394,0.649213892056832,4448,-0.0305465618775739,-54
"11142","2213433",0.555444157671069,7430,0.592839407416008,7466,-0.0373952497449395,-36
"11143","3213433",0.512329948857566,9654,0.564045574216229,9103,-0.0517156253586635,551
"11144","4213433",0.470855618157025,11655,0.521635199094419,11414,-0.0507795809373932,241
"11145","1313433",0.590687859902482,5646,0.622163324723534,5823,-0.0314754648210521,-177
"11146","2313433",0.527464687394293,8871,0.565788840082711,8999,-0.0383241526884177,-128
"11147","3313433",0.484350478580789,11022,0.536995006882931,10637,-0.0526445283021417,385
"11148","4313433",0.442876147880249,12832,0.494584631761121,12733,-0.0517084838808714,99
"11149","1413433",0.551751361917486,7612,0.581533820755428,8102,-0.0297824588379423,-490
"11150","2413433",0.488528189409297,10826,0.525159336114605,11239,-0.036631146705308,-413
"11151","3413433",0.445413980595793,12738,0.496365502914825,12654,-0.0509515223190319,84
"11152","4413433",0.403939649895253,14197,0.453955127793015,14288,-0.0500154778977617,-91
"11153","1123433",0.604645836905834,5021,0.643948859345131,4705,-0.0393030224392973,316
"11154","2123433",0.541422664397645,8151,0.587574374704308,7736,-0.0461517103066629,415
"11155","3123433",0.498308455584142,10345,0.558780541504528,9410,-0.0604720859203869,935
"11156","4123433",0.456834124883602,12267,0.516370166382718,11698,-0.0595360414991164,569
"11157","1223433",0.550688059312838,7667,0.588644580399425,7678,-0.0379565210865871,-11
"11158","2223433",0.487464886804649,10882,0.532270095758602,10879,-0.0448052089539527,3
"11159","3223433",0.444350677991146,12783,0.503476262558822,12321,-0.0591255845676767,462
"11160","4223433",0.402876347290606,14217,0.461065887437012,14048,-0.0581895401464064,169
"11161","1323433",0.522708589036062,9107,0.561594013066127,9238,-0.0388854240300653,-131
"11162","2323433",0.459485416527873,12163,0.505219528425304,12237,-0.0457341118974309,-74
"11163","3323433",0.416371207714369,13799,0.476425695225524,13495,-0.0600544875111549,304
"11164","4323433",0.374896877013829,14943,0.434015320103714,14865,-0.0591184430898846,78
"11165","1423433",0.483772091051066,11063,0.520964509098021,11445,-0.0371924180469555,-382
"11166","2423433",0.420548918542877,13670,0.464590024457198,13932,-0.0440411059143211,-262
"11167","3423433",0.377434709729373,14899,0.435796191257419,14825,-0.0583614815280452,74
"11168","4423433",0.335960379028833,15655,0.393385816135608,15678,-0.0574254371067748,-23
"11169","1133433",0.561313314740734,7102,0.605483766897102,6739,-0.0441704521563679,363
"11170","2133433",0.498090142232546,10361,0.549109282256279,9946,-0.0510191400237335,415
"11171","3133433",0.454975933419042,12344,0.5203154490565,11480,-0.0653395156374575,864
"11172","4133433",0.413501602718502,13884,0.477905073934689,13425,-0.0644034712161872,459
"11173","1233433",0.507355537147738,9884,0.550179487951396,9886,-0.042823950803658,-2
"11174","2233433",0.444132364639549,12800,0.493805003310573,12765,-0.0496726386710235,35
"11175","3233433",0.401018155826046,14279,0.465011170110793,13924,-0.0639930142847475,355
"11176","4233433",0.359543825125506,15267,0.422600794988983,15136,-0.063056969863477,131
"11177","1333433",0.479376066870962,11247,0.523128920618098,11342,-0.0437528537471362,-95
"11178","2333433",0.416152894362773,13808,0.466754435977275,13860,-0.0506015416145018,-52
"11179","3333433",0.37303868554927,14983,0.437960602777495,14760,-0.0649219172282258,223
"11180","4333433",0.33156435484873,15707,0.395550227655685,15651,-0.0639858728069552,56
"11181","1433433",0.440439568885966,12928,0.482499416649992,13233,-0.0420598477640263,-305
"11182","2433433",0.377216396377777,14904,0.426124932009169,15058,-0.048908535631392,-154
"11183","3433433",0.334102187564274,15678,0.39733109880939,15629,-0.0632289112451159,49
"11184","4433433",0.292627856863734,16088,0.354920723687579,16094,-0.0622928668238453,-6
"11185","1143433",0.512279750285905,9661,0.565085272770018,9037,-0.0528055224841135,624
"11186","2143433",0.449056577777716,12594,0.508710788129195,12079,-0.0596542103514791,515
"11187","3143433",0.405942368964212,14135,0.479916954929415,13342,-0.0739745859652031,793
"11188","4143433",0.364468038263673,15174,0.437506579807605,14772,-0.0730385415439326,402
"11189","1243433",0.458321972692909,12219,0.509780993824312,12038,-0.0514590211314033,181
"11190","2243433",0.39509880018472,14447,0.453406509183489,14303,-0.0583077089987689,144
"11191","3243433",0.351984591371216,15406,0.424612675983709,15094,-0.0726280846124929,312
"11192","4243433",0.310510260670676,15951,0.382202300861899,15831,-0.0716920401912225,120
"11193","1343433",0.430342502416133,13329,0.482730426491014,13227,-0.0523879240748815,102
"11194","2343433",0.367119329907944,15119,0.426355941850191,15050,-0.0592366119422471,69
"11195","3343433",0.32400512109444,15801,0.397562108650411,15625,-0.073556987555971,176
"11196","4343433",0.2825307903939,16152,0.355151733528601,16092,-0.0726209431347006,60
"11197","1443433",0.391406004431137,14558,0.442100922522908,14657,-0.0506949180917717,-99
"11198","2443433",0.328182831922948,15756,0.385726437882085,15785,-0.0575436059591373,-29
"11199","3443433",0.285068623109444,16137,0.356932604682306,16084,-0.0718639815728612,53
"11200","4443433",0.243594292408904,16309,0.314522229560495,16293,-0.0709279371515909,16
"11201","1114433",0.620418035801684,4321,0.659867557628882,3977,-0.039449521827198,344
"11202","2114433",0.557194863293495,7334,0.603493072988059,6850,-0.0462982096945636,484
"11203","3114433",0.514080654479992,9562,0.574699239788279,8510,-0.0606185853082876,1052
"11204","4114433",0.472606323779452,11587,0.532288864666469,10876,-0.0596825408870172,711
"11205","1214433",0.566460258208688,6862,0.604563278683176,6804,-0.0381030204744879,58
"11206","2214433",0.503237085700499,10105,0.548188794042353,10000,-0.0449517083418535,105
"11207","3214433",0.460122876886996,12135,0.519394960842573,11536,-0.0592720839555775,599
"11208","4214433",0.418648546186456,13735,0.476984585720763,13471,-0.058336039534307,264
"11209","1314433",0.538480787931912,8301,0.577512711349878,8349,-0.0390319234179661,-48
"11210","2314433",0.475257615423723,11454,0.521138226709055,11437,-0.0458806112853317,17
"11211","3314433",0.43214340661022,13261,0.492344393509275,12835,-0.0602009868990557,426
"11212","4314433",0.39066907590968,14572,0.449934018387465,14421,-0.0592649424777853,151
"11213","1414433",0.499544289946916,10288,0.536883207381772,10644,-0.0373389174348563,-356
"11214","2414433",0.436321117438727,13085,0.480508722740949,13318,-0.0441876053022219,-233
"11215","3414433",0.393206908625224,14498,0.45171488954117,14357,-0.058507980915946,141
"11216","4414433",0.351732577924684,15412,0.409304514419359,15418,-0.0575719364946756,-6
"11217","1124433",0.552438764935264,7571,0.599298245971475,7096,-0.0468594810362112,475
"11218","2124433",0.489215592427075,10787,0.542923761330652,10291,-0.0537081689035768,496
"11219","3124433",0.446101383613572,12712,0.514129928130873,11822,-0.0680285445173008,890
"11220","4124433",0.404627052913032,14177,0.471719553009062,13697,-0.0670925000960303,480
"11221","1224433",0.498480987342268,10334,0.543993967025769,10237,-0.0455129796835011,97
"11222","2224433",0.435257814834079,13133,0.487619482384946,13030,-0.0523616675508666,103
"11223","3224433",0.392143606020576,14533,0.458825649185166,14123,-0.0666820431645906,410
"11224","4224433",0.350669275320036,15425,0.416415274063356,15272,-0.0657459987433203,153
"11225","1324433",0.470501517065492,11667,0.516943399692471,11670,-0.0464418826269793,-3
"11226","2324433",0.407278344557303,14091,0.460568915051648,14062,-0.0532905704943449,29
"11227","3324433",0.3641641357438,15179,0.431775081851868,14937,-0.0676109461080689,242
"11228","4324433",0.32268980504326,15816,0.389364706730058,15738,-0.0666749016867984,78
"11229","1424433",0.431565019080496,13284,0.476313895724365,13499,-0.0447488766438695,-215
"11230","2424433",0.368341846572307,15090,0.419939411083542,15201,-0.0515975645112351,-111
"11231","3424433",0.325227637758804,15787,0.391145577883763,15715,-0.065917940124959,72
"11232","4424433",0.283753307058264,16144,0.348735202761952,16141,-0.0649818957036886,3
"11233","1134433",0.509106242770165,9795,0.560833153523447,9275,-0.051726910753282,520
"11234","2134433",0.445883070261976,12723,0.504458668882623,12275,-0.0585755986206475,448
"11235","3134433",0.402768861448472,14224,0.475664835682844,13524,-0.0728959742343715,700
"11236","4134433",0.361294530747932,15235,0.433254460561033,14885,-0.0719599298131011,350
"11237","1234433",0.455148465177168,12331,0.50552887457774,12225,-0.0503804094005719,106
"11238","2234433",0.39192529266898,14545,0.449154389936917,14445,-0.0572290972679374,100
"11239","3234433",0.348811083855476,15457,0.420360556737138,15195,-0.0715494728816614,262
"11240","4234433",0.307336753154936,15976,0.377950181615327,15889,-0.0706134284603909,87
"11241","1334433",0.427168994900392,13429,0.478478307244442,13396,-0.0513093123440501,33
"11242","2334433",0.363945822392203,15184,0.422103822603619,15143,-0.0581580002114157,41
"11243","3334433",0.3208316135787,15836,0.39330998940384,15681,-0.0724783758251396,155
"11244","4334433",0.27935728287816,16168,0.350899614282029,16127,-0.0715423314038691,41
"11245","1434433",0.388232496915396,14629,0.437848803276337,14765,-0.0496163063609402,-136
"11246","2434433",0.325009324407208,15791,0.381474318635513,15839,-0.0564649942283058,-48
"11247","3434433",0.281895115593704,16157,0.352680485435734,16115,-0.0707853698420297,42
"11248","4434433",0.240420784893164,16314,0.310270110313923,16312,-0.0698493254207595,2
"11249","1144433",0.460072678315335,12140,0.520434659396362,11474,-0.0603619810810274,666
"11250","2144433",0.396849505807146,14393,0.464060174755539,13944,-0.067210668948393,449
"11251","3144433",0.353735296993643,15368,0.43526634155576,14839,-0.081531044562117,529
"11252","4144433",0.312260966293103,15930,0.392855966433949,15686,-0.0805950001408465,244
"11253","1244433",0.406114900722339,14128,0.465130380450656,13919,-0.0590154797283173,209
"11254","2244433",0.34289172821415,15547,0.408755895809833,15430,-0.0658641675956829,117
"11255","3244433",0.299777519400647,16043,0.379962062610053,15868,-0.0801845432094068,175
"11256","4244433",0.258303188700107,16262,0.337551687488243,16210,-0.0792484987881363,52
"11257","1344433",0.378135430445563,14883,0.438079813117358,14757,-0.0599443826717955,126
"11258","2344433",0.314912257937374,15897,0.381705328476535,15835,-0.066793070539161,62
"11259","3344433",0.27179804912387,16213,0.352911495276755,16112,-0.0811134461528849,101
"11260","4344433",0.23032371842333,16330,0.310501120154945,16310,-0.0801774017316147,20
"11261","1444433",0.339198932460567,15613,0.397450309149252,15627,-0.0582513766886856,-14
"11262","2444433",0.275975759952378,16189,0.341075824508429,16187,-0.0651000645560512,2
"11263","3444433",0.232861551138874,16326,0.31228199130865,16303,-0.0794204401697753,23
"11264","4444433",0.191387220438334,16373,0.269871616186839,16371,-0.0784843957485049,2
"11265","1111143",0.80763015659477,262,0.826455133324125,237,-0.0188249767293552,25
"11266","2111143",0.744406984086581,861,0.770080648683302,773,-0.0256736645967208,88
"11267","3111143",0.701292775273077,1668,0.741286815483522,1284,-0.0399940402104448,384
"11268","4111143",0.659818444572537,2816,0.698876440361712,2443,-0.0390579957891743,373
"11269","1211143",0.753672379001774,740,0.771150854378419,753,-0.017478475376645,-13
"11270","2211143",0.690449206493585,1944,0.714776369737595,1941,-0.0243271632440106,3
"11271","3211143",0.647334997680081,3290,0.685982536537816,2891,-0.0386475388577346,399
"11272","4211143",0.605860666979541,4978,0.643572161416006,4728,-0.0377114944364644,250
"11273","1311143",0.725692908724997,1166,0.744100287045121,1228,-0.0184073783201233,-62
"11274","2311143",0.662469736216809,2746,0.687725802404297,2819,-0.0252560661874889,-73
"11275","3311143",0.619355527403305,4369,0.658931969204518,4016,-0.0395764418012129,353
"11276","4311143",0.577881196702765,6300,0.616521594082708,6139,-0.0386403973799426,161
"11277","1411143",0.686756410740001,2030,0.703470783077015,2298,-0.0167143723370135,-268
"11278","2411143",0.623533238231813,4203,0.647096298436192,4552,-0.0235630602043791,-349
"11279","3411143",0.580419029418309,6180,0.618302465236412,6030,-0.0378834358181032,150
"11280","4411143",0.538944698717769,8281,0.575892090114602,8432,-0.0369473913968329,-151
"11281","1121143",0.73965088572835,930,0.765885821666718,844,-0.0262349359383685,86
"11282","2121143",0.676427713220161,2331,0.709511337025895,2098,-0.033083623805734,233
"11283","3121143",0.633313504406657,3798,0.680717503826115,3100,-0.0474039994194581,698
"11284","4121143",0.591839173706117,5590,0.638307128704305,5026,-0.0464679549981876,564
"11285","1221143",0.685693108135354,2065,0.710581542721012,2066,-0.0248884345856583,-1
"11286","2221143",0.622469935627165,4245,0.654207058080189,4230,-0.0317371224530238,15
"11287","3221143",0.579355726813661,6239,0.625413224880409,5645,-0.0460574980667479,594
"11288","4221143",0.537881396113121,8336,0.583002849758599,8020,-0.0451214536454776,316
"11289","1321143",0.657713637858578,2895,0.683530975387714,2985,-0.0258173375291365,-90
"11290","2321143",0.594490465350389,5493,0.627156490746891,5552,-0.0326660253965021,-59
"11291","3321143",0.551376256536885,7628,0.598362657547111,7153,-0.0469864010102261,475
"11292","4321143",0.509901925836345,9761,0.555952282425301,9581,-0.0460503565889558,180
"11293","1421143",0.618777139873582,4388,0.642901471419608,4764,-0.0241243315460267,-376
"11294","2421143",0.555553967365393,7423,0.586526986778785,7805,-0.0309730194133924,-382
"11295","3421143",0.512439758551889,9647,0.557733153579006,9460,-0.0452933950271164,187
"11296","4421143",0.470965427851349,11649,0.515322778457195,11757,-0.0443573506058461,-108
"11297","1131143",0.69631836356325,1788,0.727420729218689,1600,-0.0311023656554391,188
"11298","2131143",0.633095191055061,3807,0.671046244577866,3470,-0.0379510535228047,337
"11299","3131143",0.589980982241558,5689,0.642252411378087,4802,-0.0522714291365287,887
"11300","4131143",0.548506651541018,7761,0.599842036256276,7064,-0.0513353847152584,697
"11301","1231143",0.642360585970254,3469,0.672116450272983,3432,-0.0297558643027291,37
"11302","2231143",0.579137413462065,6250,0.61574196563216,6177,-0.0366045521700947,73
"11303","3231143",0.536023204648562,8421,0.58694813243238,7780,-0.0509249277838187,641
"11304","4231143",0.494548873948022,10517,0.54453775731057,10204,-0.0499888833625483,313
"11305","1331143",0.614381115693478,4590,0.645065882939685,4649,-0.0306847672462074,-59
"11306","2331143",0.551157943185289,7649,0.588691398298862,7671,-0.037533455113573,-22
"11307","3331143",0.508043734371785,9855,0.559897565099082,9343,-0.051853830727297,512
"11308","4331143",0.466569403671246,11834,0.517487189977272,11639,-0.0509177863060265,195
"11309","1431143",0.575444617708482,6402,0.604436378971579,6810,-0.0289917612630975,-408
"11310","2431143",0.512221445200293,9662,0.548061894330756,10006,-0.0358404491304632,-344
"11311","3431143",0.469107236386789,11736,0.519268061130977,11544,-0.0501608247441873,192
"11312","4431143",0.42763290568625,13408,0.476857686009166,13476,-0.0492247803229167,-68
"11313","1141143",0.64728479910842,3292,0.687022235091605,2853,-0.0397374359831847,439
"11314","2141143",0.584061626600232,5998,0.630647750450782,5374,-0.0465861238505503,624
"11315","3141143",0.540947417786728,8179,0.601853917251002,6940,-0.0609064994642743,1239
"11316","4141143",0.499473087086188,10292,0.559443542129192,9364,-0.0599704550430038,928
"11317","1241143",0.593327021515424,5539,0.631717956145899,5331,-0.0383909346304745,208
"11318","2241143",0.530103849007236,8727,0.575343471505076,8469,-0.0452396224978401,258
"11319","3241143",0.486989640193732,10907,0.546549638305296,10082,-0.0595599981115641,825
"11320","4241143",0.445515309493192,12730,0.504139263183486,12292,-0.0586239536902938,438
"11321","1341143",0.565347551238648,6921,0.604667388812601,6795,-0.0393198375739527,126
"11322","2341143",0.502124378730459,10158,0.548292904171778,9991,-0.0461685254413183,167
"11323","3341143",0.459010169916956,12189,0.519499070971998,11529,-0.0604889010550423,660
"11324","4341143",0.417535839216416,13769,0.477088695850188,13468,-0.059552856633772,301
"11325","1441143",0.526411053253652,8936,0.564037884844495,9105,-0.0376268315908429,-169
"11326","2441143",0.463187880745463,11992,0.507663400203672,12134,-0.0444755194582086,-142
"11327","3441143",0.42007367193196,13690,0.478869567003893,13380,-0.0587958950719327,310
"11328","4441143",0.37859934123142,14868,0.436459191882082,14803,-0.0578598506506623,65
"11329","1112143",0.774545244833081,508,0.788136151795473,542,-0.0135909069623921,-34
"11330","2112143",0.711322072324892,1444,0.73176166715465,1500,-0.0204395948297577,-56
"11331","3112143",0.668207863511388,2568,0.70296783395487,2319,-0.0347599704434817,249
"11332","4112143",0.626733532810849,4046,0.66055745883306,3948,-0.0338239260222112,98
"11333","1212143",0.720587467240085,1266,0.732831872849767,1471,-0.0122444056096819,-205
"11334","2212143",0.657364294731896,2914,0.676457388208943,3277,-0.0190930934770475,-363
"11335","3212143",0.614250085918392,4597,0.647663555009164,4524,-0.0334134690907715,73
"11336","4212143",0.572775755217852,6541,0.605253179887353,6759,-0.0324774246695012,-218
"11337","1312143",0.692607996963309,1888,0.705781305516469,2223,-0.0131733085531601,-335
"11338","2312143",0.62938482445512,3942,0.649406820875645,4440,-0.0200219964205257,-498
"11339","3312143",0.586270615641616,5869,0.620612987675866,5908,-0.0343423720342497,-39
"11340","4312143",0.544796284941076,7972,0.578202612554056,8309,-0.0334063276129795,-337
"11341","1412143",0.653671498978313,3047,0.665151801548363,3741,-0.0114803025700503,-694
"11342","2412143",0.590448326470124,5669,0.60877731690754,6568,-0.018328990437416,-899
"11343","3412143",0.54733411765662,7824,0.57998348370776,8198,-0.03264936605114,-374
"11344","4412143",0.50585978695608,9954,0.53757310858595,10607,-0.0317133216298697,-653
"11345","1122143",0.706565973966661,1555,0.727566840138066,1597,-0.0210008661714053,-42
"11346","2122143",0.643342801458472,3423,0.671192355497243,3463,-0.0278495540387709,-40
"11347","3122143",0.600228592644968,5219,0.642398522297463,4792,-0.0421699296524949,427
"11348","4122143",0.558754261944429,7234,0.599988147175653,7059,-0.0412338852312244,175
"11349","1222143",0.652608196373665,3095,0.67226256119236,3430,-0.0196543648186951,-335
"11350","2222143",0.589385023865476,5717,0.615888076551537,6175,-0.0265030526860607,-458
"11351","3222143",0.546270815051972,7887,0.587094243351757,7769,-0.0408234282997847,118
"11352","4222143",0.504796484351432,10014,0.544683868229947,10196,-0.0398873838785144,-182
"11353","1322143",0.624628726096889,4146,0.645211993859062,4642,-0.0205832677621733,-496
"11354","2322143",0.5614055535887,7092,0.588837509218239,7666,-0.0274319556295389,-574
"11355","3322143",0.518291344775196,9327,0.560043676018459,9330,-0.0417523312432629,-3
"11356","4322143",0.476817014074656,11382,0.517633300896649,11633,-0.0408162868219927,-251
"11357","1422143",0.585692228111893,5905,0.604582489890956,6799,-0.0188902617790635,-894
"11358","2422143",0.522469055603704,9122,0.548208005250133,9998,-0.0257389496464292,-876
"11359","3422143",0.4793548467902,11250,0.519414172050353,11534,-0.0400593252601532,-284
"11360","4422143",0.43788051608966,13020,0.477003796928543,13470,-0.0391232808388829,-450
"11361","1132143",0.663233451801561,2726,0.689101747690037,2770,-0.0258682958884759,-44
"11362","2132143",0.600010279293372,5233,0.632727263049214,5281,-0.0327169837558415,-48
"11363","3132143",0.556896070479869,7349,0.603933429849434,6829,-0.0470373593695655,520
"11364","4132143",0.515421739779329,9499,0.561523054727624,9241,-0.0461013149482953,258
"11365","1232143",0.609275674208565,4838,0.633797468744331,5232,-0.024521794535766,-394
"11366","2232143",0.546052501700376,7902,0.577422984103508,8354,-0.0313704824031316,-452
"11367","3232143",0.502938292886873,10120,0.548629150903728,9972,-0.0456908580168556,148
"11368","4232143",0.461463962186333,12069,0.506218775781918,12198,-0.0447548135955851,-129
"11369","1332143",0.581296203931789,6131,0.606746901411033,6659,-0.0254506974792442,-528
"11370","2332143",0.5180730314236,9346,0.55037241677021,9874,-0.0322993853466098,-528
"11371","3332143",0.474958822610096,11473,0.52157858357043,11417,-0.0466197609603338,56
"11372","4332143",0.433484491909557,13212,0.47916820844862,13369,-0.0456837165390633,-157
"11373","1432143",0.542359705946793,8103,0.566117397442927,8983,-0.0237576914961344,-880
"11374","2432143",0.479136533438604,11268,0.509742912802104,12039,-0.0306063793635001,-771
"11375","3432143",0.4360223246251,13100,0.480949079602325,13300,-0.044926754977224,-200
"11376","4432143",0.39454799392456,14464,0.438538704480514,14747,-0.0439907105559537,-283
"11377","1142143",0.614199887346732,4598,0.648703253562953,4463,-0.0345033662162215,135
"11378","2142143",0.550976714838543,7656,0.59232876892213,7486,-0.0413520540835871,170
"11379","3142143",0.507862506025039,9863,0.56353493572235,9128,-0.0556724296973111,735
"11380","4142143",0.466388175324499,11842,0.52112456060054,11438,-0.0547363852760406,404
"11381","1242143",0.560242109753736,7163,0.593398974617247,7438,-0.0331568648635113,-275
"11382","2242143",0.497018937245547,10411,0.537024489976424,10635,-0.0400055527308769,-224
"11383","3242143",0.453904728432043,12393,0.508230656776644,12100,-0.0543259283446009,293
"11384","4242143",0.412430397731503,13924,0.465820281654834,13899,-0.0533898839233306,25
"11385","1342143",0.532262639476959,8606,0.566348407283949,8973,-0.0340857678069896,-367
"11386","2342143",0.46903946696877,11737,0.509973922643126,12028,-0.0409344556743552,-291
"11387","3342143",0.425925258155267,13477,0.481180089443346,13285,-0.0552548312880792,192
"11388","4342143",0.384450927454727,14719,0.438769714321536,14742,-0.0543187868668089,-23
"11389","1442143",0.493326141491963,10577,0.525718903315843,11214,-0.0323927618238797,-637
"11390","2442143",0.430102968983775,13340,0.46934441867502,13786,-0.0392414496912454,-446
"11391","3442143",0.386988760170271,14657,0.44055058547524,14696,-0.0535618253049695,-39
"11392","4442143",0.345514429469731,15500,0.39814021035343,15615,-0.0526257808836991,-115
"11393","1113143",0.735662069260595,1002,0.762639561406234,898,-0.0269774921456387,104
"11394","2113143",0.672438896752406,2433,0.70626507676541,2210,-0.0338261800130043,223
"11395","3113143",0.629324687938903,3947,0.677471243565631,3227,-0.0481465556267283,720
"11396","4113143",0.587850357238363,5780,0.635060868443821,5174,-0.0472105112054578,606
"11397","1213143",0.681704291667599,2178,0.707335282460528,2170,-0.0256309907929285,8
"11398","2213143",0.61848111915941,4408,0.650960797819704,4370,-0.0324796786602941,38
"11399","3213143",0.575366910345907,6407,0.622166964619925,5821,-0.0468000542740181,586
"11400","4213143",0.533892579645367,8513,0.579756589498114,8211,-0.0458640098527479,302
"11401","1313143",0.653724821390823,3044,0.68028471512723,3124,-0.0265598937364068,-80
"11402","2313143",0.590501648882634,5664,0.623910230486406,5728,-0.0334085816037724,-64
"11403","3313143",0.547387440069131,7820,0.595116397286627,7337,-0.0477289572174964,483
"11404","4313143",0.50591310936859,9951,0.552706022164817,9763,-0.0467929127962261,188
"11405","1413143",0.614788323405827,4563,0.639655211159124,4940,-0.0248668877532969,-377
"11406","2413143",0.551565150897638,7621,0.583280726518301,7994,-0.0317155756206626,-373
"11407","3413143",0.508450942084135,9828,0.554486893318521,9653,-0.0460359512343866,175
"11408","4413143",0.466976611383594,11814,0.512076518196711,11927,-0.0450999068131164,-113
"11409","1123143",0.667682798394175,2582,0.702070249748827,2358,-0.0343874513546519,224
"11410","2123143",0.604459625885986,5033,0.645695765108004,4622,-0.0412361392220175,411
"11411","3123143",0.561345417072483,7098,0.616901931908224,6113,-0.0555565148357415,985
"11412","4123143",0.519871086371943,9240,0.574491556786414,8521,-0.054620470414471,719
"11413","1223143",0.613725020801179,4627,0.646765970803121,4573,-0.0330409500019417,54
"11414","2223143",0.55050184829299,7679,0.590391486162298,7579,-0.0398896378693073,100
"11415","3223143",0.507387639479487,9880,0.561597652962518,9237,-0.0542100134830313,643
"11416","4223143",0.465913308778947,11862,0.519187277840708,11547,-0.0532739690617611,315
"11417","1323143",0.585745550524403,5902,0.619715403469823,5959,-0.03396985294542,-57
"11418","2323143",0.522522378016214,9116,0.563340918829,9142,-0.0408185408127856,-26
"11419","3323143",0.479408169202711,11244,0.53454708562922,10761,-0.0551389164265096,483
"11420","4323143",0.43793383850217,13016,0.49213671050741,12847,-0.0542028720052393,169
"11421","1423143",0.546809052539407,7858,0.579085899501717,8252,-0.0322768469623101,-394
"11422","2423143",0.483585880031218,11070,0.522711414860894,11360,-0.0391255348296758,-290
"11423","3423143",0.440471671217715,12927,0.493917581661114,12758,-0.0534459104433998,169
"11424","4423143",0.398997340517175,14325,0.451507206539304,14361,-0.0525098660221295,-36
"11425","1133143",0.624350276229076,4166,0.663605157300798,3814,-0.0392548810717226,352
"11426","2133143",0.561127103720887,7115,0.607230672659975,6641,-0.0461035689390882,474
"11427","3133143",0.518012894907383,9350,0.578436839460195,8292,-0.0604239445528122,1058
"11428","4133143",0.476538564206843,11398,0.536026464338385,10683,-0.0594879001315419,715
"11429","1233143",0.570392498636079,6671,0.608300878355092,6589,-0.0379083797190126,82
"11430","2233143",0.50716932612789,9894,0.551926393714269,9797,-0.0447570675863782,97
"11431","3233143",0.464055117314387,11954,0.523132560514489,11341,-0.0590774432001022,613
"11432","4233143",0.422580786613847,13594,0.480722185392679,13311,-0.0581413987788317,283
"11433","1333143",0.542413028359303,8101,0.581250311021794,8121,-0.0388372826624909,-20
"11434","2333143",0.479189855851114,11264,0.524875826380971,11254,-0.0456859705298565,10
"11435","3333143",0.436075647037611,13097,0.496081993181191,12666,-0.0600063461435804,431
"11436","4333143",0.394601316337071,14462,0.453671618059381,14296,-0.0590703017223099,166
"11437","1433143",0.503476530374307,10092,0.540620807053688,10446,-0.037144276679381,-354
"11438","2433143",0.440253357866118,12934,0.484246322412865,13172,-0.0439929645467467,-238
"11439","3433143",0.397139149052615,14382,0.455452489213086,14231,-0.0583133401604707,151
"11440","4433143",0.355664818352075,15340,0.413042114091275,15348,-0.0573772957392002,-8
"11441","1143143",0.575316711774246,6413,0.623206663173714,5772,-0.0478899513994682,641
"11442","2143143",0.512093539266057,9667,0.566832178532891,8950,-0.0547386392668338,717
"11443","3143143",0.468979330452554,11741,0.538038345333111,10576,-0.0690590148805578,1165
"11444","4143143",0.427504999752014,13411,0.495627970211301,12685,-0.0681229704592872,726
"11445","1243143",0.52135893418125,9180,0.567902384228008,8892,-0.046543450046758,288
"11446","2243143",0.458135761673061,12226,0.511527899587185,11956,-0.0533921379141236,270
"11447","3243143",0.415021552859558,13846,0.482734066387405,13226,-0.0677125135278475,620
"11448","4243143",0.373547222159017,14974,0.440323691265595,14704,-0.0667764691065773,270
"11449","1343143",0.493379463904474,10573,0.54085181689471,10431,-0.0474723529902362,142
"11450","2343143",0.430156291396285,13337,0.484477332253887,13161,-0.0543210408576018,176
"11451","3343143",0.387042082582781,14655,0.455683499054107,14224,-0.0686414164713258,431
"11452","4343143",0.345567751882241,15499,0.413273123932297,15345,-0.0677053720500555,154
"11453","1443143",0.454442965919478,12365,0.500222312926604,12484,-0.0457793470071264,-119
"11454","2443143",0.391219793411289,14559,0.443847828285781,14608,-0.052628034874492,-49
"11455","3443143",0.348105584597785,15467,0.415053995086001,15299,-0.066948410488216,168
"11456","4443143",0.306631253897245,15982,0.372643619964191,15950,-0.0660123660669457,32
"11457","1114143",0.683454997290025,2124,0.717988948032578,1863,-0.0345339507425525,261
"11458","2114143",0.620231824781837,4327,0.661614463391755,3908,-0.0413826386099181,419
"11459","3114143",0.577117615968333,6332,0.632820630191975,5277,-0.0557030142236421,1055
"11460","4114143",0.535643285267793,8433,0.590410255070165,7578,-0.0547669698023718,855
"11461","1214143",0.629497219697029,3939,0.662684669086872,3851,-0.0331874493898425,88
"11462","2214143",0.56627404718884,6878,0.606310184446048,6682,-0.0400361372572081,196
"11463","3214143",0.523159838375337,9081,0.577516351246269,8348,-0.0543565128709321,733
"11464","4214143",0.481685507674797,11149,0.535105976124459,10731,-0.0534204684496616,418
"11465","1314143",0.601517749420253,5157,0.635634101753574,5138,-0.0341163523333208,19
"11466","2314143",0.538294576912064,8312,0.57925961711275,8238,-0.0409650402006864,74
"11467","3314143",0.495180368098561,10486,0.550465783912971,9872,-0.0552854158144104,614
"11468","4314143",0.453706037398021,12399,0.508055408791161,12110,-0.0543493713931399,289
"11469","1414143",0.562581251435257,7032,0.595004597785468,7344,-0.0324233463502109,-312
"11470","2414143",0.499358078927068,10298,0.538630113144645,10542,-0.0392720342175766,-244
"11471","3414143",0.456243870113565,12293,0.509836279944865,12033,-0.0535924098313006,260
"11472","4414143",0.414769539413025,13854,0.467425904823055,13839,-0.0526563654100302,15
"11473","1124143",0.615475726423605,4528,0.657419636375171,4086,-0.0419439099515657,442
"11474","2124143",0.552252553915417,7584,0.601045151734348,6995,-0.0487925978189313,589
"11475","3124143",0.509138345101913,9792,0.572251318534568,8638,-0.0631129734326553,1154
"11476","4124143",0.467664014401373,11789,0.529840943412758,11010,-0.062176929011385,779
"11477","1224143",0.561517948830609,7088,0.602115357429465,6928,-0.0405974085988557,160
"11478","2224143",0.49829477632242,10346,0.545740872788642,10127,-0.0474460964662213,219
"11479","3224143",0.455180567508917,12330,0.516947039588862,11669,-0.0617664720799453,661
"11480","4224143",0.413706236808377,13878,0.474536664467052,13576,-0.0608304276586749,302
"11481","1324143",0.533538478553833,8535,0.575064790096167,8484,-0.041526311542334,51
"11482","2324143",0.470315306045644,11675,0.518690305455344,11575,-0.0483749994096996,100
"11483","3324143",0.427201097232141,13426,0.489896472255564,12940,-0.0626953750234235,486
"11484","4324143",0.385726766531601,14684,0.447486097133754,14501,-0.0617593306021532,183
"11485","1424143",0.494601980568837,10516,0.534435286128061,10768,-0.0398333055592242,-252
"11486","2424143",0.431378808060648,13289,0.478060801487238,13419,-0.0466819934265898,-130
"11487","3424143",0.388264599247145,14628,0.449266968287459,14441,-0.0610023690403138,187
"11488","4424143",0.346790268546605,15478,0.406856593165648,15467,-0.0600663246190434,11
"11489","1134143",0.572143204258506,6584,0.618954543927142,5995,-0.0468113396686366,589
"11490","2134143",0.508920031750317,9806,0.562580059286319,9187,-0.0536600275360022,619
"11491","3134143",0.465805822936813,11866,0.53378622608654,10804,-0.0679804031497262,1062
"11492","4134143",0.424331492236273,13537,0.491375850964729,12870,-0.0670443587284558,667
"11493","1234143",0.51818542666551,9339,0.563650264981436,9123,-0.0454648383159264,216
"11494","2234143",0.454962254157321,12346,0.507275780340613,12149,-0.052313526183292,197
"11495","3234143",0.411848045343817,13944,0.478481947140833,13395,-0.0666339017970161,549
"11496","4234143",0.370373714643277,15043,0.436071572019023,14820,-0.0656978573757457,223
"11497","1334143",0.490205956388734,10732,0.536599697648138,10657,-0.0463937412594047,75
"11498","2334143",0.426982783880545,13440,0.480225213007315,13326,-0.0532424291267702,114
"11499","3334143",0.383868575067041,14735,0.451431379807535,14366,-0.0675628047404943,369
"11500","4334143",0.342394244366501,15556,0.409021004685725,15425,-0.0666267603192239,131
"11501","1434143",0.451269458403738,12490,0.495970193680032,12672,-0.0447007352762948,-182
"11502","2434143",0.388046285895549,14634,0.439595709039209,14721,-0.0515494231436606,-87
"11503","3434143",0.344932077082045,15512,0.41080187583943,15385,-0.0658697987573846,127
"11504","4434143",0.303457746381505,16009,0.368391500717619,15990,-0.0649337543361142,19
"11505","1144143",0.523109639803676,9085,0.578556049800058,8286,-0.055446409996382,799
"11506","2144143",0.459886467295487,12145,0.522181565159235,11394,-0.0622950978637475,751
"11507","3144143",0.416772258481984,13789,0.493387731959455,12786,-0.0766154734774716,1003
"11508","4144143",0.375297927781444,14934,0.450977356837645,14380,-0.0756794290562012,554
"11509","1244143",0.46915186221068,11735,0.523251770854352,11331,-0.054099908643672,404
"11510","2244143",0.405928689702491,14136,0.466877286213529,13851,-0.0609485965110375,285
"11511","3244143",0.362814480888988,15212,0.438083453013749,14756,-0.0752689721247615,456
"11512","4244143",0.321340150188448,15832,0.395673077891939,15648,-0.0743329277034911,184
"11513","1344143",0.441172391933904,12894,0.496201203521054,12660,-0.0550288115871502,234
"11514","2344143",0.377949219425715,14886,0.439826718880231,14715,-0.0618774994545158,171
"11515","3344143",0.334835010612212,15670,0.411032885680451,15381,-0.0761978750682398,289
"11516","4344143",0.293360679911672,16083,0.368622510558641,15986,-0.0752618306469694,97
"11517","1444143",0.402235893948908,14240,0.455571699552948,14226,-0.0533358056040403,14
"11518","2444143",0.339012721440719,15614,0.399197214912125,15597,-0.060184493471406,17
"11519","3444143",0.295898512627216,16068,0.370403381712346,15968,-0.07450486908513,100
"11520","4444143",0.254424181926676,16273,0.327993006590535,16250,-0.0735688246638597,23
"11521","1111243",0.76178132244656,646,0.781120286669343,623,-0.0193389642227835,23
"11522","2111243",0.698558149938371,1727,0.72474580202852,1681,-0.0261876520901491,46
"11523","3111243",0.655443941124867,2973,0.69595196882874,2540,-0.0405080277038731,433
"11524","4111243",0.613969610424327,4615,0.65354159370693,4255,-0.0395719832826026,360
"11525","1211243",0.707823544853563,1525,0.725816007723637,1646,-0.0179924628700733,-121
"11526","2211243",0.644600372345375,3380,0.669441523082813,3544,-0.0248411507374389,-164
"11527","3211243",0.601486163531871,5160,0.640647689883034,4888,-0.0391615263511629,272
"11528","4211243",0.560011832831331,7175,0.598237314761224,7161,-0.0382254819298926,14
"11529","1311243",0.679844074576787,2231,0.698765440390339,2449,-0.0189213658135515,-218
"11530","2311243",0.616620902068598,4476,0.642390955749516,4794,-0.0257700536809171,-318
"11531","3311243",0.573506693255095,6505,0.613597122549736,6291,-0.0400904292946411,214
"11532","4311243",0.532032362554555,8622,0.571186747427926,8715,-0.0391543848733709,-93
"11533","1411243",0.640907576591791,3527,0.658135936422233,4046,-0.0172283598304417,-519
"11534","2411243",0.577684404083602,6310,0.60176145178141,6946,-0.0240770476978074,-636
"11535","3411243",0.534570195270099,8483,0.57296761858163,8598,-0.0383974233115314,-115
"11536","4411243",0.493095864569559,10598,0.53055724345982,10967,-0.0374613788902611,-369
"11537","1121243",0.69380205158014,1848,0.720550975011936,1790,-0.0267489234317967,58
"11538","2121243",0.630578879071951,3890,0.664176490371113,3790,-0.0335976112991623,100
"11539","3121243",0.587464670258447,5803,0.635382657171333,5155,-0.0479179869128863,648
"11540","4121243",0.545990339557907,7905,0.592972282049523,7454,-0.0469819424916158,451
"11541","1221243",0.639844273987143,3568,0.66524669606623,3732,-0.0254024220790865,-164
"11542","2221243",0.576621101478955,6354,0.608872211425407,6562,-0.0322511099464521,-208
"11543","3221243",0.533506892665451,8539,0.580078378225627,8190,-0.0465714855601761,349
"11544","4221243",0.492032561964911,10644,0.537668003103817,10599,-0.0456354411389058,45
"11545","1321243",0.611864803710367,4706,0.638196128732932,5030,-0.0263313250225647,-324
"11546","2321243",0.548641631202178,7758,0.581821644092109,8091,-0.0331800128899303,-333
"11547","3321243",0.505527422388675,9973,0.553027810892329,9744,-0.0475003885036543,229
"11548","4321243",0.464053091688135,11956,0.510617435770519,12004,-0.0465643440823841,-48
"11549","1421243",0.572928305725371,6537,0.597566624764826,7204,-0.0246383190394549,-667
"11550","2421243",0.509705133217182,9768,0.541192140124003,10410,-0.0314870069068206,-642
"11551","3421243",0.466590924403679,11832,0.512398306924224,11912,-0.0458073825205446,-80
"11552","4421243",0.425116593703139,13506,0.469987931802413,13763,-0.0448713380992743,-257
"11553","1131243",0.65046952941504,3171,0.682085882563907,3046,-0.0316163531488673,125
"11554","2131243",0.587246356906851,5821,0.625711397923084,5629,-0.0384650410162329,192
"11555","3131243",0.544132148093348,8013,0.596917564723305,7242,-0.052785416629957,771
"11556","4131243",0.502657817392808,10132,0.554507189601494,9652,-0.0518493722086867,480
"11557","1231243",0.596511751822044,5389,0.626781603618201,5577,-0.0302698517961574,-188
"11558","2231243",0.533288579313855,8557,0.570407118977378,8759,-0.037118539663523,-202
"11559","3231243",0.490174370500351,10735,0.541613285777598,10381,-0.051438915277247,354
"11560","4231243",0.448700039799812,12609,0.499202910655788,12536,-0.0505028708559764,73
"11561","1331243",0.568532281545268,6764,0.599731036284903,7070,-0.0311987547396356,-306
"11562","2331243",0.505309109037079,9990,0.54335655164408,10269,-0.0380474426070012,-279
"11563","3331243",0.462194900223575,12038,0.5145627184443,11802,-0.0523678182207252,236
"11564","4331243",0.420720569523035,13661,0.47215234332249,13683,-0.0514317737994548,-22
"11565","1431243",0.529595783560272,8752,0.559101532316797,9390,-0.0295057487565258,-638
"11566","2431243",0.466372611052083,11845,0.502727047675974,12358,-0.0363544366238915,-513
"11567","3431243",0.423258402238579,13575,0.473933214476195,13603,-0.0506748122376154,-28
"11568","4431243",0.381784071538039,14785,0.431522839354384,14947,-0.0497387678163451,-162
"11569","1141243",0.60143596496021,5164,0.641687388436823,4834,-0.0402514234766129,330
"11570","2141243",0.538212792452021,8319,0.585312903796,7868,-0.0471001113439785,451
"11571","3141243",0.495098583638518,10492,0.55651907059622,9540,-0.0614204869577025,952
"11572","4141243",0.453624252937978,12402,0.51410869547441,11824,-0.060484442536432,578
"11573","1241243",0.547478187367214,7812,0.586383109491117,7811,-0.0389049221239027,1
"11574","2241243",0.484255014859025,11034,0.530008624850294,11001,-0.0457536099912683,33
"11575","3241243",0.441140806045522,12896,0.501214791650514,12434,-0.0600739856049923,462
"11576","4241243",0.399666475344982,14304,0.458804416528704,14124,-0.059137941183722,180
"11577","1341243",0.519498717090438,9252,0.559332542157819,9370,-0.039833825067381,-118
"11578","2341243",0.456275544582249,12290,0.502958057516996,12349,-0.0466825129347466,-59
"11579","3341243",0.413161335768746,13895,0.474164224317216,13591,-0.0610028885484706,304
"11580","4341243",0.371687005068206,15013,0.431753849195406,14939,-0.0600668441272003,74
"11581","1441243",0.480562219105442,11197,0.518703038189713,11573,-0.0381408190842711,-376
"11582","2441243",0.417339046597253,13776,0.46232855354889,14005,-0.0449895069516369,-229
"11583","3441243",0.37422483778375,14957,0.433534720349111,14879,-0.0593098825653609,78
"11584","4441243",0.33275050708321,15693,0.3911243452273,15716,-0.0583738381440905,-23
"11585","1112243",0.728696410684871,1110,0.742801305140691,1252,-0.0141048944558203,-142
"11586","2112243",0.665473238176682,2648,0.686426820499868,2876,-0.0209535823231859,-228
"11587","3112243",0.622359029363178,4252,0.657632987300088,4074,-0.0352739579369099,178
"11588","4112243",0.580884698662638,6155,0.615222612178278,6201,-0.0343379135156394,-46
"11589","1212243",0.674738633091875,2372,0.687497026194985,2833,-0.0127583931031101,-461
"11590","2212243",0.611515460583686,4727,0.631122541554161,5355,-0.0196070809704757,-628
"11591","3212243",0.568401251770182,6771,0.602328708354382,6915,-0.0339274565841997,-144
"11592","4212243",0.526926921069642,8908,0.559918333232572,9341,-0.0329914121629294,-433
"11593","1312243",0.646759162815098,3309,0.660446458861687,3951,-0.0136872960465884,-642
"11594","2312243",0.58353599030691,6027,0.604071974220863,6823,-0.0205359839139539,-796
"11595","3312243",0.540421781493406,8213,0.575278141021084,8475,-0.034856359527678,-262
"11596","4312243",0.498947450792866,10322,0.532867765899274,10856,-0.0339203151064077,-534
"11597","1412243",0.607822664830102,4899,0.619816954893581,5949,-0.0119942900634785,-1050
"11598","2412243",0.544599492321914,7989,0.563442470252758,9134,-0.0188429779308442,-1145
"11599","3412243",0.50148528350841,10198,0.534648637052978,10757,-0.0331633535445682,-559
"11600","4412243",0.46001095280787,12143,0.492238261931168,12842,-0.0322273091232979,-699
"11601","1122243",0.660717139818451,2792,0.682231993483284,3037,-0.0215148536648335,-245
"11602","2122243",0.597493967310262,5351,0.625857508842461,5620,-0.0283635415321991,-269
"11603","3122243",0.554379758496758,7482,0.597063675642681,7233,-0.0426839171459231,249
"11604","4122243",0.512905427796218,9630,0.554653300520871,9640,-0.0417478727246526,-10
"11605","1222243",0.606759362225455,4940,0.626927714537578,5566,-0.0201683523121233,-626
"11606","2222243",0.543536189717266,8037,0.570553229896755,8750,-0.0270170401794889,-713
"11607","3222243",0.500421980903762,10238,0.541759396696975,10371,-0.0413374157932129,-133
"11608","4222243",0.458947650203222,12192,0.499349021575165,12528,-0.0404013713719426,-336
"11609","1322243",0.578779891948678,6265,0.59987714720428,7062,-0.0210972552556016,-797
"11610","2322243",0.51555671944049,9494,0.543502662563457,10261,-0.0279459431229672,-767
"11611","3322243",0.472442510626986,11593,0.514708829363677,11796,-0.0422663187366912,-203
"11612","4322243",0.430968179926446,13306,0.472298454241867,13676,-0.0413302743154209,-370
"11613","1422243",0.539843393963682,8238,0.559247643236174,9381,-0.0194042492724917,-1143
"11614","2422243",0.476620221455494,11394,0.502873158595351,12353,-0.0262529371398574,-959
"11615","3422243",0.43350601264199,13209,0.474079325395571,13598,-0.0405733127535814,-389
"11616","4422243",0.39203168194145,14539,0.431668950273761,14943,-0.0396372683323111,-404
"11617","1132243",0.617384617653351,4453,0.643766901035255,4715,-0.0263822833819042,-262
"11618","2132243",0.554161445145162,7497,0.587392416394432,7748,-0.0332309712492698,-251
"11619","3132243",0.511047236331659,9721,0.558598583194652,9417,-0.0475513468629938,304
"11620","4132243",0.469572905631119,11716,0.516188208072842,11706,-0.0466153024417235,10
"11621","1232243",0.563426840060355,6992,0.588462622089549,7688,-0.0250357820291942,-696
"11622","2232243",0.500203667552166,10258,0.532088137448726,10887,-0.0318844698965598,-629
"11623","3232243",0.457089458738662,12256,0.503294304248946,12334,-0.0462048455102838,-78
"11624","4232243",0.415615128038123,13828,0.460883929127136,14053,-0.0452688010890134,-225
"11625","1332243",0.535447369783579,8445,0.561412054756251,9243,-0.0259646849726725,-798
"11626","2332243",0.47222419727539,11607,0.505037570115428,12243,-0.032813372840038,-636
"11627","3332243",0.429109988461886,13374,0.476243736915648,13500,-0.047133748453762,-126
"11628","4332243",0.387635657761346,14644,0.433833361793838,14871,-0.0461977040324916,-227
"11629","1432243",0.496510871798583,10431,0.520782550788145,11455,-0.0242716789895626,-1024
"11630","2432243",0.433287699290394,13222,0.464408066147322,13934,-0.0311203668569283,-712
"11631","3432243",0.39017349047689,14589,0.435614232947543,14828,-0.0454407424706523,-239
"11632","4432243",0.34869915977635,15461,0.393203857825732,15683,-0.0445046980493819,-222
"11633","1142243",0.568351053198521,6778,0.603368406908171,6856,-0.0350173537096498,-78
"11634","2142243",0.505127880690333,10000,0.546993922267348,10056,-0.0418660415770153,-56
"11635","3142243",0.462013671876829,12049,0.518200089067568,11605,-0.0561864171907394,444
"11636","4142243",0.420539341176289,13671,0.475789713945758,13518,-0.0552503727694689,153
"11637","1242243",0.514393275605525,9541,0.548064127962465,10005,-0.0336708523569396,-464
"11638","2242243",0.451170103097337,12498,0.491689643321642,12860,-0.0405195402243051,-362
"11639","3242243",0.408055894283833,14058,0.462895810121862,13980,-0.0548399158380292,78
"11640","4242243",0.366581563583293,15133,0.420485435000052,15191,-0.0539038714167588,-58
"11641","1342243",0.486413805328749,10933,0.521013560629167,11439,-0.0345997553004178,-506
"11642","2342243",0.42319063282056,13576,0.464639075988344,13930,-0.0414484431677835,-354
"11643","3342243",0.380076424007057,14838,0.435845242788564,14824,-0.0557688187815075,14
"11644","4342243",0.338602093306517,15621,0.393434867666754,15677,-0.0548327743602371,-56
"11645","1442243",0.447477307343753,12657,0.480384056661061,13321,-0.0329067493173079,-664
"11646","2442243",0.384254134835564,14725,0.424009572020238,15106,-0.0397554371846737,-381
"11647","3442243",0.341139926022061,15579,0.395215738820459,15655,-0.0540758127983977,-76
"11648","4442243",0.299665595321521,16045,0.352805363698648,16113,-0.0531397683771274,-68
"11649","1113243",0.689813235112385,1951,0.717304714751452,1881,-0.027491479639067,70
"11650","2113243",0.626590062604196,4050,0.660930230110629,3937,-0.0343401675064325,113
"11651","3113243",0.583475853790693,6029,0.632136396910849,5308,-0.0486605431201566,721
"11652","4113243",0.542001523090153,8123,0.589726021789039,7620,-0.0477244986988861,503
"11653","1213243",0.635855457519389,3718,0.662000435805746,3883,-0.0261449782863568,-165
"11654","2213243",0.5726322850112,6552,0.605625951164922,6729,-0.0329936661537223,-177
"11655","3213243",0.529518076197697,8757,0.576832117965143,8381,-0.0473140417674464,376
"11656","4213243",0.488043745497156,10855,0.534421742843333,10770,-0.0463779973461761,85
"11657","1313243",0.607875987242613,4897,0.634949868472448,5183,-0.027073881229835,-286
"11658","2313243",0.544652814734424,7985,0.578575383831624,8285,-0.0339225690972006,-300
"11659","3313243",0.50153860592092,10194,0.549781550631845,9903,-0.0482429447109246,291
"11660","4313243",0.46006427522038,12141,0.507371175510035,12144,-0.0473069002896543,-3
"11661","1413243",0.568939489257617,6740,0.594320364504342,7385,-0.0253808752467252,-645
"11662","2413243",0.505716316749428,9963,0.537945879863519,10583,-0.0322295631140909,-620
"11663","3413243",0.462602107935924,12016,0.509152046663739,12057,-0.0465499387278149,-41
"11664","4413243",0.421127777235384,13647,0.466741671541929,13861,-0.0456138943065446,-214
"11665","1123243",0.621833964245965,4264,0.656735403094045,4117,-0.0349014388480802,147
"11666","2123243",0.558610791737776,7246,0.600360918453222,7043,-0.0417501267154458,203
"11667","3123243",0.515496582924273,9496,0.571567085253442,8687,-0.0560705023291698,809
"11668","4123243",0.474022252223733,11525,0.529156710131632,11045,-0.0551344579078993,480
"11669","1223243",0.567876186652969,6805,0.601431124148339,6968,-0.03355493749537,-163
"11670","2223243",0.50465301414478,10023,0.545056639507516,10168,-0.0404036253627356,-145
"11671","3223243",0.461538805331277,12065,0.516262806307736,11702,-0.0547240009764596,363
"11672","4223243",0.420064474630736,13691,0.473852431185926,13608,-0.0537879565551893,83
"11673","1323243",0.539896716376193,8234,0.574380556815041,8529,-0.0344838404388482,-295
"11674","2323243",0.476673543868004,11390,0.518006072174218,11615,-0.0413325283062138,-225
"11675","3323243",0.4335593350545,13206,0.489212238974438,12967,-0.0556529039199378,239
"11676","4323243",0.39208500435396,14538,0.446801863852628,14521,-0.0547168594986675,17
"11677","1423243",0.500960218391197,10218,0.533751052846935,10810,-0.0327908344557384,-592
"11678","2423243",0.437737045883008,13026,0.477376568206112,13456,-0.039639522323104,-430
"11679","3423243",0.394622837069504,14460,0.448582735006332,14461,-0.053959897936828,-1
"11680","4423243",0.353148506368964,15385,0.406172359884522,15479,-0.0530238535155578,-94
"11681","1133243",0.578501442080865,6275,0.618270310646016,6032,-0.0397688685651508,243
"11682","2133243",0.515278269572677,9507,0.561895826005193,9224,-0.0466175564325164,283
"11683","3133243",0.472164060759173,11610,0.533101992805413,10842,-0.0609379320462404,768
"11684","4133243",0.430689730058633,13315,0.490691617683603,12903,-0.0600018876249701,412
"11685","1233243",0.524543664487869,9018,0.56296603170031,9163,-0.0384223672124409,-145
"11686","2233243",0.46132049197968,12081,0.506591547059487,12181,-0.0452710550798064,-100
"11687","3233243",0.418206283166177,13745,0.477797713859707,13429,-0.0595914306935304,316
"11688","4233243",0.376731952465637,14913,0.435387338737897,14834,-0.0586553862722599,79
"11689","1333243",0.496564194211093,10424,0.535915464367012,10689,-0.0393512701559191,-265
"11690","2333243",0.433341021702904,13218,0.479540979726189,13352,-0.0461999580232846,-134
"11691","3333243",0.390226812889401,14585,0.450747146526409,14388,-0.0605203336370086,197
"11692","4333243",0.348752482188861,15458,0.408336771404599,15435,-0.0595842892157382,23
"11693","1433243",0.457627696226097,12239,0.495285960398906,12705,-0.0376582641728092,-466
"11694","2433243",0.394404523717908,14466,0.438911475758083,14740,-0.0445069520401749,-274
"11695","3433243",0.351290314904405,15417,0.410117642558304,15401,-0.0588273276538989,16
"11696","4433243",0.309815984203865,15958,0.367707267436493,15997,-0.0578912832326284,-39
"11697","1143243",0.529467877626036,8761,0.577871816518932,8328,-0.0484039388928964,433
"11698","2143243",0.466244705117847,11848,0.521497331878109,11422,-0.055252626760262,426
"11699","3143243",0.423130496304343,13578,0.492703498678329,12814,-0.069573002373986,764
"11700","4143243",0.381656165603804,14788,0.450293123556519,14408,-0.0686369579527155,380
"11701","1243243",0.47551010003304,11445,0.522567537573226,11367,-0.0470574375401862,78
"11702","2243243",0.412286927524851,13931,0.466193052932403,13878,-0.0539061254075517,53
"11703","3243243",0.369172718711347,15067,0.437399219732623,14773,-0.0682265010212758,294
"11704","4243243",0.327698388010807,15764,0.394988844610813,15657,-0.0672904566000055,107
"11705","1343243",0.447530629756264,12653,0.495516970239928,12692,-0.0479863404836644,-39
"11706","2343243",0.384307457248075,14723,0.439142485599105,14731,-0.05483502835103,-8
"11707","3343243",0.341193248434571,15577,0.410348652399325,15393,-0.069155403964754,184
"11708","4343243",0.299718917734031,16044,0.367938277277515,15992,-0.0682193595434837,52
"11709","1443243",0.408594131771268,14042,0.454887466271822,14254,-0.0462933345005546,-212
"11710","2443243",0.345370959263079,15503,0.398512981630999,15610,-0.0531420223679203,-107
"11711","3443243",0.302256750449575,16016,0.36971914843122,15971,-0.0674623979816443,45
"11712","4443243",0.260782419749035,16252,0.327308773309409,16252,-0.0665263535603739,0
"11713","1114243",0.637606163141815,3652,0.672654101377796,3409,-0.0350479382359807,243
"11714","2114243",0.574382990633626,6462,0.616279616736973,6156,-0.0418966261033463,306
"11715","3114243",0.531268781820123,8667,0.587485783537193,7740,-0.0562170017170703,927
"11716","4114243",0.489794451119583,10754,0.545075408415383,10165,-0.0552809572958001,589
"11717","1214243",0.583648385548819,6019,0.61734982243209,6085,-0.0337014368832708,-66
"11718","2214243",0.52042521304063,9216,0.560975337791267,9265,-0.0405501247506364,-49
"11719","3214243",0.477311004227127,11354,0.532181504591487,10882,-0.0548705003643604,472
"11720","4214243",0.435836673526587,13108,0.489771129469677,12944,-0.0539344559430898,164
"11721","1314243",0.555668915272043,7417,0.590299255098792,7582,-0.034630339826749,-165
"11722","2314243",0.492445742763854,10623,0.533924770457969,10794,-0.0414790276941146,-171
"11723","3314243",0.44933153395035,12580,0.505130937258189,12239,-0.0557994033078386,341
"11724","4314243",0.407857203249811,14073,0.462720562136379,13987,-0.0548633588865682,86
"11725","1414243",0.516732417287047,9427,0.549669751130686,9909,-0.0329373338436392,-482
"11726","2414243",0.453509244778858,12408,0.493295266489863,12790,-0.0397860217110048,-382
"11727","3414243",0.410395035965355,13983,0.464501433290083,13933,-0.0541063973247288,50
"11728","4414243",0.368920705264815,15078,0.422091058168273,15144,-0.0531703529034585,-66
"11729","1124243",0.569626892275395,6713,0.612084789720389,6384,-0.042457897444994,329
"11730","2124243",0.506403719767206,9931,0.555710305079566,9591,-0.0493065853123595,340
"11731","3124243",0.463289510953703,11987,0.526916471879787,11147,-0.0636269609260836,840
"11732","4124243",0.421815180253163,13622,0.484506096757976,13160,-0.0626909165048132,462
"11733","1224243",0.515669114682399,9487,0.556780510774683,9523,-0.041111396092284,-36
"11734","2224243",0.45244594217421,12439,0.50040602613386,12473,-0.0479600839596496,-34
"11735","3224243",0.409331733360707,14019,0.47161219293408,13702,-0.0622804595733735,317
"11736","4224243",0.367857402660167,15100,0.42920181781227,14996,-0.0613444151521031,104
"11737","1324243",0.487689644405623,10871,0.529729943441385,11014,-0.0420402990357622,-143
"11738","2324243",0.424466471897434,13529,0.473355458800562,13630,-0.0488889869031278,-101
"11739","3324243",0.381352263083931,14798,0.444561625600782,14583,-0.0632093625168518,215
"11740","4324243",0.339877932383391,15600,0.402151250478972,15562,-0.0622733180955814,38
"11741","1424243",0.448753146420627,12605,0.489100439473279,12974,-0.0403472930526523,-369
"11742","2424243",0.385529973912438,14691,0.432725954832456,14904,-0.047195980920018,-213
"11743","3424243",0.342415765098935,15554,0.403932121632677,15522,-0.061516356533742,32
"11744","4424243",0.300941434398395,16030,0.361521746510866,16054,-0.0605803121124717,-24
"11745","1134243",0.526294370110296,8944,0.57361969727236,8564,-0.0473253271620648,380
"11746","2134243",0.463071197602107,11998,0.517245212631537,11652,-0.0541740150294304,346
"11747","3134243",0.419956988788603,13697,0.488451379431758,13000,-0.0684943906431544,697
"11748","4134243",0.378482658088063,14871,0.446041004309947,14540,-0.067558346221884,331
"11749","1234243",0.4723365925173,11600,0.518315418326654,11597,-0.0459788258093546,3
"11750","2234243",0.409113420009111,14030,0.461940933685831,14015,-0.0528275136767203,15
"11751","3234243",0.365999211195607,15146,0.433147100486051,14887,-0.0671478892904443,259
"11752","4234243",0.324524880495067,15795,0.390736725364241,15722,-0.0662118448691739,73
"11753","1334243",0.444357122240523,12782,0.491264850993356,12876,-0.0469077287528328,-94
"11754","2334243",0.381133949732334,14806,0.434890366352533,14845,-0.0537564166201985,-39
"11755","3334243",0.338019740918831,15630,0.406096533152753,15482,-0.0680767922339225,148
"11756","4334243",0.296545410218291,16061,0.363686158030943,16031,-0.0671407478126522,30
"11757","1434243",0.405420624255527,14154,0.45063534702525,14393,-0.0452147227697231,-239
"11758","2434243",0.342197451747338,15558,0.394260862384427,15668,-0.0520634106370888,-110
"11759","3434243",0.299083242933835,16048,0.365467029184648,16012,-0.0663837862508128,36
"11760","4434243",0.257608912233295,16264,0.323056654062837,16269,-0.0654477418295424,-5
"11761","1144243",0.477260805655466,11360,0.533221203145276,10834,-0.0559603974898102,526
"11762","2144243",0.414037633147277,13871,0.476846718504453,13477,-0.0628090853571758,394
"11763","3144243",0.370923424333774,15032,0.448052885304674,14480,-0.0771294609708998,552
"11764","4144243",0.329449093633234,15734,0.405642510182863,15491,-0.0761934165496295,243
"11765","1244243",0.42330302806247,13571,0.47791692419957,13423,-0.0546138961371002,148
"11766","2244243",0.360079855554281,15258,0.421542439558747,15157,-0.0614625840044657,101
"11767","3244243",0.316965646740778,15874,0.392748606358967,15687,-0.0757829596181898,187
"11768","4244243",0.275491316040238,16192,0.350338231237157,16131,-0.0748469151969194,61
"11769","1344243",0.395323557785694,14435,0.450866356866272,14381,-0.0555427990805784,54
"11770","2344243",0.332100385277505,15701,0.394491872225449,15665,-0.062391486947944,36
"11771","3344243",0.288986176464001,16110,0.365698039025669,16010,-0.076711862561668,100
"11772","4344243",0.247511845763461,16297,0.323287663903859,16266,-0.0757758181403977,31
"11773","1444243",0.356387059800698,15323,0.410236852898166,15396,-0.0538497930974686,-73
"11774","2444243",0.293163887292509,16084,0.353862368257343,16101,-0.0606984809648343,-17
"11775","3444243",0.250049678479005,16285,0.325068535057564,16259,-0.0750188565785583,26
"11776","4444243",0.208575347778465,16360,0.282658159935753,16354,-0.0740828121572879,6
"11777","1111343",0.739327343441252,934,0.763070296741668,890,-0.0237429533004169,44
"11778","2111343",0.676104170933063,2338,0.706695812100845,2196,-0.0305916411677825,142
"11779","3111343",0.632989962119559,3810,0.677901978901066,3211,-0.0449120167815065,599
"11780","4111343",0.591515631419019,5604,0.635491603779255,5143,-0.0439759723602362,461
"11781","1211343",0.685369565848255,2075,0.707766017795962,2153,-0.0223964519477069,-78
"11782","2211343",0.622146393340066,4257,0.651391533155139,4346,-0.0292451398150725,-89
"11783","3211343",0.579032184526563,6254,0.622597699955359,5803,-0.0435655154287965,451
"11784","4211343",0.537557853826023,8346,0.580187324833549,8176,-0.042629471007526,170
"11785","1311343",0.657390095571479,2912,0.680715450462664,3101,-0.0233253548911851,-189
"11786","2311343",0.59416692306329,5508,0.624340965821841,5701,-0.0301740427585507,-193
"11787","3311343",0.551052714249787,7653,0.595547132622061,7314,-0.0444944183722747,339
"11788","4311343",0.509578383549247,9773,0.553136757500251,9735,-0.0435583739510043,38
"11789","1411343",0.618453597586483,4411,0.640085946494558,4909,-0.0216323489080753,-498
"11790","2411343",0.555230425078294,7444,0.583711461853735,7964,-0.028481036775441,-520
"11791","3411343",0.512116216264791,9665,0.554917628653956,9629,-0.042801412389165,36
"11792","4411343",0.470641885564251,11663,0.512507253532145,11902,-0.0418653679678945,-239
"11793","1121343",0.671348072574832,2467,0.702500985084262,2337,-0.0311529125094301,130
"11794","2121343",0.608124900066643,4888,0.646126500443438,4603,-0.0380016003767957,285
"11795","3121343",0.565010691253139,6935,0.617332667243659,6087,-0.0523219759905197,848
"11796","4121343",0.523536360552599,9062,0.574922292121849,8492,-0.0513859315692494,570
"11797","1221343",0.617390294981835,4450,0.647196706138555,4548,-0.0298064111567201,-98
"11798","2221343",0.554167122473646,7495,0.590822221497732,7557,-0.0366550990240857,-62
"11799","3221343",0.511052913660143,9719,0.562028388297953,9215,-0.0509754746378097,504
"11800","4221343",0.469578582959603,11714,0.519618013176142,11521,-0.0500394302165392,193
"11801","1321343",0.589410824705059,5716,0.620146138805257,5932,-0.0307353141001984,-216
"11802","2321343",0.52618765219687,8952,0.563771654164434,9119,-0.037584001967564,-167
"11803","3321343",0.483073443383367,11091,0.534977820964655,10738,-0.051904377581288,353
"11804","4321343",0.441599112682827,12879,0.492567445842844,12822,-0.0509683331600174,57
"11805","1421343",0.550474326720063,7685,0.579516634837152,8222,-0.0290423081170885,-537
"11806","2421343",0.487251154211874,10898,0.523142150196328,11338,-0.0358909959844542,-440
"11807","3421343",0.444136945398371,12797,0.494348316996549,12743,-0.0502113715981782,54
"11808","4421343",0.402662614697831,14229,0.451937941874739,14347,-0.0492753271769077,-118
"11809","1131343",0.628015550409732,3998,0.664035892636233,3798,-0.036020342226501,200
"11810","2131343",0.564792377901543,6939,0.60766140799541,6624,-0.0428690300938666,315
"11811","3131343",0.521678169088039,9161,0.57886757479563,8269,-0.0571894057075906,892
"11812","4131343",0.4802038383875,11213,0.53645719967382,10660,-0.0562533612863201,553
"11813","1231343",0.574057772816736,6476,0.608731613690527,6571,-0.0346738408737908,-95
"11814","2231343",0.510834600308547,9727,0.552357129049703,9778,-0.0415225287411564,-51
"11815","3231343",0.467720391495043,11788,0.523563295849924,11319,-0.0558429043548804,469
"11816","4231343",0.426246060794503,13465,0.481152920728113,13288,-0.05490685993361,177
"11817","1331343",0.54607830253996,7901,0.581681046357229,8094,-0.035602743817269,-193
"11818","2331343",0.482855130031771,11101,0.525306561716405,11229,-0.0424514316846346,-128
"11819","3331343",0.439740921218267,12956,0.496512728516626,12642,-0.0567718072983586,314
"11820","4331343",0.398266590517727,14344,0.454102353394815,14280,-0.0558357628770883,64
"11821","1431343",0.507141804554964,9896,0.541051542389123,10417,-0.0339097378341592,-521
"11822","2431343",0.443918632046775,12805,0.4846770577483,13151,-0.0407584257015248,-346
"11823","3431343",0.400804423233271,14287,0.45588322454852,14217,-0.0550788013152488,70
"11824","4431343",0.359330092532731,15268,0.41347284942671,15338,-0.0541427568939786,-70
"11825","1141343",0.578981985954902,6257,0.623637398509149,5748,-0.0446554125542463,509
"11826","2141343",0.515758813446713,9479,0.567262913868325,8924,-0.0515041004216119,555
"11827","3141343",0.47264460463321,11583,0.538469080668546,10554,-0.0658244760353359,1029
"11828","4141343",0.43117027393267,13297,0.496058705546736,12667,-0.0648884316140656,630
"11829","1241343",0.525024208361906,8999,0.568333119563442,8867,-0.0433089112015363,132
"11830","2241343",0.461801035853717,12055,0.511958634922619,11933,-0.0501575990689019,122
"11831","3241343",0.418686827040214,13734,0.48316480172284,13213,-0.0644779746826259,521
"11832","4241343",0.377212496339674,14905,0.440754426601029,14691,-0.0635419302613554,214
"11833","1341343",0.49704473808513,10408,0.541282552230145,10403,-0.0442378141450146,5
"11834","2341343",0.433821565576941,13191,0.484908067589321,13143,-0.0510865020123801,48
"11835","3341343",0.390707356763438,14571,0.456114234389542,14204,-0.0654068776261041,367
"11836","4341343",0.349233026062898,15449,0.413703859267731,15332,-0.0644708332048337,117
"11837","1441343",0.458108240100134,12228,0.500653048262039,12462,-0.0425448081619048,-234
"11838","2441343",0.394885067591945,14452,0.444278563621215,14594,-0.0493934960292704,-142
"11839","3441343",0.351770858778442,15410,0.415484730421436,15292,-0.0637138716429944,118
"11840","4441343",0.310296528077902,15953,0.373074355299626,15945,-0.0627778272217239,8
"11841","1112343",0.706242431679563,1566,0.724751315213016,1680,-0.0185088835334537,-114
"11842","2112343",0.643019259171374,3441,0.668376830572193,3599,-0.0253575714008193,-158
"11843","3112343",0.59990505035787,5235,0.639582997372414,4948,-0.0396779470145433,287
"11844","4112343",0.55843071965733,7256,0.597172622250603,7224,-0.038741902593273,32
"11845","1212343",0.652284654086566,3112,0.66944703626731,3542,-0.0171623821807437,-430
"11846","2212343",0.589061481578377,5731,0.613072551626487,6324,-0.0240110700481093,-593
"11847","3212343",0.545947272764874,7907,0.584278718426707,7933,-0.0383314456618333,-26
"11848","4212343",0.504472942064334,10033,0.541868343304897,10364,-0.0373954012405628,-331
"11849","1312343",0.62430518380979,4169,0.642396468934012,4793,-0.018091285124222,-624
"11850","2312343",0.561082011301601,7117,0.586021984293189,7831,-0.0249399729915876,-714
"11851","3312343",0.517967802488098,9352,0.557228151093409,9499,-0.0392603486053116,-147
"11852","4312343",0.476493471787558,11401,0.514817775971599,11789,-0.0383243041840411,-388
"11853","1412343",0.585368685824794,5934,0.601766964965906,6945,-0.0163982791411121,-1011
"11854","2412343",0.522145513316605,9143,0.545392480325083,10146,-0.0232469670084778,-1003
"11855","3412343",0.479031304503102,11273,0.516598647125304,11687,-0.0375673426222018,-414
"11856","4412343",0.437556973802562,13036,0.474188272003493,13589,-0.0366312982009313,-553
"11857","1122343",0.638263160813143,3627,0.66418200355561,3789,-0.0259188427424669,-162
"11858","2122343",0.575039988304954,6435,0.607807518914786,6616,-0.0327675306098325,-181
"11859","3122343",0.53192577949145,8626,0.579013685715007,8259,-0.0470879062235565,367
"11860","4122343",0.49045144879091,10714,0.536603310593196,10656,-0.0461518618022863,58
"11861","1222343",0.584305383220146,5989,0.608877724609903,6560,-0.0245723413897569,-571
"11862","2222343",0.521082210711957,9194,0.55250323996908,9774,-0.0314210292571225,-580
"11863","3222343",0.477968001898454,11321,0.523709406769301,11311,-0.0457414048708465,10
"11864","4222343",0.436493671197914,13076,0.48129903164749,13283,-0.044805360449576,-207
"11865","1322343",0.55632591294337,7381,0.581827157276605,8090,-0.0255012443332352,-709
"11866","2322343",0.493102740435181,10597,0.525452672635782,11226,-0.0323499322006008,-629
"11867","3322343",0.449988531621678,12544,0.496658839436003,12637,-0.0466703078143247,-93
"11868","4322343",0.408514200921138,14043,0.454248464314192,14278,-0.0457342633930543,-235
"11869","1422343",0.517389414958374,9388,0.5411976533085,10409,-0.0238082383501254,-1021
"11870","2422343",0.454166242450185,12382,0.484823168667676,13147,-0.030656926217491,-765
"11871","3422343",0.411052033636682,13962,0.456029335467897,14212,-0.044977301831215,-250
"11872","4422343",0.369577702936142,15059,0.413618960346087,15336,-0.0440412574099445,-277
"11873","1132343",0.594930638648043,5473,0.625716911107581,5628,-0.0307862724595378,-155
"11874","2132343",0.531707466139854,8639,0.569342426466757,8811,-0.0376349603269034,-172
"11875","3132343",0.48859325732635,10820,0.540548593266978,10451,-0.0519553359406274,369
"11876","4132343",0.447118926625811,12675,0.498138218145168,12577,-0.0510192915193569,98
"11877","1232343",0.540972861055047,8176,0.570412632161874,8758,-0.0294397711068276,-582
"11878","2232343",0.477749688546858,11336,0.514038147521051,11831,-0.0362884589741932,-495
"11879","3232343",0.434635479733354,13161,0.485244314321272,13130,-0.0506088345879172,31
"11880","4232343",0.393161149032814,14500,0.442833939199461,14639,-0.0496727901666469,-139
"11881","1332343",0.512993390778271,9625,0.543362064828577,10268,-0.0303686740503059,-643
"11882","2332343",0.449770218270082,12557,0.486987580187753,13050,-0.0372173619176714,-493
"11883","3332343",0.406656009456578,14109,0.458193746987974,14147,-0.0515377375313954,-38
"11884","4332343",0.365181678756038,15161,0.415783371866163,15283,-0.0506016931101251,-122
"11885","1432343",0.474056892793275,11522,0.502732560860471,12357,-0.028675668067196,-835
"11886","2432343",0.410833720285086,13971,0.446358076219647,14532,-0.0355243559345617,-561
"11887","3432343",0.367719511471582,15107,0.417564243019868,15248,-0.0498447315482857,-141
"11888","4432343",0.326245180771042,15775,0.375153867898058,15924,-0.0489086871270154,-149
"11889","1142343",0.545897074193213,7909,0.585318416980497,7867,-0.0394213427872832,42
"11890","2142343",0.482673901685025,11109,0.528943932339673,11055,-0.0462700306546487,54
"11891","3142343",0.439559692871521,12959,0.500150099139894,12491,-0.0605904062683728,468
"11892","4142343",0.398085362170981,14351,0.457739724018083,14157,-0.0596543618471024,194
"11893","1242343",0.491939296600217,10648,0.53001413803479,11000,-0.0380748414345732,-352
"11894","2242343",0.428716124092028,13385,0.473639653393967,13618,-0.0449235293019387,-233
"11895","3242343",0.385601915278525,14688,0.444845820194188,14578,-0.0592439049156627,110
"11896","4242343",0.344127584577985,15524,0.402435445072377,15558,-0.0583078604943922,-34
"11897","1342343",0.463959826323441,11957,0.502963570701492,12348,-0.0390037443780514,-391
"11898","2342343",0.400736653815252,14288,0.446589086060669,14526,-0.045852432245417,-238
"11899","3342343",0.357622445001749,15300,0.41779525286089,15244,-0.060172807859141,56
"11900","4342343",0.316148114301209,15887,0.375384877739079,15919,-0.0592367634378705,-32
"11901","1442343",0.425023328338445,13511,0.462334066733387,14004,-0.0373107383949415,-493
"11902","2442343",0.361800155830256,15229,0.405959582092563,15484,-0.0441594262623072,-255
"11903","3442343",0.318685947016753,15854,0.377165748892784,15898,-0.0584798018760312,-44
"11904","4442343",0.277211616316213,16181,0.334755373770974,16225,-0.0575437574547608,-44
"11905","1113343",0.667359256107077,2591,0.699254724823777,2433,-0.0318954687167003,158
"11906","2113343",0.604136083598888,5046,0.642880240182954,4768,-0.0387441565840659,278
"11907","3113343",0.561021874785385,7119,0.614086406983175,6265,-0.05306453219779,854
"11908","4113343",0.519547544084845,9248,0.571676031861364,8679,-0.0521284877765195,569
"11909","1213343",0.613401478514081,4643,0.643950445878071,4704,-0.0305489673639902,-61
"11910","2213343",0.550178306005892,7697,0.587575961237248,7735,-0.0373976552313557,-38
"11911","3213343",0.507064097192389,9899,0.558782128037468,9409,-0.0517180308450798,490
"11912","4213343",0.465589766491848,11871,0.516371752915658,11697,-0.0507819864238095,174
"11913","1313343",0.585422008237305,5931,0.616899878544773,6114,-0.0314778703074684,-183
"11914","2313343",0.522198835729116,9141,0.56052539390395,9294,-0.038326558174834,-153
"11915","3313343",0.479084626915612,11272,0.53173156070417,10903,-0.052646933788558,369
"11916","4313343",0.437610296215072,13035,0.48932118558236,12962,-0.0517108893672877,73
"11917","1413343",0.546485510252309,7876,0.576270374576667,8411,-0.0297848643243586,-535
"11918","2413343",0.48326233774412,11084,0.519895889935844,11500,-0.0366335521917243,-416
"11919","3413343",0.440148128930616,12939,0.491102056736065,12887,-0.0509539278054482,52
"11920","4413343",0.398673798230076,14333,0.448691681614254,14457,-0.050017883384178,-124
"11921","1123343",0.599379985240657,5262,0.63868541316637,5007,-0.0393054279257136,255
"11922","2123343",0.536156812732468,8418,0.582310928525547,8066,-0.0461541157930792,352
"11923","3123343",0.493042603918965,10600,0.553517095325768,9715,-0.0604744914068032,885
"11924","4123343",0.451568273218425,12477,0.511106720203957,11980,-0.0595384469855327,497
"11925","1223343",0.545422207647661,7941,0.583381134220664,7990,-0.0379589265730034,-49
"11926","2223343",0.482199035139472,11130,0.527006649579841,11144,-0.044807614440369,-14
"11927","3223343",0.439084826325969,12975,0.498212816380061,12572,-0.0591279900540929,403
"11928","4223343",0.397610495625428,14364,0.455802441258251,14221,-0.0581919456328227,143
"11929","1323343",0.517442737370885,9384,0.556330566887366,9556,-0.0388878295164816,-172
"11930","2323343",0.454219564862696,12379,0.499956082246543,12504,-0.0457365173838472,-125
"11931","3323343",0.411105356049192,13960,0.471162249046764,13716,-0.0600568929975712,244
"11932","4323343",0.369631025348652,15058,0.428751873924953,15010,-0.0591208485763009,48
"11933","1423343",0.478506239385889,11297,0.515701062919261,11738,-0.0371948235333718,-441
"11934","2423343",0.4152830668777,13837,0.459326578278437,14111,-0.0440435114007374,-274
"11935","3423343",0.372168858064196,15006,0.430532745078658,14965,-0.0583638870144614,41
"11936","4423343",0.330694527363656,15722,0.388122369956848,15753,-0.0574278425931912,-31
"11937","1133343",0.556047463075557,7398,0.600220320718342,7048,-0.0441728576427842,350
"11938","2133343",0.492824290567369,10606,0.543845836077518,10246,-0.0510215455101498,360
"11939","3133343",0.449710081753865,12559,0.515052002877739,11775,-0.0653419211238738,784
"11940","4133343",0.408235751053325,14051,0.472641627755928,13661,-0.0644058767026035,390
"11941","1233343",0.502089685482561,10162,0.544916041772635,10178,-0.0428263562900743,-16
"11942","2233343",0.438866512974372,12981,0.488541557131812,12996,-0.0496750441574398,-15
"11943","3233343",0.395752304160869,14422,0.459747723932033,14091,-0.0639954197711638,331
"11944","4233343",0.354277973460329,15357,0.417337348810222,15252,-0.0630593753498933,105
"11945","1333343",0.474110215205785,11519,0.517865474439338,11622,-0.0437552592335525,-103
"11946","2333343",0.410887042697596,13969,0.461490989798514,14032,-0.050603947100918,-63
"11947","3333343",0.367772833884093,15104,0.432697156598735,14906,-0.064924322714642,198
"11948","4333343",0.326298503183553,15773,0.390286781476924,15728,-0.0639882782933716,45
"11949","1433343",0.435173717220789,13139,0.477235970471232,13461,-0.0420622532504426,-322
"11950","2433343",0.3719505447126,15008,0.420861485830408,15179,-0.0489109411178083,-171
"11951","3433343",0.328836335899097,15745,0.392067652630629,15701,-0.0632313167315323,44
"11952","4433343",0.287362005198557,16122,0.349657277508819,16139,-0.0622952723102618,-17
"11953","1143343",0.507013898620728,9902,0.559821826591258,9351,-0.0528079279705298,551
"11954","2143343",0.443790726112539,12807,0.503447341950434,12323,-0.0596566158378954,484
"11955","3143343",0.400676517299035,14289,0.474653508750655,13569,-0.0739769914516193,720
"11956","4143343",0.359202186598496,15270,0.432243133628844,14924,-0.0730409470303489,346
"11957","1243343",0.453056121027732,12428,0.504517547645551,12270,-0.0514614266178196,158
"11958","2243343",0.389832948519543,14594,0.448143063004728,14474,-0.0583101144851851,120
"11959","3243343",0.346718739706039,15480,0.419349229804949,15213,-0.0726304900989092,267
"11960","4243343",0.305244409005499,15994,0.376938854683138,15902,-0.0716944456776389,92
"11961","1343343",0.425076650750956,13508,0.477466980312253,13450,-0.0523903295612978,58
"11962","2343343",0.361853478242767,15228,0.42109249567143,15170,-0.0592390174286634,58
"11963","3343343",0.318739269429263,15853,0.392298662471651,15694,-0.0735593930423874,159
"11964","4343343",0.277264938728723,16180,0.34988828734984,16136,-0.0726233486211171,44
"11965","1443343",0.38614015276596,14676,0.436837476344148,14795,-0.050697323578188,-119
"11966","2443343",0.322916980257771,15813,0.380462991703324,15856,-0.0575460114455537,-43
"11967","3443343",0.279802771444267,16166,0.351669158503545,16122,-0.0718663870592777,44
"11968","4443343",0.238328440743727,16316,0.309258783381735,16315,-0.0709303426380074,1
"11969","1114343",0.615152184136507,4550,0.654604111450121,4208,-0.0394519273136144,342
"11970","2114343",0.551929011628318,7600,0.598229626809298,7162,-0.0463006151809799,438
"11971","3114343",0.508814802814815,9810,0.569435793609519,8803,-0.060620990794704,1007
"11972","4114343",0.467340472114275,11799,0.527025418487708,11140,-0.0596849463734335,659
"11973","1214343",0.561194406543511,7111,0.599299832504415,7095,-0.0381054259609042,16
"11974","2214343",0.497971234035322,10367,0.542925347863592,10290,-0.0449541138282697,77
"11975","3214343",0.454857025221819,12350,0.514131514663812,11821,-0.0592744894419938,529
"11976","4214343",0.413382694521279,13888,0.471721139542002,13696,-0.0583384450207234,192
"11977","1314343",0.533214936266735,8565,0.572249265171117,8639,-0.0390343289043824,-74
"11978","2314343",0.469991763758546,11693,0.515874780530294,11724,-0.045883016771748,-31
"11979","3314343",0.426877554945043,13445,0.487080947330514,13048,-0.060203392385472,397
"11980","4314343",0.385403224244502,14700,0.444670572208704,14580,-0.0592673479642017,120
"11981","1414343",0.494278438281739,10533,0.531619761203011,10909,-0.0373413229212726,-376
"11982","2414343",0.43105526577355,13304,0.475245276562188,13539,-0.0441900107886382,-235
"11983","3414343",0.387941056960047,14636,0.446451443362409,14530,-0.0585103864023622,106
"11984","4414343",0.346466726259506,15484,0.404041068240598,15518,-0.057574341981092,-34
"11985","1124343",0.547172913270087,7842,0.594034799792715,7401,-0.0468618865226276,441
"11986","2124343",0.483949740761898,11055,0.537660315151891,10600,-0.0537105743899932,455
"11987","3124343",0.440835531948395,12915,0.508866481952112,12070,-0.0680309500037172,845
"11988","4124343",0.399361201247855,14314,0.466456106830302,13870,-0.0670949055824466,444
"11989","1224343",0.493215135677091,10586,0.538730520847008,10536,-0.0455153851699174,50
"11990","2224343",0.429991963168902,13343,0.482356036206185,13240,-0.0523640730372829,103
"11991","3224343",0.386877754355399,14660,0.453562203006406,14298,-0.0666844486510069,362
"11992","4224343",0.345403423654859,15502,0.411151827884595,15379,-0.0657484042297367,123
"11993","1324343",0.465235665400315,11892,0.511679953513711,11949,-0.0464442881133956,-57
"11994","2324343",0.402012492892126,14252,0.455305468872887,14236,-0.0532929759807612,16
"11995","3324343",0.358898284078623,15276,0.426511635673108,15046,-0.0676133515944852,230
"11996","4324343",0.317423953378082,15869,0.384101260551297,15805,-0.0666773071732149,64
"11997","1424343",0.426299167415319,13461,0.471050449545605,13722,-0.0447512821302857,-261
"11998","2424343",0.36307599490713,15205,0.414675964904781,15308,-0.0515999699976514,-103
"11999","3424343",0.319961786093627,15844,0.385882131705002,15782,-0.0659203456113754,62
"12000","4424343",0.278487455393087,16175,0.343471756583192,16174,-0.0649843011901051,1
"12001","1134343",0.503840391104988,10074,0.555569707344686,9600,-0.0517293162396982,474
"12002","2134343",0.440617218596799,12921,0.499195222703862,12537,-0.0585780041070638,384
"12003","3134343",0.397503009783295,14366,0.470401389504083,13748,-0.0728983797207878,618
"12004","4134343",0.356028679082755,15328,0.427991014382273,15024,-0.0719623352995175,304
"12005","1234343",0.449882613511991,12551,0.50026542839898,12482,-0.0503828148869883,69
"12006","2234343",0.386659441003802,14664,0.443890943758156,14607,-0.0572315027543538,57
"12007","3234343",0.343545232190299,15534,0.415097110558377,15298,-0.0715518783680778,236
"12008","4234343",0.302070901489759,16017,0.372686735436566,15949,-0.0706158339468073,68
"12009","1334343",0.421903143235215,13619,0.473214861065682,13638,-0.0513117178304665,-19
"12010","2334343",0.358679970727026,15279,0.416840376424858,15261,-0.058160405697832,18
"12011","3334343",0.315565761913523,15892,0.388046543225079,15755,-0.072480781311556,137
"12012","4334343",0.274091431212983,16198,0.345636168103269,16161,-0.0715447368902856,37
"12013","1434343",0.382966645250219,14761,0.432585357097576,14914,-0.0496187118473566,-153
"12014","2434343",0.31974347274203,15845,0.376210872456753,15909,-0.0564673997147223,-64
"12015","3434343",0.276629263928527,16185,0.347417039256973,16148,-0.0707877753284462,37
"12016","4434343",0.235154933227987,16321,0.305006664135163,16323,-0.0698517309071759,-2
"12017","1144343",0.454806826650158,12353,0.515171213217602,11769,-0.0603643865674438,584
"12018","2144343",0.391583654141969,14553,0.458796728576778,14125,-0.0672130744348093,428
"12019","3144343",0.348469445328466,15464,0.430002895376999,14978,-0.0815334500485334,486
"12020","4144343",0.306995114627926,15978,0.387592520255189,15761,-0.0805974056272629,217
"12021","1244343",0.400849049057162,14285,0.459866934271895,14086,-0.0590178852147336,199
"12022","2244343",0.337625876548973,15635,0.403492449631072,15529,-0.0658665730820991,106
"12023","3244343",0.29451166773547,16074,0.374698616431293,15927,-0.0801869486958232,147
"12024","4244343",0.25303733703493,16276,0.332288241309482,16236,-0.0792509042745528,40
"12025","1344343",0.372869578780386,14993,0.432816366938598,14901,-0.0599467881582118,92
"12026","2344343",0.309646406272197,15960,0.376441882297774,15905,-0.0667954760255774,55
"12027","3344343",0.266532197458693,16231,0.347648049097995,16146,-0.0811158516393014,85
"12028","4344343",0.225057866758153,16338,0.305237673976184,16321,-0.0801798072180311,17
"12029","1444343",0.33393308079539,15683,0.392186862970492,15698,-0.058253782175102,-15
"12030","2444343",0.270709908287201,16218,0.335812378329669,16216,-0.0651024700424677,2
"12031","3444343",0.227595699473697,16334,0.307018545129889,16318,-0.0794228456561918,16
"12032","4444343",0.186121368773157,16374,0.264608170008079,16373,-0.0784868012349214,1
"12033","1111443",0.709535326429104,1486,0.728945156904553,1562,-0.0194098304754491,-76
"12034","2111443",0.646312153920915,3322,0.67257067226373,3417,-0.0262585183428147,-95
"12035","3111443",0.603197945107412,5081,0.64377683906395,4714,-0.0405788939565387,367
"12036","4111443",0.561723614406872,7076,0.60136646394214,6973,-0.0396428495352682,103
"12037","1211443",0.655577548836108,2968,0.673640877958847,3366,-0.0180633291227389,-398
"12038","2211443",0.592354376327919,5574,0.617266393318024,6092,-0.0249120169901045,-518
"12039","3211443",0.549240167514416,7733,0.588472560118244,7687,-0.0392323926038285,46
"12040","4211443",0.507765836813876,9866,0.546062184996434,10109,-0.0382963481825582,-243
"12041","1311443",0.627598078559332,4013,0.646590310625549,4579,-0.0189922320662171,-566
"12042","2311443",0.564374906051143,6956,0.590215825984726,7588,-0.0258409199335827,-632
"12043","3311443",0.521260697237639,9184,0.561421992784946,9242,-0.0401612955473067,-58
"12044","4311443",0.479786366537099,11227,0.519011617663136,11553,-0.0392252511260365,-326
"12045","1411443",0.588661580574336,5748,0.605960806657443,6702,-0.0172992260831073,-954
"12046","2411443",0.525438408066147,8983,0.54958632201662,9914,-0.024147913950473,-931
"12047","3411443",0.482324199252643,11123,0.52079248881684,11453,-0.038468289564197,-330
"12048","4411443",0.440849868552103,12913,0.47838211369503,13400,-0.0375322451429267,-487
"12049","1121443",0.641556055562684,3507,0.668375845247146,3600,-0.0268197896844623,-93
"12050","2121443",0.578332883054495,6283,0.612001360606323,6394,-0.0336684775518279,-111
"12051","3121443",0.535218674240992,8456,0.583207527406544,8001,-0.0479888531655519,455
"12052","4121443",0.493744343540452,10558,0.540797152284733,10433,-0.0470528087442814,125
"12053","1221443",0.587598277969688,5800,0.61307156630144,6325,-0.0254732883317521,-525
"12054","2221443",0.524375105461499,9028,0.556697081660617,9531,-0.0323219761991177,-503
"12055","3221443",0.481260896647996,11172,0.527903248460837,11102,-0.0466423518128417,70
"12056","4221443",0.439786565947456,12955,0.485492873339027,13123,-0.0457063073915714,-168
"12057","1321443",0.559618807692912,7189,0.586020998968142,7832,-0.0264021912752304,-643
"12058","2321443",0.496395635184723,10436,0.529646514327319,11021,-0.0332508791425959,-585
"12059","3321443",0.45328142637122,12416,0.500852681127539,12450,-0.04757125475632,-34
"12060","4321443",0.411807095670679,13946,0.458442306005729,14139,-0.0466352103350496,-193
"12061","1421443",0.520682309707916,9205,0.545391495000036,10147,-0.0247091852921205,-942
"12062","2421443",0.457459137199727,12243,0.489017010359213,12979,-0.0315578731594862,-736
"12063","3421443",0.414344928386223,13867,0.460223177159434,14074,-0.0458782487732103,-207
"12064","4421443",0.372870597685683,14992,0.417812802037623,15241,-0.0449422043519399,-249
"12065","1131443",0.598223533397584,5313,0.629910752799117,5414,-0.031687219401533,-101
"12066","2131443",0.535000360889396,8464,0.573536268158294,8572,-0.0385359072688986,-108
"12067","3131443",0.491886152075892,10651,0.544742434958515,10190,-0.0528562828826226,461
"12068","4131443",0.450411821375352,12527,0.502332059836704,12377,-0.0519202384613523,150
"12069","1231443",0.544265755804588,8003,0.574606473853411,8514,-0.030340718048823,-511
"12070","2231443",0.481042583296399,11180,0.518231989212588,11602,-0.0371894059161886,-422
"12071","3231443",0.437928374482896,13017,0.489438156012808,12958,-0.0515097815299125,59
"12072","4231443",0.396454043782356,14403,0.447027780890998,14515,-0.0505737371086422,-112
"12073","1331443",0.516286285527812,9455,0.547555906520113,10029,-0.0312696209923012,-574
"12074","2331443",0.453063113019623,12427,0.49118142187929,12881,-0.0381183088596668,-454
"12075","3331443",0.40994890420612,13999,0.46238758867951,14002,-0.0524386844733908,-3
"12076","4331443",0.36847457350558,15088,0.4199772135577,15199,-0.0515026400521204,-111
"12077","1431443",0.477349787542816,11352,0.506926402552007,12167,-0.0295766150091914,-815
"12078","2431443",0.414126615034627,13870,0.450551917911184,14396,-0.036425302876557,-526
"12079","3431443",0.371012406221124,15030,0.421758084711405,15153,-0.0507456784902811,-123
"12080","4431443",0.329538075520584,15733,0.379347709589594,15874,-0.0498096340690107,-141
"12081","1141443",0.549189968942755,7736,0.589512258672033,7635,-0.0403222897292785,101
"12082","2141443",0.485966796434566,10957,0.53313777403121,10839,-0.0471709775966441,118
"12083","3141443",0.442852587621062,12833,0.504343940831431,12278,-0.0614913532103681,555
"12084","4141443",0.401378256920523,14267,0.46193356570962,14016,-0.0605553087890977,251
"12085","1241443",0.495232191349759,10484,0.534207979726327,10778,-0.0389757883765683,-294
"12086","2241443",0.43200901884157,13266,0.477833495085504,13427,-0.0458244762439339,-161
"12087","3241443",0.388894810028066,14611,0.449039661885724,14446,-0.060144851857658,165
"12088","4241443",0.347420479327526,15473,0.406629286763914,15471,-0.0592088074363876,2
"12089","1341443",0.467252721072983,11804,0.507157412393029,12156,-0.0399046913200466,-352
"12090","2341443",0.404029548564794,14189,0.450782927752206,14387,-0.0467533791874122,-198
"12091","3341443",0.36091533975129,15240,0.421989094552426,15146,-0.0610737548011362,94
"12092","4341443",0.31944100905075,15847,0.379578719430616,15870,-0.0601377103798659,-23
"12093","1441443",0.428316223087987,13393,0.466527908424923,13867,-0.0382116853369367,-474
"12094","2441443",0.365093050579798,15165,0.4101534237841,15399,-0.0450603732043025,-234
"12095","3441443",0.321978841766294,15823,0.381359590584321,15840,-0.0593807488180265,-17
"12096","4441443",0.280504511065754,16163,0.33894921546251,16199,-0.058444704396756,-36
"12097","1112443",0.676450414667415,2330,0.690626175375901,2724,-0.0141757607084859,-394
"12098","2112443",0.613227242159226,4650,0.634251690735078,5222,-0.0210244485758515,-572
"12099","3112443",0.570113033345723,6683,0.605457857535298,6741,-0.0353448241895755,-58
"12100","4112443",0.528638702645183,8804,0.563047482413488,9159,-0.034408779768305,-355
"12101","1212443",0.622492637074419,4243,0.635321896430195,5163,-0.0128292593557757,-920
"12102","2212443",0.55926946456623,7212,0.578947411789371,8265,-0.0196779472231413,-1053
"12103","3212443",0.516155255752727,9457,0.550153578589592,9888,-0.0339983228368653,-431
"12104","4212443",0.474680925052187,11487,0.507743203467782,12130,-0.0330622784155951,-643
"12105","1312443",0.594513166797643,5492,0.608271329096897,6594,-0.013758162299254,-1102
"12106","2312443",0.531289994289454,8666,0.551896844456074,9799,-0.0206068501666196,-1133
"12107","3312443",0.48817578547595,10845,0.523103011256294,11344,-0.0349272257803436,-499
"12108","4312443",0.44670145477541,12693,0.480692636134484,13314,-0.0339911813590733,-621
"12109","1412443",0.555576668812647,7422,0.567641825128791,8907,-0.0120651563161441,-1485
"12110","2412443",0.492353496304458,10630,0.511267340487968,11973,-0.0189138441835098,-1343
"12111","3412443",0.449239287490955,12584,0.482473507288188,13235,-0.0332342197972338,-651
"12112","4412443",0.407764956790414,14076,0.440063132166378,14712,-0.0322981753759635,-636
"12113","1122443",0.608471143800995,4874,0.630056863718494,5408,-0.0215857199174991,-534
"12114","2122443",0.545247971292806,7951,0.573682379077671,8561,-0.0284344077848647,-610
"12115","3122443",0.502133762479303,10157,0.544888545877891,10179,-0.0427547833985887,-22
"12116","4122443",0.460659431778763,12111,0.502478170756081,12369,-0.0418187389773182,-258
"12117","1222443",0.554513366207999,7475,0.574752584772788,8508,-0.0202392185647889,-1033
"12118","2222443",0.49129019369981,10678,0.518378100131965,11594,-0.0270879064321545,-916
"12119","3222443",0.448175984886307,12629,0.489584266932185,12954,-0.0414082820458785,-325
"12120","4222443",0.406701654185767,14108,0.447173891810375,14510,-0.0404722376246082,-402
"12121","1322443",0.526533895931223,8929,0.54770201743949,10025,-0.0211681215082672,-1096
"12122","2322443",0.463310723423034,11985,0.491327532798667,12872,-0.0280168093756327,-887
"12123","3322443",0.42019651460953,13683,0.462533699598887,13998,-0.0423371849893568,-315
"12124","4322443",0.37872218390899,14862,0.420123324477077,15197,-0.0414011405680865,-335
"12125","1422443",0.487597397946227,10876,0.507072513471384,12162,-0.0194751155251573,-1286
"12126","2422443",0.424374225438038,13535,0.450698028830561,14392,-0.0263238033925231,-857
"12127","3422443",0.381260016624534,14802,0.421904195630782,15150,-0.0406441790062471,-348
"12128","4422443",0.339785685923994,15602,0.379493820508971,15872,-0.0397081345849767,-270
"12129","1132443",0.565138621635896,6931,0.591591771270465,7524,-0.0264531496345698,-593
"12130","2132443",0.501915449127707,10172,0.535217286629642,10728,-0.0333018375019354,-556
"12131","3132443",0.458801240314203,12199,0.506423453429863,12188,-0.0476222131156594,11
"12132","4132443",0.417326909613663,13778,0.464013078308052,13946,-0.0466861686943891,-168
"12133","1232443",0.511180844042899,9710,0.536287492324759,10671,-0.0251066482818598,-961
"12134","2232443",0.44795767153471,12642,0.479913007683936,13343,-0.0319553361492254,-701
"12135","3232443",0.404843462721207,14168,0.451119174484156,14373,-0.0462757117629494,-205
"12136","4232443",0.363369132020667,15198,0.408708799362346,15431,-0.045339667341679,-233
"12137","1332443",0.483201373766123,11088,0.509236924991461,12054,-0.0260355512253381,-966
"12138","2332443",0.419978201257934,13695,0.452862440350638,14314,-0.0328842390927036,-619
"12139","3332443",0.376863992444431,14908,0.424068607150858,15105,-0.0472046147064276,-197
"12140","4332443",0.335389661743891,15661,0.381658232029048,15836,-0.0462685702851572,-175
"12141","1432443",0.444264875781127,12789,0.468607421023355,13805,-0.0243425452422282,-1016
"12142","2432443",0.381041703272938,14811,0.412232936382532,15360,-0.0311912331095939,-549
"12143","3432443",0.337927494459435,15633,0.383439103182753,15814,-0.0455116087233179,-181
"12144","4432443",0.296453163758895,16064,0.341028728060942,16188,-0.0445755643020474,-124
"12145","1142443",0.516105057181066,9462,0.551193277143381,9836,-0.0350882199623154,-374
"12146","2142443",0.452881884672877,12433,0.494818792502558,12724,-0.0419369078296809,-291
"12147","3142443",0.409767675859374,14005,0.466024959302778,13886,-0.0562572834434049,119
"12148","4142443",0.368293345158834,15093,0.423614584180968,15112,-0.0553212390221345,-19
"12149","1242443",0.46214727958807,12042,0.495888998197675,12676,-0.0337417186096051,-634
"12150","2242443",0.398924107079881,14328,0.439514513556852,14724,-0.0405904064769708,-396
"12151","3242443",0.355809898266377,15333,0.410720680357072,15387,-0.0549107820906948,-54
"12152","4242443",0.314335567565837,15907,0.368310305235262,15991,-0.0539747376694245,-84
"12153","1342443",0.434167809311294,13180,0.468838430864377,13799,-0.0346706215530834,-619
"12154","2342443",0.370944636803105,15031,0.412463946223554,15354,-0.0415193094204491,-323
"12155","3342443",0.327830427989601,15761,0.383670113023774,15812,-0.0558396850341731,-51
"12156","4342443",0.286356097289061,16130,0.341259737901964,16186,-0.0549036406129026,-56
"12157","1442443",0.395231311326298,14440,0.428208926896271,15022,-0.0329776155699736,-582
"12158","2442443",0.332008138818109,15703,0.371834442255448,15958,-0.0398263034373393,-255
"12159","3442443",0.288893930004605,16112,0.343040609055669,16176,-0.0541466790510632,-64
"12160","4442443",0.247419599304065,16299,0.300630233933858,16331,-0.0532106346297928,-32
"12161","1113443",0.637567239094929,3656,0.665129584986662,3744,-0.0275623458917326,-88
"12162","2113443",0.57434406658674,6464,0.608755100345839,6569,-0.0344110337590982,-105
"12163","3113443",0.531229857773237,8671,0.579961267146059,8202,-0.0487314093728222,469
"12164","4113443",0.489755527072697,10757,0.537550892024249,10608,-0.0477953649515517,149
"12165","1213443",0.583609461501933,6023,0.609825306040956,6498,-0.0262158445390224,-475
"12166","2213443",0.520386288993745,9219,0.553450821400132,9718,-0.033064532406388,-499
"12167","3213443",0.477272080180241,11358,0.524656988200353,11266,-0.047384908020112,92
"12168","4213443",0.435797749479701,13111,0.482246613078543,13243,-0.0464488635988416,-132
"12169","1313443",0.555629991225157,7421,0.582774738707658,8033,-0.0271447474825006,-612
"12170","2313443",0.492406818716968,10628,0.526400254066835,11176,-0.0339934353498662,-548
"12171","3313443",0.449292609903465,12582,0.497606420867055,12596,-0.0483138109635902,-14
"12172","4313443",0.407818279202925,14075,0.455196045745245,14239,-0.0473777665423199,-164
"12173","1413443",0.516693493240161,9429,0.542145234739552,10344,-0.0254517414993908,-915
"12174","2413443",0.453470320731972,12410,0.485770750098729,13105,-0.0323004293667564,-695
"12175","3413443",0.410356111918469,13985,0.456976916898949,14182,-0.0466208049804804,-197
"12176","4413443",0.368881781217929,15080,0.414566541777139,15312,-0.0456847605592102,-232
"12177","1123443",0.569587968228509,6716,0.604560273329255,6805,-0.0349723051007458,-89
"12178","2123443",0.506364795720321,9935,0.548185788688432,10001,-0.0418209929681114,-66
"12179","3123443",0.463250586906817,11991,0.519391955488652,11537,-0.0561413685818354,454
"12180","4123443",0.421776256206277,13625,0.476981580366842,13472,-0.0552053241605648,153
"12181","1223443",0.515630190635513,9491,0.549255994383549,9938,-0.0336258037480356,-447
"12182","2223443",0.452407018127325,12444,0.492881509742726,12808,-0.0404744916154011,-364
"12183","3223443",0.409292809313821,14021,0.464087676542946,13942,-0.0547948672291251,79
"12184","4223443",0.367818478613281,15102,0.421677301421136,15156,-0.0538588228078549,-54
"12185","1323443",0.487650720358737,10873,0.522205427050251,11393,-0.0345547066915138,-520
"12186","2323443",0.424427547850548,13531,0.465830942409428,13897,-0.0414033945588794,-366
"12187","3323443",0.381313339037045,14799,0.437037109209648,14785,-0.0557237701726034,14
"12188","4323443",0.339839008336505,15601,0.394626734087838,15664,-0.0547877257513331,-63
"12189","1423443",0.448714222373741,12606,0.481575923082145,13274,-0.0328617007084039,-668
"12190","2423443",0.385491049865552,14695,0.425201438441322,15083,-0.0397103885757696,-388
"12191","3423443",0.342376841052049,15557,0.396407605241543,15637,-0.0540307641894937,-80
"12192","4423443",0.300902510351509,16032,0.353997230119732,16098,-0.0530947197682233,-66
"12193","1133443",0.52625544606341,8947,0.566095180881226,8986,-0.0398397348178164,-39
"12194","2133443",0.463032273555221,12000,0.509720696240403,12040,-0.046688422685182,-40
"12195","3133443",0.419918064741718,13699,0.480926863040624,13304,-0.061008798298906,395
"12196","4133443",0.378443734041177,14874,0.438516487918813,14748,-0.0600727538776357,126
"12197","1233443",0.472297668470414,11604,0.51079090193552,11995,-0.0384932334651065,-391
"12198","2233443",0.409074495962225,14032,0.454416417294697,14272,-0.045341921332472,-240
"12199","3233443",0.365960287148721,15148,0.425622584094917,15069,-0.059662296946196,79
"12200","4233443",0.324485956448181,15797,0.383212208973107,15817,-0.0587262525249255,-20
"12201","1333443",0.444318198193637,12786,0.483740334602222,13192,-0.0394221364085847,-406
"12202","2333443",0.381095025685449,14808,0.427365849961399,15036,-0.0462708242759503,-228
"12203","3333443",0.337980816871945,15631,0.398572016761619,15606,-0.0605911998896743,25
"12204","4333443",0.296506486171405,16062,0.356161641639809,16086,-0.0596551554684037,-24
"12205","1433443",0.405381700208642,14155,0.443110830634116,14634,-0.0377291304254748,-479
"12206","2433443",0.342158527700453,15559,0.386736345993293,15774,-0.0445778182928405,-215
"12207","3433443",0.299044318886949,16049,0.357942512793514,16075,-0.0588981939065644,-26
"12208","4433443",0.257569988186409,16265,0.315532137671703,16290,-0.0579621494852939,-25
"12209","1143443",0.47722188160858,11362,0.525696686754142,11218,-0.048474805145562,144
"12210","2143443",0.413998709100391,13872,0.469322202113319,13787,-0.0553234930129275,85
"12211","3143443",0.370884500286888,15033,0.44052836891354,14699,-0.0696438686266516,334
"12212","4143443",0.329410169586348,15736,0.398117993791729,15616,-0.0687078242053811,120
"12213","1243443",0.423264104015584,13574,0.470392407808436,13749,-0.0471283037928518,-175
"12214","2243443",0.360040931507395,15260,0.414017923167613,15324,-0.0539769916602174,-64
"12215","3243443",0.316926722693892,15876,0.385224089967833,15789,-0.0682973672739414,87
"12216","4243443",0.275452391993352,16194,0.342813714846023,16179,-0.067361322852671,15
"12217","1343443",0.395284633738808,14438,0.443341840475138,14626,-0.04805720673633,-188
"12218","2343443",0.332061461230619,15702,0.386967355834315,15769,-0.0549058946036956,-67
"12219","3343443",0.288947252417116,16111,0.358173522634535,16071,-0.0692262702174195,40
"12220","4343443",0.247472921716576,16298,0.315763147512725,16289,-0.0682902257961492,9
"12221","1443443",0.356348135753812,15324,0.402712336507032,15553,-0.0463642007532202,-229
"12222","2443443",0.293124963245623,16085,0.346337851866209,16157,-0.0532128886205858,-72
"12223","3443443",0.25001075443212,16286,0.31754401866643,16285,-0.0675332642343097,1
"12224","4443443",0.20853642373158,16361,0.275133643544619,16364,-0.0665972198130394,-3
"12225","1114443",0.58536016712436,5936,0.620478971613006,5918,-0.0351188044886463,18
"12226","2114443",0.522136994616171,9144,0.564104486972183,9098,-0.0419674923560119,46
"12227","3114443",0.479022785802667,11274,0.535310653772403,10723,-0.056287867969736,551
"12228","4114443",0.437548455102127,13037,0.492900278650593,12806,-0.0553518235484656,231
"12229","1214443",0.531402389531364,8659,0.5651746926673,9030,-0.0337723031359364,-371
"12230","2214443",0.468179217023175,11772,0.508800208026477,12074,-0.040620991003302,-302
"12231","3214443",0.425065008209671,13509,0.480006374826697,13337,-0.0549413666170259,172
"12232","4214443",0.383590677509131,14743,0.437595999704887,14770,-0.0540053221957555,-27
"12233","1314443",0.503422919254587,10096,0.538124125334002,10569,-0.0347012060794146,-473
"12234","2314443",0.440199746746399,12936,0.481749640693179,13263,-0.0415498939467802,-327
"12235","3314443",0.397085537932895,14383,0.452955807493399,14313,-0.0558702695605042,70
"12236","4314443",0.355611207232355,15341,0.410545432371589,15389,-0.0549342251392338,-48
"12237","1414443",0.464486421269591,11934,0.497494621365896,12600,-0.0330082000963047,-666
"12238","2414443",0.401263248761403,14273,0.441120136725073,14683,-0.0398568879636704,-410
"12239","3414443",0.358149039947899,15290,0.412326303525293,15359,-0.0541772635773944,-69
"12240","4414443",0.316674709247359,15882,0.369915928403483,15969,-0.0532412191561241,-87
"12241","1124443",0.51738089625794,9392,0.559909659955599,9342,-0.0425287636976596,50
"12242","2124443",0.454157723749751,12383,0.503535175314776,12319,-0.0493774515650252,64
"12243","3124443",0.411043514936247,13963,0.474741342114997,13564,-0.0636978271787492,399
"12244","4124443",0.369569184235707,15060,0.432330966993186,14921,-0.0627617827574788,139
"12245","1224443",0.463423118664944,11982,0.504605381009893,12265,-0.0411822623449496,-283
"12246","2224443",0.400199946156755,14294,0.44823089636907,14471,-0.0480309502123151,-177
"12247","3224443",0.357085737343251,15310,0.41943706316929,15211,-0.0623513258260391,99
"12248","4224443",0.315611406642711,15891,0.37702668804748,15900,-0.0614152814047688,-9
"12249","1324443",0.435443648388167,13126,0.477554813676595,13443,-0.0421111652884278,-317
"12250","2324443",0.372220475879979,15003,0.421180329035772,15167,-0.0489598531557934,-164
"12251","3324443",0.329106267066475,15740,0.392386495835992,15692,-0.0632802287695174,48
"12252","4324443",0.287631936365935,16120,0.349976120714182,16134,-0.0623441843482469,-14
"12253","1424443",0.396507150403171,14401,0.436925309708489,14791,-0.0404181593053179,-390
"12254","2424443",0.333283977894983,15688,0.380550825067666,15854,-0.0472668471726836,-166
"12255","3424443",0.290169769081479,16099,0.351756991867887,16120,-0.0615872227864075,-21
"12256","4424443",0.248695438380939,16292,0.309346616746076,16313,-0.0606511783651371,-21
"12257","1134443",0.47404837409284,11524,0.52144456750757,11427,-0.0473961934147304,97
"12258","2134443",0.410825201584651,13973,0.465070082866747,13921,-0.054244881282096,52
"12259","3134443",0.367710992771148,15108,0.436276249666968,14810,-0.06856525689582,298
"12260","4134443",0.326236662070608,15776,0.393865874545157,15673,-0.0676292124745496,103
"12261","1234443",0.420090596499844,13689,0.466140288561864,13882,-0.0460496920620203,-193
"12262","2234443",0.356867423991655,15314,0.409765803921041,15411,-0.0528983799293859,-97
"12263","3234443",0.313753215178152,15916,0.380971970721261,15845,-0.0672187555431099,71
"12264","4234443",0.272278884477612,16209,0.338561595599451,16204,-0.0662827111218394,5
"12265","1334443",0.392111126223068,14535,0.439089721228566,14733,-0.0469785950054986,-198
"12266","2334443",0.328887953714879,15743,0.382715236587743,15824,-0.0538272828728641,-81
"12267","3334443",0.285773744901376,16134,0.353921403387964,16100,-0.068147658486588,34
"12268","4334443",0.244299414200836,16306,0.311511028266153,16305,-0.0672116140653176,1
"12269","1434443",0.353174628238072,15383,0.39846021726046,15612,-0.0452855890223887,-229
"12270","2434443",0.289951455729883,16100,0.342085732619637,16183,-0.0521342768897543,-83
"12271","3434443",0.24683724691638,16300,0.313291899419858,16297,-0.0664546525034783,3
"12272","4434443",0.20536291621584,16363,0.270881524298047,16370,-0.065518608082208,-7
"12273","1144443",0.42501480963801,13513,0.481046073380486,13297,-0.0560312637424759,216
"12274","2144443",0.361791637129822,15230,0.424671588739663,15093,-0.0628799516098414,137
"12275","3144443",0.318677428316318,15855,0.395877755539884,15643,-0.0772003272235655,212
"12276","4144443",0.277203097615778,16182,0.353467380418073,16105,-0.076264282802295,77
"12277","1244443",0.371057032045014,15029,0.42574179443478,15064,-0.0546847623897658,-35
"12278","2244443",0.307833859536826,15973,0.369367309793957,15974,-0.0615334502571314,-1
"12279","3244443",0.264719650723322,16238,0.340573476594177,16190,-0.0758538258708553,48
"12280","4244443",0.223245320022782,16340,0.298163101472367,16333,-0.0749177814495849,7
"12281","1344443",0.343077561768238,15544,0.398691227101482,15604,-0.055613665333244,-60
"12282","2344443",0.279854389260049,16165,0.342316742460659,16181,-0.0624623532006095,-16
"12283","3344443",0.236740180446546,16320,0.313522909260879,16295,-0.0767827288143335,25
"12284","4344443",0.195265849746006,16370,0.271112534139069,16368,-0.0758466843930632,2
"12285","1444443",0.304141063783242,16004,0.358061723133376,16074,-0.0539206593501341,-70
"12286","2444443",0.240917891275053,16313,0.301687238492553,16328,-0.0607693472174997,-15
"12287","3444443",0.19780368246155,16367,0.272893405292774,16366,-0.0750897228312238,1
"12288","4444443",0.15632935176101,16383,0.230483030170963,16383,-0.0741536784099534,0
"12289","1111114",0.898955086576993,25,0.906548963767666,20,-0.00759387719067295,5
"12290","2111114",0.835731914068804,138,0.850174479126843,124,-0.0144425650580385,14
"12291","3111114",0.7926177052553,359,0.821380645927063,261,-0.0287629406717625,98
"12292","4111114",0.75114337455476,769,0.778970270805253,651,-0.0278268962504922,118
"12293","1211114",0.844997308983997,110,0.85124468482196,120,-0.00624737583796287,-10
"12294","2211114",0.781774136475808,433,0.794870200181136,463,-0.0130960637053285,-30
"12295","3211114",0.738659927662304,947,0.766076366981357,842,-0.0274164393190525,105
"12296","4211114",0.697185596961764,1769,0.723665991859546,1709,-0.0264803948977821,60
"12297","1311114",0.81701783870722,210,0.824194117488662,249,-0.00717627878144111,-39
"12298","2311114",0.753794666199032,737,0.767819632847838,801,-0.0140249666488067,-64
"12299","3311114",0.710680457385528,1455,0.739025799648059,1333,-0.0283453422625307,122
"12300","4311114",0.669206126684988,2537,0.696615424526249,2520,-0.0274092978412603,17
"12301","1411114",0.778081340722225,468,0.783564613520556,591,-0.00548327279833127,-123
"12302","2411114",0.714858168214036,1370,0.727190128879733,1604,-0.012331960665697,-234
"12303","3411114",0.671743959400532,2452,0.698396295679953,2463,-0.026652336279421,-11
"12304","4411114",0.630269628699992,3906,0.655985920558143,4145,-0.0257162918581506,-239
"12305","1121114",0.830975815710573,155,0.845979652110259,140,-0.0150038363996862,15
"12306","2121114",0.767752643202384,575,0.789605167469436,521,-0.0218525242670518,54
"12307","3121114",0.72463843438888,1184,0.760811334269656,922,-0.0361728998807758,262
"12308","4121114",0.683164103688341,2134,0.718400959147846,1847,-0.0352368554595054,287
"12309","1221114",0.777018038117577,477,0.790675373164553,507,-0.0136573350469761,-30
"12310","2221114",0.713794865609388,1388,0.73430088852373,1431,-0.0205060229143417,-43
"12311","3221114",0.670680656795884,2485,0.70550705532395,2234,-0.0348263985280657,251
"12312","4221114",0.629206326095344,3956,0.66309668020214,3833,-0.0338903541067953,123
"12313","1321114",0.749038567840801,798,0.763624805831255,880,-0.0145862379904543,-82
"12314","2321114",0.685815395332612,2062,0.707250321190432,2175,-0.0214349258578199,-113
"12315","3321114",0.642701186519108,3455,0.678456487990652,3188,-0.0357553014715439,267
"12316","4321114",0.601226855818568,5180,0.636046112868842,5120,-0.0348192570502736,60
"12317","1421114",0.710102069855805,1467,0.722995301863149,1724,-0.0128932320073445,-257
"12318","2421114",0.646878897347616,3307,0.666620817222326,3661,-0.0197419198747102,-354
"12319","3421114",0.603764688534112,5055,0.637826984022546,5047,-0.0340622954884342,8
"12320","4421114",0.562290357833572,7053,0.595416608900736,7322,-0.0331262510671638,-269
"12321","1131114",0.787643293545473,391,0.80751455966223,360,-0.0198712661167569,31
"12322","2131114",0.724420121037284,1187,0.751140075021407,1079,-0.0267199539841225,108
"12323","3131114",0.681305912223781,2192,0.722346241821627,1742,-0.0410403295978465,450
"12324","4131114",0.639831581523241,3570,0.679935866699817,3142,-0.0401042851765762,428
"12325","1231114",0.733685515952477,1030,0.752210280716524,1057,-0.0185247647640469,-27
"12326","2231114",0.670462343444288,2490,0.695835796075701,2545,-0.0253734526314124,-55
"12327","3231114",0.627348134630785,4028,0.667041962875921,3649,-0.0396938282451365,379
"12328","4231114",0.585873803930245,5896,0.624631587754111,5686,-0.0387577838238661,210
"12329","1331114",0.705706045675701,1574,0.725159713383226,1670,-0.0194536677075251,-96
"12330","2331114",0.642482873167512,3463,0.668785228742403,3577,-0.0263023555748907,-114
"12331","3331114",0.599368664354009,5263,0.639991395542623,4919,-0.0406227311886147,344
"12332","4331114",0.557894333653469,7281,0.597581020420813,7202,-0.0396866867673443,79
"12333","1431114",0.666769547690705,2603,0.68453020941512,2946,-0.0177606617244153,-343
"12334","2431114",0.603546375182516,5061,0.628155724774297,5493,-0.024609349591781,-432
"12335","3431114",0.560432166369013,7155,0.599361891574518,7090,-0.038929725205505,65
"12336","4431114",0.518957835668473,9288,0.556951516452707,9511,-0.0379936807842346,-223
"12337","1141114",0.738609729090644,949,0.767116065535146,821,-0.0285063364445024,128
"12338","2141114",0.675386556582455,2356,0.710741580894323,2061,-0.035355024311868,295
"12339","3141114",0.632272347768951,3835,0.681947747694543,3055,-0.049675399925592,780
"12340","4141114",0.590798017068411,5639,0.639537372572733,4950,-0.0487393555043216,689
"12341","1241114",0.684651951497648,2089,0.71181178658944,2018,-0.0271598350917923,71
"12342","2241114",0.621428778989459,4275,0.655437301948617,4168,-0.0340085229591579,107
"12343","3241114",0.578314570175955,6285,0.626643468748837,5586,-0.0483288985728819,699
"12344","4241114",0.536840239475415,8375,0.584233093627027,7936,-0.0473928541516115,439
"12345","1341114",0.656672481220871,2935,0.684761219256142,2936,-0.0280887380352706,-1
"12346","2341114",0.593449308712683,5536,0.628386734615319,5482,-0.0349374259026362,54
"12347","3341114",0.550335099899179,7690,0.599592901415539,7080,-0.0492578015163602,610
"12348","4341114",0.508860769198639,9808,0.557182526293729,9502,-0.0483217570950898,306
"12349","1441114",0.617735983235875,4435,0.644131715288036,4692,-0.0263957320521607,-257
"12350","2441114",0.554512810727687,7476,0.587757230647213,7722,-0.0332444199195264,-246
"12351","3441114",0.511398601914183,9697,0.558963397447434,9400,-0.0475647955332504,297
"12352","4441114",0.469924271213643,11697,0.516553022325623,11689,-0.0466287511119801,8
"12353","1112114",0.865870174815304,67,0.868229982239014,78,-0.00235980742370978,-11
"12354","2112114",0.802647002307115,295,0.81185549759819,322,-0.00920849529107537,-27
"12355","3112114",0.759532793493612,675,0.783061664398411,597,-0.0235288709047994,78
"12356","4112114",0.718058462793072,1302,0.740651289276601,1304,-0.022592826483529,-2
"12357","1212114",0.811912397222308,238,0.812925703293307,313,-0.0010133060709997,-75
"12358","2212114",0.748689224714119,803,0.756551218652484,985,-0.00786199393836529,-182
"12359","3212114",0.705575015900615,1578,0.727757385452705,1593,-0.0221823695520893,-15
"12360","4212114",0.664100685200075,2691,0.685347010330894,2915,-0.0212463251308189,-224
"12361","1312114",0.783932926945532,419,0.78587513596001,568,-0.00194220901447795,-149
"12362","2312114",0.720709754437343,1261,0.729500651319186,1542,-0.00879089688184354,-281
"12363","3312114",0.677595545623839,2300,0.700706818119407,2383,-0.0231112724955675,-83
"12364","4312114",0.636121214923299,3710,0.658296442997596,4040,-0.0221752280742972,-330
"12365","1412114",0.744996428960536,856,0.745245631991904,1203,-0.000249203031368106,-347
"12366","2412114",0.681773256452347,2175,0.688871147351081,2776,-0.0070978908987338,-601
"12367","3412114",0.638659047638843,3611,0.660077314151301,3966,-0.0214182665124578,-355
"12368","4412114",0.597184716938303,5367,0.617666939029491,6067,-0.0204822220911874,-700
"12369","1122114",0.797890903948884,328,0.807660670581607,359,-0.009769766632723,-31
"12370","2122114",0.734667731440695,1016,0.751286185940784,1076,-0.0166184545000886,-60
"12371","3122114",0.691553522627192,1922,0.722492352741004,1737,-0.0309388301138126,185
"12372","4122114",0.650079191926652,3189,0.680081977619194,3135,-0.0300027856925422,54
"12373","1222114",0.743933126355888,869,0.752356391635901,1055,-0.00842326528001291,-186
"12374","2222114",0.680709953847699,2207,0.695981906995077,2539,-0.0152719531473785,-332
"12375","3222114",0.637595745034195,3654,0.667188073795298,3642,-0.0295923287611025,12
"12376","4222114",0.596121414333656,5419,0.624777698673488,5677,-0.0286562843398321,-258
"12377","1322114",0.715953656079112,1348,0.725305824302603,1665,-0.00935216822349116,-317
"12378","2322114",0.652730483570923,3090,0.66893133966178,3568,-0.0162008560908568,-478
"12379","3322114",0.609616274757419,4816,0.640137506462,4906,-0.0305212317045808,-90
"12380","4322114",0.568141944056879,6795,0.59772713134019,7193,-0.0295851872833104,-398
"12381","1422114",0.677017158094116,2315,0.684676320334497,2940,-0.00765916224038132,-625
"12382","2422114",0.613793985585927,4625,0.628301835693674,5485,-0.014507850107747,-860
"12383","3422114",0.570679776772423,6651,0.599508002493894,7083,-0.028828225721471,-432
"12384","4422114",0.529205446071883,8784,0.557097627372084,9505,-0.0278921813002007,-721
"12385","1132114",0.754558381783784,728,0.769195578133578,783,-0.0146371963497938,-55
"12386","2132114",0.691335209275595,1926,0.712821093492755,1988,-0.0214858842171594,-62
"12387","3132114",0.648221000462092,3259,0.684027260292975,2966,-0.0358062598308834,293
"12388","4132114",0.606746669761552,4943,0.641616885171165,4841,-0.034870215409613,102
"12389","1232114",0.700600604190788,1680,0.713891299187872,1966,-0.0132906949970837,-286
"12390","2232114",0.637377431682599,3661,0.657516814547049,4081,-0.0201393828644493,-420
"12391","3232114",0.594263222869096,5504,0.628722981347269,5467,-0.0344597584781733,37
"12392","4232114",0.552788892168556,7548,0.586312606225459,7818,-0.0335237140569029,-270
"12393","1332114",0.672621133914012,2426,0.686840731854574,2859,-0.0142195979405619,-433
"12394","2332114",0.609397961405823,4829,0.630466247213751,5385,-0.0210682858079275,-556
"12395","3332114",0.56628375259232,6876,0.601672414013971,6952,-0.0353886614216515,-76
"12396","4332114",0.52480942189178,9008,0.559262038892161,9378,-0.0344526170003812,-370
"12397","1432114",0.633684635929016,3790,0.646211227886468,4595,-0.0125265919574521,-805
"12398","2432114",0.570461463420827,6666,0.589836743245645,7611,-0.0193752798248178,-945
"12399","3432114",0.527347254607324,8886,0.561042910045865,9261,-0.0336956554385418,-375
"12400","4432114",0.485872923906784,10964,0.518632534924055,11578,-0.0327596110172714,-614
"12401","1142114",0.705524817328955,1580,0.728797084006494,1569,-0.0232722666775392,11
"12402","2142114",0.642301644820766,3473,0.672422599365671,3425,-0.0301209545449048,48
"12403","3142114",0.599187436007262,5268,0.643628766165891,4727,-0.0444413301586288,541
"12404","4142114",0.557713105306722,7288,0.601218391044081,6986,-0.0435052857373585,302
"12405","1242114",0.651567039735959,3138,0.673492805060788,3376,-0.0219257653248291,-238
"12406","2242114",0.58834386722777,5766,0.617118320419965,6103,-0.0287744531921947,-337
"12407","3242114",0.545229658414266,7953,0.588324487220185,7695,-0.0430948288059188,258
"12408","4242114",0.503755327713726,10077,0.545914112098375,10119,-0.0421587843846484,-42
"12409","1342114",0.623587569459182,4200,0.64644223772749,4587,-0.0228546682683074,-387
"12410","2342114",0.560364396950994,7158,0.590067753086667,7598,-0.029703356135673,-440
"12411","3342114",0.51725018813749,9398,0.561273919886887,9250,-0.044023731749397,148
"12412","4342114",0.47577585743695,11437,0.518863544765077,11564,-0.0430876873281266,-127
"12413","1442114",0.584651071474186,5970,0.605812733759384,6714,-0.0211616622851976,-744
"12414","2442114",0.521427898965998,9176,0.549438249118561,9922,-0.0280103501525633,-746
"12415","3442114",0.478313690152494,11306,0.520644415918781,11462,-0.0423307257662873,-156
"12416","4442114",0.436839359451954,13068,0.478234040796971,13410,-0.0413946813450168,-342
"12417","1113114",0.826986999242818,170,0.842733391849775,155,-0.0157463926069564,15
"12418","2113114",0.763763826734629,619,0.786358907208951,565,-0.022595080474322,54
"12419","3113114",0.720649617921126,1263,0.757565074009172,970,-0.036915456088046,293
"12420","4113114",0.679175287220586,2252,0.715154698887362,1933,-0.0359794116667755,319
"12421","1213114",0.773029221649822,519,0.787429112904068,552,-0.0143998912542462,-33
"12422","2213114",0.709806049141633,1473,0.731054628263245,1511,-0.0212485791216118,-38
"12423","3213114",0.66669184032813,2608,0.702260795063466,2351,-0.0355689547353358,257
"12424","4213114",0.62521750962759,4118,0.659850419941655,3980,-0.0346329103140656,138
"12425","1313114",0.745049751373046,855,0.76037854557077,931,-0.0153287941977245,-76
"12426","2313114",0.681826578864857,2170,0.704004060929947,2276,-0.0221774820650901,-106
"12427","3313114",0.638712370051354,3609,0.675210227730168,3314,-0.0364978576788141,295
"12428","4313114",0.597238039350814,5363,0.632799852608357,5279,-0.0355618132575438,84
"12429","1413114",0.70611325338805,1568,0.719749041602665,1810,-0.0136357882146146,-242
"12430","2413114",0.642890080879861,3444,0.663374556961842,3822,-0.0204844760819803,-378
"12431","3413114",0.599775872066358,5239,0.634580723762062,5204,-0.0348048516957044,35
"12432","4413114",0.558301541365818,7263,0.592170348640252,7494,-0.0338688072744341,-231
"12433","1123114",0.759007728376398,678,0.782164080192368,610,-0.0231563518159696,68
"12434","2123114",0.695784555868209,1798,0.725789595551545,1649,-0.0300050396833352,149
"12435","3123114",0.652670347054706,3092,0.696995762351765,2507,-0.0443254152970592,585
"12436","4123114",0.611196016354166,4749,0.654585387229955,4212,-0.0433893708757888,537
"12437","1223114",0.705049950783402,1590,0.726859801246662,1618,-0.0218098504632595,-28
"12438","2223114",0.641826778275213,3488,0.670485316605838,3491,-0.028658538330625,-3
"12439","3223114",0.59871256946171,5291,0.641691483406059,4833,-0.042978913944349,458
"12440","4223114",0.55723823876117,7329,0.599281108284249,7099,-0.0420428695230788,230
"12441","1323114",0.677070480506626,2314,0.699809233913364,2415,-0.0227387534067377,-101
"12442","2323114",0.613847307998437,4621,0.64343474927254,4739,-0.0295874412741033,-118
"12443","3323114",0.570733099184934,6648,0.614640916072761,6229,-0.0439078168878273,419
"12444","4323114",0.529258768484394,8781,0.572230540950951,8641,-0.042971772466557,140
"12445","1423114",0.63813398252163,3632,0.659179729945258,4001,-0.0210457474236279,-369
"12446","2423114",0.574910810013441,6442,0.602805245304435,6888,-0.0278944352909936,-446
"12447","3423114",0.531796601199938,8633,0.574011412104655,8548,-0.0422148109047176,85
"12448","4423114",0.490322270499398,10725,0.531601036982845,10911,-0.0412787664834473,-186
"12449","1133114",0.715675206211299,1354,0.743698987744339,1240,-0.0280237815330403,114
"12450","2133114",0.65245203370311,3101,0.687324503103516,2842,-0.0348724694004059,259
"12451","3133114",0.609337824889606,4834,0.658530669903736,4029,-0.0491928450141299,805
"12452","4133114",0.567863494189066,6807,0.616120294781926,6165,-0.0482568005928596,642
"12453","1233114",0.661717428618303,2765,0.688394708798633,2797,-0.0266772801803303,-32
"12454","2233114",0.598494256110114,5299,0.63202022415781,5317,-0.0335259680476959,-18
"12455","3233114",0.55538004729661,7437,0.60322639095803,6867,-0.0478463436614199,570
"12456","4233114",0.51390571659607,9572,0.56081601583622,9277,-0.0469102992401494,295
"12457","1333114",0.633737958341526,3785,0.661344141465335,3919,-0.0276061831238086,-134
"12458","2333114",0.570514785833337,6659,0.604969656824512,6775,-0.0344548709911742,-116
"12459","3333114",0.527400577019834,8877,0.576175823624732,8416,-0.0487752466048982,461
"12460","4333114",0.485926246319294,10960,0.533765448502922,10807,-0.0478392021836277,153
"12461","1433114",0.59480146035653,5477,0.620714637497229,5901,-0.0259131771406987,-424
"12462","2433114",0.531578287848341,8643,0.564340152856406,9083,-0.0327618650080644,-440
"12463","3433114",0.488464079034838,10832,0.535546319656626,10705,-0.0470822406217885,127
"12464","4433114",0.446989748334298,12680,0.493135944534816,12795,-0.0461461962005179,-115
"12465","1143114",0.666641641756469,2609,0.703300493617255,2305,-0.0366588518607859,304
"12466","2143114",0.60341846924828,5071,0.646926008976432,4563,-0.0435075397281515,508
"12467","3143114",0.560304260434777,7161,0.618132175776652,6041,-0.0578279153418755,1120
"12468","4143114",0.518829929734237,9293,0.575721800654842,8446,-0.056891870920605,847
"12469","1243114",0.612683864163473,4676,0.647996214671549,4504,-0.0353123505080757,172
"12470","2243114",0.549460691655284,7723,0.591621730030725,7520,-0.0421610383754413,203
"12471","3243114",0.506346482841781,9938,0.562827896830946,9176,-0.0564814139891653,762
"12472","4243114",0.464872152141241,11915,0.520417521709136,11475,-0.055545369567895,440
"12473","1343114",0.584704393886697,5967,0.620945647338251,5892,-0.0362412534515539,75
"12474","2343114",0.521481221378508,9171,0.564571162697428,9070,-0.0430899413189195,101
"12475","3343114",0.478367012565005,11303,0.535777329497648,10698,-0.0574103169326435,605
"12476","4343114",0.436892681864465,13066,0.493366954375838,12787,-0.0564742725113732,279
"12477","1443114",0.545767895901701,7923,0.580316143370145,8170,-0.0345482474684441,-247
"12478","2443114",0.482544723393512,11114,0.523941658729322,11301,-0.0413969353358098,-187
"12479","3443114",0.439430514580009,12964,0.495147825529542,12714,-0.0557173109495337,250
"12480","4443114",0.397956183879469,14357,0.452737450407732,14323,-0.0547812665282634,34
"12481","1114114",0.774779927272249,504,0.798082778476119,431,-0.0233028512038703,73
"12482","2114114",0.71155675476406,1432,0.741708293835296,1275,-0.0301515390712359,157
"12483","3114114",0.668442545950556,2560,0.712914460635516,1985,-0.0444719146849599,575
"12484","4114114",0.626968215250016,4037,0.670504085513706,3489,-0.0435358702636895,548
"12485","1214114",0.720822149679252,1258,0.742778499530413,1254,-0.0219563498511602,4
"12486","2214114",0.657598977171064,2900,0.686404014889589,2877,-0.0288050377185258,23
"12487","3214114",0.61448476835756,4586,0.65761018168981,4075,-0.0431254133322498,511
"12488","4214114",0.57301043765702,6534,0.615199806568,6202,-0.0421893689109795,332
"12489","1314114",0.692842679402476,1880,0.715727932197115,1914,-0.0228852527946385,-34
"12490","2314114",0.629619506894287,3927,0.659353447556291,3995,-0.0297339406620041,-68
"12491","3314114",0.586505298080784,5852,0.630559614356512,5378,-0.0440543162757281,474
"12492","4314114",0.545030967380244,7964,0.588149239234702,7704,-0.0431182718544577,260
"12493","1414114",0.65390618141748,3037,0.675098428229009,3316,-0.0211922468115286,-279
"12494","2414114",0.590683008909291,5647,0.618723943588186,6006,-0.0280409346788943,-359
"12495","3414114",0.547568800095788,7808,0.589930110388406,7605,-0.0423613102926184,203
"12496","4414114",0.506094469395248,9946,0.547519735266596,10031,-0.041425265871348,-85
"12497","1124114",0.706800656405829,1549,0.737513466818712,1360,-0.0307128104128835,189
"12498","2124114",0.64357748389764,3409,0.681138982177889,3087,-0.0375614982802491,322
"12499","3124114",0.600463275084136,5205,0.652345148978109,4309,-0.0518818738939731,896
"12500","4124114",0.558988944383596,7226,0.609934773856299,6489,-0.0509458294727028,737
"12501","1224114",0.652842878812832,3085,0.682209187873006,3039,-0.0293663090601735,46
"12502","2224114",0.589619706304644,5703,0.625834703232183,5622,-0.036214996927539,81
"12503","3224114",0.54650549749114,7875,0.597040870032403,7235,-0.0505353725412631,640
"12504","4224114",0.5050311667906,10008,0.554630494910593,9641,-0.0495993281199927,367
"12505","1324114",0.624863408536056,4138,0.655158620539708,4181,-0.0302952120036517,-43
"12506","2324114",0.561640236027867,7081,0.598784135898885,7126,-0.0371438998710173,-45
"12507","3324114",0.518526027214364,9310,0.569990302699105,8776,-0.0514642754847413,534
"12508","4324114",0.477051696513824,11375,0.527579927577295,11116,-0.0505282310634709,259
"12509","1424114",0.58592691055106,5893,0.614529116571602,6233,-0.0286022060205419,-340
"12510","2424114",0.522703738042871,9108,0.558154631930779,9437,-0.0354508938879076,-329
"12511","3424114",0.479589529229368,11234,0.529360798731,11034,-0.0497712695016316,200
"12512","4424114",0.438115198528828,13012,0.486950423609189,13051,-0.0488352250803611,-39
"12513","1134114",0.663468134240729,2721,0.699048374370683,2440,-0.0355802401299543,281
"12514","2134114",0.60024496173254,5218,0.64267388972986,4781,-0.0424289279973199,437
"12515","3134114",0.557130752919037,7338,0.61388005653008,6277,-0.0567493036110439,1061
"12516","4134114",0.515656422218497,9489,0.57146968140827,8697,-0.0558132591897735,792
"12517","1234114",0.609510356647733,4824,0.643744095424977,4718,-0.0342337387772442,106
"12518","2234114",0.546287184139544,7886,0.587369610784154,7750,-0.0410824266446098,136
"12519","3234114",0.50317297532604,10112,0.558575777584374,9420,-0.0554028022583338,692
"12520","4234114",0.4616986446255,12059,0.516165402462564,11708,-0.0544667578370635,351
"12521","1334114",0.581530886370957,6119,0.616693528091679,6127,-0.0351626417207225,-8
"12522","2334114",0.518307713862768,9325,0.560319043450856,9307,-0.0420113295880881,18
"12523","3334114",0.475193505049264,11461,0.531525210251076,10915,-0.0563317052018121,546
"12524","4334114",0.433719174348724,13200,0.489114835129266,12971,-0.0553956607805416,229
"12525","1434114",0.542594388385961,8089,0.576064024123573,8421,-0.0334696357376126,-332
"12526","2434114",0.479371215877772,11249,0.51968953948275,11514,-0.0403183236049783,-265
"12527","3434114",0.436257007064268,13089,0.490895706282971,12893,-0.0546386992187023,196
"12528","4434114",0.394782676363728,14456,0.44848533116116,14462,-0.053702654797432,-6
"12529","1144114",0.614434569785899,4587,0.658649880243599,4027,-0.0442153104576998,560
"12530","2144114",0.55121139727771,7643,0.602275395602776,6918,-0.0510639983250654,725
"12531","3144114",0.508097188464207,9853,0.573481562402996,8577,-0.0653843739387894,1276
"12532","4144114",0.466622857763667,11831,0.531071187281186,10937,-0.064448329517519,894
"12533","1244114",0.560476792192903,7152,0.603345601297893,6858,-0.0428688091049897,294
"12534","2244114",0.497253619684714,10401,0.54697111665707,10057,-0.0497174969723553,344
"12535","3244114",0.454139410871211,12387,0.51817728345729,11607,-0.0640378725860793,780
"12536","4244114",0.412665080170671,13917,0.47576690833548,13519,-0.0631018281648089,398
"12537","1344114",0.532497321916127,8599,0.576295033964595,8408,-0.0437977120484679,191
"12538","2344114",0.469274149407938,11728,0.519920549323772,11498,-0.0506463999158335,230
"12539","3344114",0.426159940594435,13468,0.491126716123992,12884,-0.0649667755295575,584
"12540","4344114",0.384685609893895,14715,0.448716341002182,14455,-0.0640307311082872,260
"12541","1444114",0.493560823931131,10567,0.535665529996489,10702,-0.0421047060653581,-135
"12542","2444114",0.430337651422942,13330,0.479291045355666,13363,-0.0489533939327237,-33
"12543","3444114",0.387223442609439,14652,0.450497212155887,14401,-0.0632737695464478,251
"12544","4444114",0.345749111908899,15497,0.408086837034076,15441,-0.0623377251251774,56
"12545","1111214",0.853106252428783,89,0.861214117112884,91,-0.00810786468410118,-2
"12546","2111214",0.789883079920594,378,0.804839632472061,383,-0.0149565525514668,-5
"12547","3111214",0.74676887110709,829,0.776045799272281,679,-0.0292769281651908,150
"12548","4111214",0.70529454040655,1583,0.733635424150471,1445,-0.0283408837439204,138
"12549","1211214",0.799148474835787,318,0.805909838167178,371,-0.0067613633313911,-53
"12550","2211214",0.735925302327598,993,0.749535353526354,1111,-0.0136100511987567,-118
"12551","3211214",0.692811093514094,1881,0.720741520326575,1786,-0.0279304268124807,95
"12552","4211214",0.651336762813554,3146,0.678331145204765,3191,-0.0269943823912103,-45
"12553","1311214",0.77116900455901,538,0.77885927083388,653,-0.00769026627486935,-115
"12554","2311214",0.707945832050822,1520,0.722484786193056,1739,-0.0145389541422349,-219
"12555","3311214",0.664831623237318,2664,0.693690952993277,2616,-0.028859329755959,48
"12556","4311214",0.623357292536778,4209,0.651280577871467,4356,-0.0279232853346886,-147
"12557","1411214",0.732232506574014,1058,0.738229766865774,1346,-0.00599726029175951,-288
"12558","2411214",0.669009334065826,2541,0.681855282224951,3057,-0.0128459481591252,-516
"12559","3411214",0.625895125252322,4076,0.653061449025171,4279,-0.0271663237728492,-203
"12560","4411214",0.584420794551782,5981,0.610651073903361,6451,-0.0262302793515788,-470
"12561","1121214",0.785126981562363,405,0.800644805455477,415,-0.0155178238931144,-10
"12562","2121214",0.721903809054174,1232,0.744270320814654,1223,-0.02236651176048,9
"12563","3121214",0.67878960024067,2260,0.715476487614874,1918,-0.036686887374204,342
"12564","4121214",0.63731526954013,3664,0.673066112493064,3393,-0.0357508429529336,271
"12565","1221214",0.731169203969367,1075,0.745340526509771,1201,-0.0141713225404043,-126
"12566","2221214",0.667946031461178,2573,0.688966041868948,2774,-0.0210200104077699,-201
"12567","3221214",0.624831822647674,4139,0.660172208669168,3963,-0.0353403860214939,176
"12568","4221214",0.583357491947134,6034,0.617761833547358,6061,-0.0344043416002235,-27
"12569","1321214",0.70318973369259,1629,0.718289959176473,1851,-0.0151002254838826,-222
"12570","2321214",0.639966561184402,3564,0.66191547453565,3889,-0.0219489133512482,-325
"12571","3321214",0.596852352370898,5377,0.63312164133587,5261,-0.0362692889649722,116
"12572","4321214",0.555378021670358,7439,0.59071126621406,7564,-0.0353332445437018,-125
"12573","1421214",0.664253235707594,2687,0.677660455208367,3221,-0.0134072195007727,-534
"12574","2421214",0.601030063199406,5185,0.621285970567544,5873,-0.0202559073681384,-688
"12575","3421214",0.557915854385902,7279,0.592492137367765,7479,-0.0345762829818624,-200
"12576","4421214",0.516441523685362,9441,0.550081762245954,9892,-0.0336402385605921,-451
"12577","1131214",0.741794459397263,892,0.762179713007448,906,-0.0203852536101852,-14
"12578","2131214",0.678571286889074,2270,0.705805228366625,2221,-0.0272339414775508,49
"12579","3131214",0.635457078075571,3727,0.677011395166845,3249,-0.0415543170912748,478
"12580","4131214",0.593982747375031,5512,0.634601020045035,5201,-0.0406182726700044,311
"12581","1231214",0.687836681804267,1996,0.706875434061742,2187,-0.0190387522574751,-191
"12582","2231214",0.624613509296078,4148,0.650500949420919,4396,-0.0258874401248407,-248
"12583","3231214",0.581499300482575,6121,0.621707116221139,5845,-0.0402078157385647,276
"12584","4231214",0.540024969782035,8230,0.579296741099329,8235,-0.0392717713172943,-5
"12585","1331214",0.659857211527491,2812,0.679824866728444,3146,-0.0199676552009533,-334
"12586","2331214",0.596634039019302,5384,0.623450382087621,5757,-0.0268163430683189,-373
"12587","3331214",0.553519830205798,7517,0.594656548887841,7361,-0.0411367186820429,156
"12588","4331214",0.512045499505258,9671,0.552246173766031,9783,-0.0402006742607726,-112
"12589","1431214",0.620920713542495,4292,0.639195362760338,4969,-0.0182746492178435,-677
"12590","2431214",0.557697541034306,7290,0.582820878119515,8028,-0.0251233370852092,-738
"12591","3431214",0.514583332220802,9529,0.554027044919736,9680,-0.0394437126989332,-151
"12592","4431214",0.473109001520262,11562,0.511616669797925,11950,-0.0385076682776628,-388
"12593","1141214",0.692760894942434,1884,0.721781218880364,1759,-0.0290203239379306,125
"12594","2141214",0.629537722434245,3935,0.665406734239541,3726,-0.0358690118052962,209
"12595","3141214",0.586423513620741,5857,0.636612901039761,5095,-0.0501893874190202,762
"12596","4141214",0.544949182920201,7966,0.594202525917951,7393,-0.0492533429977499,573
"12597","1241214",0.638803117349437,3607,0.666476939934658,3668,-0.0276738225852206,-61
"12598","2241214",0.575579944841249,6396,0.610102455293835,6477,-0.0345225104525861,-81
"12599","3241214",0.532465736027745,8600,0.581308622094055,8115,-0.0488428860663102,485
"12600","4241214",0.490991405327205,10690,0.538898246972245,10524,-0.0479068416450398,166
"12601","1341214",0.610823647072661,4760,0.63942637260136,4958,-0.0286027255286988,-198
"12602","2341214",0.547600474564472,7807,0.583051887960537,8016,-0.0354514133960644,-209
"12603","3341214",0.504486265750969,10032,0.554258054760757,9668,-0.0497717890097884,364
"12604","4341214",0.463011935050429,12002,0.511847679638947,11942,-0.048835744588518,60
"12605","1441214",0.571887149087665,6593,0.598796868633254,7123,-0.026909719545589,-530
"12606","2441214",0.508663976579476,9814,0.542422383992431,10324,-0.0337584074129547,-510
"12607","3441214",0.465549767765973,11873,0.513628550792652,11850,-0.0480787830266787,23
"12608","4441214",0.424075437065433,13544,0.471218175670841,13712,-0.0471427386054082,-168
"12609","1112214",0.820021340667094,196,0.822895135584232,255,-0.00287379491713802,-59
"12610","2112214",0.756798168158905,697,0.766520650943408,832,-0.0097224827845036,-135
"12611","3112214",0.713683959345401,1391,0.737726817743629,1355,-0.0240428583982276,36
"12612","4112214",0.672209628644861,2440,0.695316442621819,2567,-0.0231068139769572,-127
"12613","1212214",0.766063563074098,593,0.767590856638526,805,-0.00152729356442793,-212
"12614","2212214",0.702840390565909,1630,0.711216371997702,2039,-0.00837598143179352,-409
"12615","3212214",0.659726181752405,2819,0.682422538797923,3026,-0.0226963570455175,-207
"12616","4212214",0.618251851051865,4420,0.640012163676112,4916,-0.0217603126242472,-496
"12617","1312214",0.738084092797321,957,0.740540289305228,1305,-0.00245619650790618,-348
"12618","2312214",0.674860920289133,2367,0.684165804664404,2962,-0.00930488437527177,-595
"12619","3312214",0.631746711475629,3853,0.655371971464625,4171,-0.0236252599889958,-318
"12620","4312214",0.590272380775089,5682,0.612961596342815,6335,-0.0226892155677254,-653
"12621","1412214",0.699147594812325,1714,0.699910785337122,2412,-0.000763190524796342,-698
"12622","2412214",0.635924422304137,3714,0.643536300696299,4731,-0.00761187839216204,-1017
"12623","3412214",0.592810213490633,5555,0.614742467496519,6223,-0.0219322540058861,-668
"12624","4412214",0.551335882790093,7635,0.572332092374709,8633,-0.0209962095846157,-998
"12625","1122214",0.752042069800674,758,0.762325823926825,904,-0.0102837541261512,-146
"12626","2122214",0.688818897292485,1970,0.705951339286002,2218,-0.0171324419935168,-248
"12627","3122214",0.645704688478981,3340,0.677157506086222,3242,-0.0314528176072408,98
"12628","4122214",0.604230357778441,5041,0.634747130964412,5195,-0.0305167731859705,-154
"12629","1222214",0.698084292207678,1742,0.707021544981119,2183,-0.00893725277344115,-441
"12630","2222214",0.634861119699489,3744,0.650647060340296,4387,-0.0157859406408067,-643
"12631","3222214",0.591746910885985,5594,0.621853227140516,5837,-0.0301063162545308,-243
"12632","4222214",0.550272580185445,7694,0.579442852018706,8229,-0.0291702718332604,-535
"12633","1322214",0.670104821930901,2502,0.679970977647821,3139,-0.0098661557169194,-637
"12634","2322214",0.606881649422713,4935,0.623596493006998,5752,-0.016714843584285,-817
"12635","3322214",0.563767440609209,6970,0.594802659807218,7353,-0.031035219198009,-383
"12636","4322214",0.522293109908669,9133,0.552392284685408,9777,-0.0300991747767386,-644
"12637","1422214",0.631168323945905,3874,0.639341473679715,4964,-0.00817314973380956,-1090
"12638","2422214",0.567945151437717,6802,0.582966989038892,8022,-0.0150218376011753,-1220
"12639","3422214",0.524830942624213,9006,0.554173155839112,9672,-0.0293422132148993,-666
"12640","4422214",0.483356611923673,11079,0.511762780717302,11946,-0.0284061687936289,-867
"12641","1132214",0.708709547635574,1500,0.723860731478796,1704,-0.015151183843222,-204
"12642","2132214",0.645486375127385,3347,0.667486246837973,3630,-0.0219998717105876,-283
"12643","3132214",0.602372166313882,5118,0.638692413638193,5005,-0.0363202473243116,113
"12644","4132214",0.560897835613342,7123,0.596282038516383,7276,-0.0353842029030412,-153
"12645","1232214",0.654751770042578,2993,0.66855645253309,3590,-0.0138046824905119,-597
"12646","2232214",0.591528597534389,5601,0.612181967892267,6379,-0.0206533703578775,-778
"12647","3232214",0.548414388720886,7768,0.583388134692487,7989,-0.0349737459716015,-221
"12648","4232214",0.506940058020346,9907,0.540977759570677,10423,-0.0340377015503311,-516
"12649","1332214",0.626772299765802,4042,0.641505885199792,4846,-0.0147335854339902,-804
"12650","2332214",0.563549127257613,6983,0.585131400558969,7880,-0.0215822733013558,-897
"12651","3332214",0.52043491844411,9213,0.556337567359189,9554,-0.0359026489150798,-341
"12652","4332214",0.47896058774357,11278,0.513927192237379,11835,-0.0349666044938094,-557
"12653","1432214",0.587835801780806,5783,0.600876381231686,7007,-0.0130405794508803,-1224
"12654","2432214",0.524612629272617,9014,0.544501896590863,10206,-0.019889267318246,-1192
"12655","3432214",0.481498420459114,11157,0.515708063391084,11737,-0.03420964293197,-580
"12656","4432214",0.440024089758574,12941,0.473297688269273,13631,-0.0332735985106996,-690
"12657","1142214",0.659675983180745,2823,0.683462237351712,2988,-0.0237862541709675,-165
"12658","2142214",0.596452810672556,5395,0.627087752710889,5557,-0.0306349420383331,-162
"12659","3142214",0.553338601859052,7524,0.598293919511109,7157,-0.0449553176520571,367
"12660","4142214",0.511864271158512,9678,0.555883544389299,9584,-0.0440192732307867,94
"12661","1242214",0.605718205587748,4982,0.628157958406006,5492,-0.0224397528182574,-510
"12662","2242214",0.54249503307956,8093,0.571783473765183,8670,-0.029288440685623,-577
"12663","3242214",0.499380824266056,10296,0.542989640565403,10286,-0.043608816299347,10
"12664","4242214",0.457906493565516,12233,0.500579265443593,12466,-0.0426727718780766,-233
"12665","1342214",0.577738735310972,6308,0.601107391072708,6993,-0.0233686557617356,-685
"12666","2342214",0.514515562802783,9534,0.544732906431885,10191,-0.0302173436291012,-657
"12667","3342214",0.47140135398928,11636,0.515939073232105,11721,-0.0445377192428252,-85
"12668","4342214",0.42992702328874,13347,0.473528698110295,13623,-0.0436016748215548,-276
"12669","1442214",0.538802237325976,8290,0.560477887104602,9298,-0.0216756497786258,-1008
"12670","2442214",0.475579064817787,11442,0.504103402463779,12294,-0.0285243376459915,-852
"12671","3442214",0.432464856004284,13249,0.475309569263999,13537,-0.0428447132597155,-288
"12672","4442214",0.390990525303744,14563,0.432899194142189,14897,-0.0419086688384451,-334
"12673","1113214",0.781138165094608,441,0.797398545194993,436,-0.0162603801003847,5
"12674","2113214",0.717914992586419,1304,0.74102406055417,1290,-0.0231090679677503,14
"12675","3113214",0.674800783772916,2370,0.71223022735439,1998,-0.0374294435814743,372
"12676","4113214",0.633326453072376,3797,0.66981985223258,3516,-0.0364933991602038,281
"12677","1213214",0.727180387501612,1135,0.742094266249287,1265,-0.0149138787476745,-130
"12678","2213214",0.663957214993423,2695,0.685719781608463,2899,-0.0217625666150401,-204
"12679","3213214",0.62084300617992,4294,0.656925948408684,4104,-0.0360829422287641,190
"12680","4213214",0.57936867547938,6237,0.614515573286873,6234,-0.0351468978074938,3
"12681","1313214",0.699200917224836,1713,0.715043698915989,1935,-0.0158427816911527,-222
"12682","2313214",0.635977744716647,3711,0.658669214275165,4026,-0.0226914695585183,-315
"12683","3313214",0.592863535903144,5553,0.629875381075386,5416,-0.0370118451722423,137
"12684","4313214",0.551389205202603,7627,0.587465005953576,7743,-0.0360758007509721,-116
"12685","1413214",0.66026441923984,2806,0.674414194947883,3334,-0.0141497757080429,-528
"12686","2413214",0.597041246731651,5370,0.61803971030706,6044,-0.0209984635754086,-674
"12687","3413214",0.553927037918148,7503,0.58924587710728,7646,-0.0353188391891326,-143
"12688","4413214",0.512452707217607,9646,0.54683550198547,10064,-0.0343827947678623,-418
"12689","1123214",0.713158894228188,1403,0.736829233537586,1379,-0.0236703393093979,24
"12690","2123214",0.649935721719999,3192,0.680454748896763,3117,-0.0305190271767635,75
"12691","3123214",0.606821512906496,4937,0.651660915696983,4331,-0.0448394027904875,606
"12692","4123214",0.565347182205956,6922,0.609250540575173,6536,-0.043903358369217,386
"12693","1223214",0.659201116635192,2842,0.68152495459188,3074,-0.0223238379566877,-232
"12694","2223214",0.595977944127003,5423,0.625150469951056,5661,-0.0291725258240533,-238
"12695","3223214",0.5528637353135,7547,0.596356636751277,7273,-0.0434929014377773,274
"12696","4223214",0.51138940461296,9698,0.553946261629467,9688,-0.042556857016507,10
"12697","1323214",0.631221646358416,3872,0.654474387258582,4217,-0.0232527409001659,-345
"12698","2323214",0.567998473850227,6799,0.598099902617759,7177,-0.0301014287675315,-378
"12699","3323214",0.524884265036724,9002,0.569306069417979,8814,-0.0444218043812555,188
"12700","4323214",0.483409934336184,11076,0.526895694296169,11149,-0.0434857599599853,-73
"12701","1423214",0.59228514837342,5576,0.613844883290476,6281,-0.0215597349170561,-705
"12702","2423214",0.529061975865231,8789,0.557470398649653,9481,-0.0284084227844218,-692
"12703","3423214",0.485947767051728,10959,0.528676565449873,11070,-0.0427287983981458,-111
"12704","4423214",0.444473436351188,12777,0.486266190328063,13084,-0.0417927539768755,-307
"12705","1133214",0.669826372063089,2509,0.698364141089557,2465,-0.0285377690264685,44
"12706","2133214",0.6066031995549,4948,0.641989656448734,4814,-0.0353864568938341,134
"12707","3133214",0.563488990741396,6987,0.613195823248954,6313,-0.0497068325075581,674
"12708","4133214",0.522014660040856,9146,0.570785448127144,8737,-0.0487707880862879,409
"12709","1233214",0.615868594470092,4502,0.643059862143851,4756,-0.0271912676737586,-254
"12710","2233214",0.552645421961903,7555,0.586685377503028,7796,-0.0340399555411242,-241
"12711","3233214",0.5095312131484,9776,0.557891544303248,9452,-0.0483603311548482,324
"12712","4233214",0.46805688244786,11775,0.515481169181438,11749,-0.0474242867335777,26
"12713","1333214",0.587889124193316,5778,0.616009294810553,6169,-0.0281201706172368,-391
"12714","2333214",0.524665951685127,9012,0.55963481016973,9358,-0.0349688584846024,-346
"12715","3333214",0.481551742871624,11153,0.53084097696995,10949,-0.0492892340983264,204
"12716","4333214",0.440077412171084,12940,0.48843060184814,13002,-0.0483531896770559,-62
"12717","1433214",0.54895262620832,7748,0.575379790842447,8466,-0.026427164634127,-718
"12718","2433214",0.485729453700131,10969,0.519005306201624,11554,-0.0332758525014927,-585
"12719","3433214",0.442615244886628,12847,0.490211473001844,12923,-0.0475962281152166,-76
"12720","4433214",0.401140914186088,14274,0.447801097880034,14489,-0.0466601836939461,-215
"12721","1143214",0.620792807608259,4296,0.657965646962473,4055,-0.0371728393542141,241
"12722","2143214",0.55756963510007,7297,0.60159116232165,6956,-0.0440215272215797,341
"12723","3143214",0.514455426286567,9537,0.57279732912187,8602,-0.0583419028353037,935
"12724","4143214",0.472981095586027,11567,0.53038695400006,10980,-0.0574058584140332,587
"12725","1243214",0.566835030015263,6849,0.602661368016767,6894,-0.0358263380015039,-45
"12726","2243214",0.503611857507074,10084,0.546286883375944,10094,-0.0426750258688695,-10
"12727","3243214",0.460497648693571,12119,0.517493050176164,11638,-0.0569954014825935,481
"12728","4243214",0.41902331799303,13725,0.475082675054354,13547,-0.0560593570613232,178
"12729","1343214",0.538855559738487,8286,0.575610800683469,8456,-0.0367552409449822,-170
"12730","2343214",0.475632387230298,11440,0.519236316042646,11545,-0.0436039288123478,-105
"12731","3343214",0.432518178416794,13247,0.490442482842866,12911,-0.0579243044260717,336
"12732","4343214",0.391043847716254,14562,0.448032107721056,14481,-0.0569882600048014,81
"12733","1443214",0.499919061753491,10272,0.534981296715363,10737,-0.0350622349618723,-465
"12734","2443214",0.436695889245302,13071,0.47860681207454,13386,-0.041910922829238,-315
"12735","3443214",0.393581680431798,14488,0.44981297887476,14423,-0.056231298442962,65
"12736","4443214",0.352107349731258,15403,0.40740260375295,15454,-0.0552952540216917,-51
"12737","1114214",0.728931093124038,1103,0.752747931821337,1043,-0.0238168386972986,60
"12738","2114214",0.66570792061585,2633,0.696373447180514,2525,-0.0306655265646641,108
"12739","3114214",0.622593711802346,4236,0.667579613980734,3626,-0.0449859021783882,610
"12740","4114214",0.581119381101806,6139,0.625169238858924,5658,-0.0440498577571178,481
"12741","1214214",0.674973315531042,2362,0.697443652875631,2488,-0.0224703373445885,-126
"12742","2214214",0.611750143022853,4707,0.641069168234807,4870,-0.0293190252119541,-163
"12743","3214214",0.56863593420935,6754,0.612275335035028,6373,-0.0436394008256781,381
"12744","4214214",0.52716160350881,8893,0.569864959913218,8783,-0.0427033564044077,110
"12745","1314214",0.646993845254266,3301,0.670393085542333,3495,-0.0233992402880667,-194
"12746","2314214",0.583770672746077,6007,0.61401860090151,6267,-0.0302479281554323,-260
"12747","3314214",0.540656463932574,8200,0.58522476770173,7874,-0.0445683037691563,326
"12748","4314214",0.499182133232034,10305,0.54281439257992,10299,-0.043632259347886,6
"12749","1414214",0.60805734726927,4890,0.629763581574227,5422,-0.0217062343049569,-532
"12750","2414214",0.544834174761081,7969,0.573389096933404,8580,-0.0285549221723226,-611
"12751","3414214",0.501719965947578,10184,0.544595263733624,10201,-0.0428752977860466,-17
"12752","4414214",0.460245635247038,12127,0.502184888611814,12385,-0.0419392533647762,-258
"12753","1124214",0.660951822257618,2784,0.69217862016393,2662,-0.0312267979063118,122
"12754","2124214",0.59772864974943,5332,0.635804135523107,5132,-0.0380754857736774,200
"12755","3124214",0.554614440935926,7464,0.607010302323327,6652,-0.0523958613874014,812
"12756","4124214",0.513140110235386,9615,0.564599927201517,9067,-0.051459816966131,548
"12757","1224214",0.606994044664622,4931,0.636874341218224,5081,-0.0298802965536017,-150
"12758","2224214",0.543770872156433,8025,0.580499856577401,8159,-0.0367289844209673,-134
"12759","3224214",0.50065666334293,10228,0.551706023377621,9810,-0.0510493600346913,418
"12760","4224214",0.45918233264239,12180,0.509295648255811,12050,-0.0501133156134209,130
"12761","1324214",0.579014574387846,6256,0.609823773884926,6500,-0.0308091994970799,-244
"12762","2324214",0.515791401879657,9477,0.553449289244103,9719,-0.0376578873644455,-242
"12763","3324214",0.472677193066154,11581,0.524655456044323,11267,-0.0519782629781695,314
"12764","4324214",0.431202862365614,13294,0.482245080922513,13244,-0.0510422185568991,50
"12765","1424214",0.54007807640285,8227,0.56919426991682,8821,-0.0291161935139701,-594
"12766","2424214",0.476854903894661,11379,0.512819785275997,11885,-0.0359648813813358,-506
"12767","3424214",0.433740695081158,13197,0.484025952076218,13180,-0.0502852569950598,17
"12768","4424214",0.392266364380618,14526,0.441615576954407,14667,-0.0493492125737894,-141
"12769","1134214",0.617619300092519,4436,0.653713527715901,4247,-0.0360942276233825,189
"12770","2134214",0.55439612758433,7480,0.597339043075078,7217,-0.0429429154907481,263
"12771","3134214",0.511281918770826,9703,0.568545209875299,8859,-0.0572632911044721,844
"12772","4134214",0.469807588070286,11700,0.526134834753488,11193,-0.0563272466832018,507
"12773","1234214",0.563661522499523,6975,0.598409248770195,7151,-0.0347477262706725,-176
"12774","2234214",0.500438349991334,10237,0.542034764129372,10351,-0.041596414138038,-114
"12775","3234214",0.45732414117783,12247,0.513240930929592,11871,-0.0559167897517621,376
"12776","4234214",0.41584981047729,13818,0.470830555807782,13732,-0.0549807453304916,86
"12777","1334214",0.535682052222746,8432,0.571358681436897,8704,-0.0356766292141507,-272
"12778","2334214",0.472458879714558,11592,0.514984196796074,11777,-0.0425253170815163,-185
"12779","3334214",0.429344670901054,13363,0.486190363596294,13088,-0.0568456926952403,275
"12780","4334214",0.387870340200514,14637,0.443779988474484,14610,-0.0559096482739699,27
"12781","1434214",0.49674555423775,10419,0.530729177468791,10954,-0.0339836232310409,-535
"12782","2434214",0.433522381729562,13208,0.474354692827968,13580,-0.0408323110984065,-372
"12783","3434214",0.390408172916058,14578,0.445560859628189,14554,-0.0551526867121305,24
"12784","4434214",0.348933842215518,15453,0.403150484506378,15535,-0.0542166422908602,-82
"12785","1144214",0.568585735637689,6758,0.613315033588817,6305,-0.044729297951128,453
"12786","2144214",0.5053625631295,9984,0.556940548947994,9513,-0.0515779858184936,471
"12787","3144214",0.462248354315997,12034,0.528146715748214,11092,-0.0658983614322176,942
"12788","4144214",0.420774023615457,13658,0.485736340626404,13109,-0.0649623170109472,549
"12789","1244214",0.514627958044693,9525,0.558010754643111,9444,-0.0433827965984179,81
"12790","2244214",0.451404785536504,12482,0.501636270002288,12417,-0.0502314844657835,65
"12791","3244214",0.408290576723001,14048,0.472842436802508,13654,-0.0645518600795075,394
"12792","4244214",0.366816246022461,15125,0.430432061680698,14968,-0.0636158156582371,157
"12793","1344214",0.486648487767917,10922,0.530960187309813,10942,-0.0443116995418962,-20
"12794","2344214",0.423425315259728,13563,0.47458570266899,13571,-0.0511603874092617,-8
"12795","3344214",0.380311106446225,14830,0.44579186946921,14547,-0.0654807630229857,283
"12796","4344214",0.338836775745685,15616,0.4033814943474,15532,-0.0645447186017154,84
"12797","1444214",0.447711989782921,12647,0.490330683341707,12916,-0.0426186935587863,-269
"12798","2444214",0.384488817274732,14717,0.433956198700884,14868,-0.049467381426152,-151
"12799","3444214",0.341374608461229,15571,0.405162365501105,15500,-0.063787757039876,71
"12800","4444214",0.299900277760689,16039,0.362751990379294,16041,-0.0628517126186057,-2
"12801","1111314",0.830652273423475,156,0.843164127185209,151,-0.0125118537617346,5
"12802","2111314",0.767429100915286,579,0.786789642544386,557,-0.0193605416291002,22
"12803","3111314",0.724314892101782,1189,0.757995809344607,961,-0.0336809172428242,228
"12804","4111314",0.682840561401242,2140,0.715585434222796,1916,-0.0327448728215539,224
"12805","1211314",0.776694495830478,479,0.787859848239503,546,-0.0111653524090246,-67
"12806","2211314",0.71347132332229,1396,0.73148536359868,1504,-0.0180140402763902,-108
"12807","3211314",0.670357114508786,2494,0.7026915303989,2332,-0.0323344158901142,162
"12808","4211314",0.628882783808246,3966,0.66028115527709,3958,-0.0313983714688437,8
"12809","1311314",0.748715025553702,801,0.760809280906205,923,-0.0120942553525029,-122
"12810","2311314",0.685491853045513,2069,0.704434796265382,2264,-0.0189429432198684,-195
"12811","3311314",0.64237764423201,3468,0.675640963065602,3303,-0.0332633188335925,165
"12812","4311314",0.60090331353147,5188,0.633230587943792,5256,-0.032327274412322,-68
"12813","1411314",0.709778527568706,1477,0.720179776938099,1803,-0.010401249369393,-326
"12814","2411314",0.646555355060517,3315,0.663805292297276,3805,-0.0172499372367587,-490
"12815","3411314",0.603441146247014,5069,0.635011459097497,5178,-0.0315703128504827,-109
"12816","4411314",0.561966815546474,7066,0.592601083975686,7474,-0.0306342684292122,-408
"12817","1121314",0.762673002557055,630,0.782594815527803,600,-0.0199218129707478,30
"12818","2121314",0.699449830048866,1707,0.726220330886979,1634,-0.0267705008381134,73
"12819","3121314",0.656335621235362,2943,0.6974264976872,2491,-0.0410908764518374,452
"12820","4121314",0.614861290534822,4560,0.655016122565389,4190,-0.0401548320305671,370
"12821","1221314",0.708715224964058,1498,0.727290536582096,1603,-0.0185753116180378,-105
"12822","2221314",0.64549205245587,3345,0.670916051941273,3476,-0.0254239994854034,-131
"12823","3221314",0.602377843642366,5117,0.642122218741494,4809,-0.0397443750991274,308
"12824","4221314",0.560903512941826,7121,0.599711843619683,7072,-0.0388083306778569,49
"12825","1321314",0.680735754687282,2205,0.700239969248798,2398,-0.0195042145615161,-193
"12826","2321314",0.617512582179093,4441,0.643865484607975,4709,-0.0263529024288817,-268
"12827","3321314",0.57439837336559,6461,0.615071651408196,6211,-0.0406732780426057,250
"12828","4321314",0.53292404266505,8579,0.572661276286385,8611,-0.0397372336213352,-32
"12829","1421314",0.641799256702286,3491,0.659610465280693,3988,-0.0178112085784062,-497
"12830","2421314",0.578576084194097,6271,0.603235980639869,6866,-0.0246598964457719,-595
"12831","3421314",0.535461875380594,8443,0.57444214744009,8524,-0.0389802720594959,-81
"12832","4421314",0.493987544680054,10545,0.53203177231828,10890,-0.0380442276382255,-345
"12833","1131314",0.719340480391955,1284,0.744129723079774,1226,-0.0247892426878187,58
"12834","2131314",0.656117307883766,2947,0.68775523843895,2817,-0.0316379305551843,130
"12835","3131314",0.613003099070263,4659,0.658961405239171,4014,-0.0459583061689083,645
"12836","4131314",0.571528768369723,6609,0.616551030117361,6137,-0.0450222617476378,472
"12837","1231314",0.665382702798959,2650,0.688825444134067,2780,-0.0234427413351085,-130
"12838","2231314",0.60215953029077,5125,0.632450959493244,5290,-0.0302914292024741,-165
"12839","3231314",0.559045321477267,7224,0.603657126293465,6844,-0.0446118048161981,380
"12840","4231314",0.517570990776727,9375,0.561246751171654,9252,-0.0436757603949278,123
"12841","1331314",0.637403232522183,3660,0.66177487680077,3897,-0.0243716442785867,-237
"12842","2331314",0.574180060013994,6469,0.605400392159946,6742,-0.0312203321459523,-273
"12843","3331314",0.53106585120049,8679,0.576606558960167,8393,-0.0455407077596763,286
"12844","4331314",0.48959152049995,10763,0.534196183838356,10780,-0.0446046633384061,-17
"12845","1431314",0.598466734537187,5302,0.621145372832664,5879,-0.0226786382954769,-577
"12846","2431314",0.535243562028998,8453,0.56477088819184,9051,-0.0295273261628426,-598
"12847","3431314",0.492129353215494,10639,0.535977054992061,10686,-0.0438477017765666,-47
"12848","4431314",0.450655022514954,12519,0.493566679870251,12772,-0.0429116573552963,-253
"12849","1141314",0.670306915937126,2498,0.70373122895269,2287,-0.033424313015564,211
"12850","2141314",0.607083743428937,4928,0.647356744311866,4540,-0.0402730008829296,388
"12851","3141314",0.563969534615433,6967,0.618562911112087,6016,-0.0545933764966536,951
"12852","4141314",0.522495203914893,9121,0.576152535990276,8420,-0.0536573320753834,701
"12853","1241314",0.616349138344129,4489,0.648426950006983,4476,-0.0320778116628541,13
"12854","2241314",0.55312596583594,7535,0.59205246536616,7500,-0.0389264995302196,35
"12855","3241314",0.510011757022437,9759,0.563258632166381,9149,-0.0532468751439437,610
"12856","4241314",0.468537426321897,11757,0.52084825704457,11450,-0.0523108307226732,307
"12857","1341314",0.588369668067353,5765,0.621376382673685,5866,-0.0330067146063323,-101
"12858","2341314",0.525146495559164,8994,0.565001898032862,9040,-0.0398554024736979,-46
"12859","3341314",0.482032286745661,11137,0.536208064833083,10675,-0.0541757780874219,462
"12860","4341314",0.440557956045121,12923,0.493797689711272,12766,-0.0532397336661514,157
"12861","1441314",0.549433170082357,7727,0.58074687870558,8146,-0.0313137086232225,-419
"12862","2441314",0.486209997574168,10947,0.524372394064756,11279,-0.0381623964905882,-332
"12863","3441314",0.443095788760665,12825,0.495578560864977,12689,-0.0524827721043121,136
"12864","4441314",0.401621458060125,14263,0.453168185743167,14306,-0.0515467276830416,-43
"12865","1112314",0.797567361661786,329,0.804845145656557,382,-0.00727778399477141,-53
"12866","2112314",0.734344189153597,1020,0.748470661015734,1134,-0.014126471862137,-114
"12867","3112314",0.691229980340093,1929,0.719676827815954,1812,-0.028446847475861,117
"12868","4112314",0.649755649639553,3203,0.677266452694144,3238,-0.0275108030545907,-35
"12869","1212314",0.74360958406879,873,0.749540866710851,1110,-0.00593128264206144,-237
"12870","2212314",0.680386411560601,2217,0.693166382070028,2634,-0.012779970509427,-417
"12871","3212314",0.637272202747097,3665,0.664372548870248,3782,-0.027100346123151,-117
"12872","4212314",0.595797872046557,5435,0.621962173748438,5830,-0.0261643017018806,-395
"12873","1312314",0.715630113792013,1357,0.722490299377553,1738,-0.00686018558553969,-381
"12874","2312314",0.652406941283824,3106,0.66611581473673,3688,-0.0137088734529053,-582
"12875","3312314",0.609292732470321,4837,0.63732198153695,5068,-0.0280292490666293,-231
"12876","4312314",0.567818401769781,6809,0.59491160641514,7349,-0.0270932046453588,-540
"12877","1412314",0.676693615807017,2323,0.681860795409447,3056,-0.00516717960242985,-733
"12878","2412314",0.613470443298828,4638,0.625486310768624,5637,-0.0120158674697955,-999
"12879","3412314",0.570356234485325,6673,0.596692477568845,7253,-0.0263362430835196,-580
"12880","4412314",0.528881903784785,8796,0.554282102447034,9667,-0.0254001986622491,-871
"12881","1122314",0.729588090795366,1097,0.74427583399915,1222,-0.0146877432037846,-125
"12882","2122314",0.666364918287177,2620,0.687901349358327,2813,-0.0215364310711502,-193
"12883","3122314",0.623250709473673,4214,0.659107516158548,4004,-0.0358568066848742,210
"12884","4122314",0.581776378773133,6102,0.616697141036737,6125,-0.034920762263604,-23
"12885","1222314",0.67563031320237,2347,0.688971555053444,2773,-0.0133412418510747,-426
"12886","2222314",0.612407140694181,4687,0.632597070412621,5287,-0.0201899297184402,-600
"12887","3222314",0.569292931880677,6727,0.603803237212841,6835,-0.0345103053321643,-108
"12888","4222314",0.527818601180137,8853,0.561392862091031,9245,-0.0335742609108938,-392
"12889","1322314",0.647650842925593,3277,0.661920987720146,3888,-0.0142701447945529,-611
"12890","2322314",0.584427670417405,5980,0.605546503079323,6731,-0.0211188326619185,-751
"12891","3322314",0.541313461603901,8162,0.576752669879544,8385,-0.0354392082756425,-223
"12892","4322314",0.499839130903361,10276,0.534342294757733,10773,-0.034503163854372,-497
"12893","1422314",0.608714344940597,4862,0.62129148375204,5871,-0.0125771388114431,-1009
"12894","2422314",0.545491172432409,7935,0.564916999111217,9046,-0.0194258266788088,-1111
"12895","3422314",0.502376963618905,10144,0.536123165911438,10677,-0.0337462022925328,-533
"12896","4422314",0.460902632918365,12101,0.493712790789627,12768,-0.0328101578712622,-667
"12897","1132314",0.686255568630266,2050,0.705810741551122,2220,-0.0195551729208555,-170
"12898","2132314",0.623032396122077,4217,0.649436256910298,4438,-0.0264038607882211,-221
"12899","3132314",0.579918187308574,6207,0.620642423710519,5905,-0.0407242364019451,302
"12900","4132314",0.538443856608034,8305,0.578232048588708,8305,-0.0397881919806746,0
"12901","1232314",0.63229779103727,3834,0.650506462605415,4395,-0.0182086715681453,-561
"12902","2232314",0.569074618529081,6732,0.594131977964592,7398,-0.0250573594355109,-666
"12903","3232314",0.525960409715578,8960,0.565338144764813,9023,-0.0393777350492349,-63
"12904","4232314",0.484486079015038,11015,0.522927769643002,11351,-0.0384416906279647,-336
"12905","1332314",0.604318320760494,5037,0.623455895272117,5756,-0.0191375745116236,-719
"12906","2332314",0.541095148252305,8170,0.567081410631294,8936,-0.0259862623789892,-766
"12907","3332314",0.497980939438802,10366,0.538287577431515,10564,-0.0403066379927132,-198
"12908","4332314",0.456506608738261,12278,0.495877202309704,12677,-0.0393705935714428,-399
"12909","1432314",0.565381822775498,6918,0.582826391304012,8027,-0.0174445685285137,-1109
"12910","2432314",0.502158650267309,10155,0.526451906663188,11174,-0.0242932563958794,-1019
"12911","3432314",0.459044441453806,12186,0.497658073463409,12593,-0.0386136320096034,-407
"12912","4432314",0.417570110753265,13766,0.455247698341599,14237,-0.0376775875883331,-471
"12913","1142314",0.637222004175437,3668,0.665412247424037,3725,-0.0281902432486009,-57
"12914","2142314",0.573998831667248,6481,0.609037762783214,6549,-0.0350389311159665,-68
"12915","3142314",0.530884622853744,8686,0.580243929583435,8174,-0.0493593067296905,512
"12916","4142314",0.489410292153204,10775,0.537833554461624,10589,-0.0484232623084202,186
"12917","1242314",0.58326422658244,6037,0.610107968478331,6476,-0.0268437418958909,-439
"12918","2242314",0.520041054074251,9234,0.553733483837508,9701,-0.0336924297632565,-467
"12919","3242314",0.476926845260748,11377,0.524939650637729,11250,-0.0480128053769805,127
"12920","4242314",0.435452514560208,13125,0.482529275515918,13230,-0.04707676095571,-105
"12921","1342314",0.555284756305664,7441,0.583057401145033,8015,-0.0277726448393691,-574
"12922","2342314",0.492061583797475,10641,0.52668291650421,11159,-0.0346213327067347,-518
"12923","3342314",0.448947374983972,12598,0.497889083304431,12585,-0.0489417083204587,13
"12924","4342314",0.407473044283432,14084,0.45547870818262,14230,-0.0480056638991882,-146
"12925","1442314",0.516348258320668,9449,0.542427897176928,10323,-0.0260796388562593,-874
"12926","2442314",0.453125085812479,12423,0.486053412536104,13092,-0.0329283267236249,-669
"12927","3442314",0.410010876998976,13997,0.457259579336325,14168,-0.047248702337349,-171
"12928","4442314",0.368536546298436,15086,0.414849204214514,15304,-0.0463126579160785,-218
"12929","1113314",0.7586841860893,683,0.779348555267318,644,-0.0206643691780181,39
"12930","2113314",0.695461013581111,1810,0.722974070626495,1726,-0.0275130570453836,84
"12931","3113314",0.652346804767608,3111,0.694180237426715,2604,-0.0418334326591077,507
"12932","4113314",0.610872474067068,4759,0.651769862304905,4329,-0.0408973882378372,430
"12933","1213314",0.704726408496304,1597,0.724044276321612,1697,-0.0193178678253079,-100
"12934","2213314",0.641503235988115,3508,0.667669791680789,3622,-0.0261665556926735,-114
"12935","3213314",0.598389027174612,5304,0.638875958481009,4995,-0.0404869313063975,309
"12936","4213314",0.556914696474072,7348,0.596465583359199,7265,-0.0395508868851272,83
"12937","1313314",0.676746938219528,2321,0.696993708988314,2508,-0.0202467707687861,-187
"12938","2313314",0.613523765711339,4635,0.640619224347491,4889,-0.0270954586361517,-254
"12939","3313314",0.570409556897836,6670,0.611825391147711,6408,-0.0414158342498757,262
"12940","4313314",0.528935226197295,8792,0.569415016025901,8806,-0.0404797898286055,-14
"12941","1413314",0.637810440234532,3641,0.656364205020208,4130,-0.0185537647856763,-489
"12942","2413314",0.574587267726343,6452,0.599989720379385,7058,-0.025402452653042,-606
"12943","3413314",0.53147305891284,8651,0.571195887179606,8714,-0.039722828266766,-63
"12944","4413314",0.4899987282123,10746,0.528785512057795,11065,-0.0387867838454957,-319
"12945","1123314",0.69070491522288,1934,0.718779243609911,1834,-0.0280743283870313,100
"12946","2123314",0.627481742714691,4019,0.662404758969088,3863,-0.0349230162543969,156
"12947","3123314",0.584367533901188,5985,0.633610925769309,5240,-0.0492433918681209,745
"12948","4123314",0.542893203200648,8074,0.591200550647498,7542,-0.0483073474468504,532
"12949","1223314",0.636747137629884,3682,0.663474964664205,3818,-0.0267278270343211,-136
"12950","2223314",0.573523965121695,6503,0.607100480023382,6647,-0.0335765149016867,-144
"12951","3223314",0.530409756308192,8711,0.578306646823602,8301,-0.0478968905154107,410
"12952","4223314",0.488935425607652,10801,0.535896271701792,10692,-0.0469608460941404,109
"12953","1323314",0.608767667353108,4858,0.636424397330907,5102,-0.0276567299777993,-244
"12954","2323314",0.545544494844919,7930,0.580049912690084,8191,-0.0345054178451649,-261
"12955","3323314",0.502430286031416,10140,0.551256079490305,9831,-0.0488257934588889,309
"12956","4323314",0.460955955330876,12097,0.508845704368494,12071,-0.0478897490376187,26
"12957","1423314",0.569831169368112,6698,0.595794893362801,7306,-0.0259637239946895,-608
"12958","2423314",0.506607996859923,9921,0.539420408721978,10506,-0.0328124118620552,-585
"12959","3423314",0.46349378804642,11976,0.510626575522199,12003,-0.0471327874757792,-27
"12960","4423314",0.42201945734588,13612,0.468216200400388,13816,-0.0461967430545089,-204
"12961","1133314",0.647372393057781,3289,0.680314151161883,3122,-0.0329417581041019,167
"12962","2133314",0.584149220549592,5995,0.623939666521059,5727,-0.0397904459714675,268
"12963","3133314",0.541035011736088,8174,0.59514583332128,7336,-0.0541108215851915,838
"12964","4133314",0.499560681035548,10286,0.552735458199469,9762,-0.0531747771639213,524
"12965","1233314",0.593414615464784,5538,0.625009872216176,5665,-0.031595256751392,-127
"12966","2233314",0.530191442956595,8724,0.568635387575353,8851,-0.0384439446187576,-127
"12967","3233314",0.487077234143092,10903,0.539841554375574,10481,-0.0527643202324816,422
"12968","4233314",0.445602903442552,12727,0.497431179253763,12603,-0.051828275811211,124
"12969","1333314",0.565435145188008,6916,0.597959304882878,7183,-0.0325241596948702,-267
"12970","2333314",0.502211972679819,10152,0.541584820242055,10383,-0.0393728475622358,-231
"12971","3333314",0.459097763866316,12184,0.512790987042276,11887,-0.0536932231759598,297
"12972","4333314",0.417623433165776,13762,0.470380611920465,13750,-0.0527571787546893,12
"12973","1433314",0.526498647203012,8931,0.557329800914773,9488,-0.0308311537117604,-557
"12974","2433314",0.463275474694823,11989,0.500955316273949,12443,-0.0376798415791261,-454
"12975","3433314",0.42016126588132,13684,0.47216148307417,13682,-0.05200021719285,2
"12976","4433314",0.37868693518078,14864,0.42975110795236,14984,-0.0510641727715796,-120
"12977","1143314",0.598338828602951,5307,0.639915657034798,4924,-0.0415768284318475,383
"12978","2143314",0.535115656094762,8460,0.583541172393975,7977,-0.0484255162992131,483
"12979","3143314",0.492001447281259,10647,0.554747339194196,9637,-0.0627458919129371,1010
"12980","4143314",0.450527116580719,12523,0.512336964072385,11916,-0.0618098474916666,607
"12981","1243314",0.544381051009955,7996,0.584611378089092,7912,-0.0402303270791373,84
"12982","2243314",0.481157878501766,11175,0.528236893448269,11089,-0.0470790149465029,86
"12983","3243314",0.438043669688263,13014,0.499443060248489,12526,-0.0613993905602269,488
"12984","4243314",0.396569338987722,14399,0.457032685126679,14179,-0.0604633461389567,220
"12985","1343314",0.516401580733179,9444,0.557560810755794,9476,-0.0411592300226156,-32
"12986","2343314",0.45317840822499,12421,0.501186326114971,12435,-0.0480079178899812,-14
"12987","3343314",0.410064199411486,13995,0.472392492915192,13673,-0.0623282935037051,322
"12988","4343314",0.368589868710946,15085,0.429982117793381,14979,-0.0613922490824349,106
"12989","1443314",0.477465082748183,11347,0.516931306787689,11671,-0.0394662240395057,-324
"12990","2443314",0.414241910239994,13868,0.460556822146865,14063,-0.0463149119068714,-195
"12991","3443314",0.37112770142649,15025,0.431762988947086,14938,-0.0606352875205954,87
"12992","4443314",0.32965337072595,15730,0.389352613825275,15739,-0.0596992430993251,-9
"12993","1114314",0.70647711411873,1559,0.734697941893662,1425,-0.0282208277749321,134
"12994","2114314",0.643253941610541,3428,0.678323457252839,3192,-0.0350695156422977,236
"12995","3114314",0.600139732797038,5229,0.64952962405306,4432,-0.0493898912560217,797
"12996","4114314",0.558665402096498,7242,0.607119248931249,6645,-0.0484538468347512,597
"12997","1214314",0.652519336525734,3099,0.679393662947956,3162,-0.0268743264222219,-63
"12998","2214314",0.589296164017545,5722,0.623019178307133,5785,-0.0337230142895875,-63
"12999","3214314",0.546181955204042,7892,0.594225345107353,7392,-0.0480433899033115,500
"13000","4214314",0.504707624503502,10019,0.551814969985543,9804,-0.0471073454820412,215
"13001","1314314",0.624539866248958,4153,0.652343095614658,4310,-0.0278032293657001,-157
"13002","2314314",0.561316693740769,7101,0.595968610973835,7295,-0.0346519172330657,-194
"13003","3314314",0.518202484927266,9338,0.567174777774055,8931,-0.0489722928467897,407
"13004","4314314",0.476728154226726,11389,0.524764402652245,11262,-0.0480362484255195,127
"13005","1414314",0.585603368263962,5910,0.611713591646552,6411,-0.0261102233825903,-501
"13006","2414314",0.522380195755773,9126,0.555339107005729,9611,-0.032958911249956,-485
"13007","3414314",0.47926598694227,11256,0.52654527380595,11166,-0.04727928686368,90
"13008","4414314",0.43779165624173,13024,0.484134898684139,13177,-0.0463432424424097,-153
"13009","1124314",0.63849784325231,3617,0.674128630236256,3343,-0.0356307869839453,274
"13010","2124314",0.575274670744121,6416,0.617754145595432,6062,-0.0424794748513109,354
"13011","3124314",0.532160461930618,8615,0.588960312395653,7660,-0.0567998504650349,955
"13012","4124314",0.490686131230078,10700,0.546549937273842,10081,-0.0558638060437644,619
"13013","1224314",0.584540065659314,5973,0.618824351290549,6002,-0.0342842856312351,-29
"13014","2224314",0.521316893151125,9182,0.562449866649726,9199,-0.0411329734986007,-17
"13015","3224314",0.478202684337622,11310,0.533656033449947,10816,-0.0554533491123247,494
"13016","4224314",0.436728353637082,13070,0.491245658328136,12878,-0.0545173046910544,192
"13017","1324314",0.556560595382538,7363,0.591773783957251,7510,-0.0352131885747133,-147
"13018","2324314",0.493337422874349,10576,0.535399299316428,10718,-0.0420618764420789,-142
"13019","3324314",0.450223214060846,12537,0.506605466116649,12180,-0.0563822520558029,357
"13020","4324314",0.408748883360306,14037,0.464195090994838,13939,-0.0554462076345326,98
"13021","1424314",0.517624097397542,9369,0.551144279989146,9838,-0.0335201825916035,-469
"13022","2424314",0.454400924889353,12367,0.494769795348322,12727,-0.0403688704589691,-360
"13023","3424314",0.41128671607585,13954,0.465975962148543,13887,-0.0546892460726932,67
"13024","4424314",0.36981238537531,15052,0.423565587026733,15113,-0.0537532016514228,-61
"13025","1134314",0.595165321087211,5465,0.635663537788227,5137,-0.0404982167010159,328
"13026","2134314",0.531942148579022,8625,0.579289053147403,8236,-0.0473469045683815,389
"13027","3134314",0.488827939765518,10808,0.550495219947624,9869,-0.0616672801821055,939
"13028","4134314",0.447353609064978,12663,0.508084844825814,12109,-0.0607312357608353,554
"13029","1234314",0.541207543494215,8165,0.58035925884252,8167,-0.039151715348306,-2
"13030","2234314",0.477984370986026,11320,0.523984774201697,11298,-0.0460004032156716,22
"13031","3234314",0.434870162172522,13153,0.495190941001918,12712,-0.0603207788293955,441
"13032","4234314",0.393395831471982,14491,0.452780565880107,14321,-0.0593847344081251,170
"13033","1334314",0.513228073217438,9610,0.553308691509223,9729,-0.0400806182917842,-119
"13034","2334314",0.45000490070925,12543,0.496934206868399,12621,-0.0469293061591498,-78
"13035","3334314",0.406890691895746,14104,0.46814037366862,13819,-0.0612496817728738,285
"13036","4334314",0.365416361195206,15157,0.425729998546809,15065,-0.0603136373516033,92
"13037","1434314",0.474291575232442,11508,0.512679187541117,11892,-0.0383876123086744,-384
"13038","2434314",0.411068402724253,13961,0.456304702900294,14196,-0.04523630017604,-235
"13039","3434314",0.36795419391075,15098,0.427510869700514,15032,-0.059556675789764,66
"13040","4434314",0.32647986321021,15770,0.385100494578704,15790,-0.0586206313684937,-20
"13041","1144314",0.546131756632381,7897,0.595265043661143,7331,-0.0491332870287615,566
"13042","2144314",0.482908584124192,11098,0.538890559020319,10525,-0.0559819748961271,573
"13043","3144314",0.439794375310689,12953,0.51009672582054,12025,-0.0703023505098511,928
"13044","4144314",0.398320044610149,14341,0.46768635069873,13834,-0.0693663060885806,507
"13045","1244314",0.492173979039385,10634,0.539960764715436,10478,-0.0477867856760513,156
"13046","2244314",0.428950806531196,13379,0.483586280074613,13201,-0.0546354735434169,178
"13047","3244314",0.385836597717693,14682,0.454792446874834,14262,-0.0689558491571409,420
"13048","4244314",0.344362267017153,15521,0.412382071753023,15358,-0.0680198047358705,163
"13049","1344314",0.464194508762609,11946,0.512910197382138,11883,-0.0487156886195296,63
"13050","2344314",0.40097133625442,14280,0.456535712741315,14192,-0.0555643764868951,88
"13051","3344314",0.357857127440917,15296,0.427741879541536,15028,-0.0698847521006192,268
"13052","4344314",0.316382796740377,15885,0.385331504419725,15788,-0.0689487076793489,97
"13053","1444314",0.425258010777613,13498,0.472280693414033,13677,-0.0470226826364197,-179
"13054","2444314",0.362034838269424,15225,0.415906208773209,15279,-0.0538713705037854,-54
"13055","3444314",0.31892062945592,15851,0.38711237557343,15766,-0.0681917461175095,85
"13056","4444314",0.277446298755381,16178,0.34470200045162,16167,-0.0672557016962391,11
"13057","1111414",0.800860256411327,306,0.809038987348094,345,-0.0081787309367668,-39
"13058","2111414",0.737637083903138,966,0.752664502707271,1045,-0.0150274188041324,-79
"13059","3111414",0.694522875089635,1829,0.723870669507491,1703,-0.0293477944178564,126
"13060","4111414",0.653048544389095,3074,0.681460294385681,3077,-0.028411749996586,-3
"13061","1211414",0.746902478818331,826,0.753734708402388,1027,-0.00683222958405671,-201
"13062","2211414",0.683679306310142,2110,0.697360223761564,2493,-0.0136809174514223,-383
"13063","3211414",0.640565097496639,3541,0.668566390561785,3589,-0.0280012930651463,-48
"13064","4211414",0.599090766796099,5274,0.626156015439975,5608,-0.0270652486438759,-334
"13065","1311414",0.718923008541555,1289,0.72668414106909,1622,-0.00776113252753496,-333
"13066","2311414",0.655699836033366,2956,0.670309656428267,3498,-0.0146098203949006,-542
"13067","3311414",0.612585627219863,4680,0.641515823228487,4845,-0.0289301960086246,-165
"13068","4311414",0.571111296519323,6635,0.599105448106677,7110,-0.0279941515873542,-475
"13069","1411414",0.679986510556559,2228,0.686054637100984,2887,-0.00606812654442512,-659
"13070","2411414",0.61676333804837,4467,0.629680152460161,5424,-0.0129168144117908,-957
"13071","3411414",0.573649129234867,6498,0.600886319260381,7006,-0.0272371900255148,-508
"13072","4411414",0.532174798534327,8613,0.558475944138571,9424,-0.0263011456042445,-811
"13073","1121414",0.732880985544907,1045,0.748469675690687,1135,-0.01558869014578,-90
"13074","2121414",0.669657813036718,2517,0.692095191049864,2664,-0.0224373780131456,-147
"13075","3121414",0.626543604223215,4055,0.663301357850084,3825,-0.0367577536268696,230
"13076","4121414",0.585069273522675,5950,0.620890982728274,5894,-0.0358217092055992,56
"13077","1221414",0.678923207951911,2258,0.693165396744981,2635,-0.0142421887930699,-377
"13078","2221414",0.615700035443722,4508,0.636790912104158,5085,-0.0210908766604355,-577
"13079","3221414",0.572585826630219,6557,0.607997078904378,6607,-0.0354112522741595,-50
"13080","4221414",0.531111495929679,8677,0.565586703782568,9010,-0.0344752078528892,-333
"13081","1321414",0.650943737675135,3156,0.666114829411683,3689,-0.0151710917365482,-533
"13082","2321414",0.587720565166946,5788,0.60974034477086,6508,-0.0220197796039138,-720
"13083","3321414",0.544606356353443,7988,0.58094651157108,8136,-0.0363401552176378,-148
"13084","4321414",0.503132025652903,10115,0.53853613644927,10547,-0.0354041107963674,-432
"13085","1421414",0.612007239690139,4703,0.625485325443577,5638,-0.0134780857534383,-935
"13086","2421414",0.54878406718195,7751,0.569110840802754,8826,-0.020326773620804,-1075
"13087","3421414",0.505669858368447,9968,0.540317007602975,10458,-0.034647149234528,-490
"13088","4421414",0.464195527667907,11945,0.497906632481164,12583,-0.0337111048132576,-638
"13089","1131414",0.689548463379808,1956,0.710004583242658,2082,-0.0204561198628508,-126
"13090","2131414",0.626325290871619,4062,0.653630098601835,4250,-0.0273048077302164,-188
"13091","3131414",0.583211082058115,6040,0.624836265402056,5675,-0.0416251833439404,365
"13092","4131414",0.541736751357575,8138,0.582425890280245,8058,-0.04068913892267,80
"13093","1231414",0.635590685786811,3725,0.654700304296952,4201,-0.0191096185101407,-476
"13094","2231414",0.572367513278623,6568,0.598325819656129,7154,-0.0259583063775063,-586
"13095","3231414",0.529253304465119,8783,0.569531986456349,8801,-0.0402786819912303,-18
"13096","4231414",0.487778973764579,10869,0.527121611334539,11136,-0.0393426375699599,-267
"13097","1331414",0.607611215510035,4911,0.627649736963654,5528,-0.020038521453619,-617
"13098","2331414",0.544388043001846,7994,0.571275252322831,8708,-0.0268872093209845,-714
"13099","3331414",0.501273834188343,10211,0.542481419123051,10319,-0.0412075849347086,-108
"13100","4331414",0.459799503487803,12152,0.500071044001241,12493,-0.0402715405134382,-341
"13101","1431414",0.568674717525039,6752,0.587020232995548,7773,-0.0183455154705091,-1021
"13102","2431414",0.50545154501685,9977,0.530645748354725,10961,-0.0251942033378748,-984
"13103","3431414",0.462337336203347,12030,0.501851915154946,12404,-0.0395145789515988,-374
"13104","4431414",0.420863005502807,13656,0.459441540033135,14104,-0.0385785345303284,-448
"13105","1141414",0.640514898924978,3546,0.669606089115574,3531,-0.0290911901905962,15
"13106","2141414",0.577291726416789,6325,0.613231604474751,6308,-0.0359398780579618,17
"13107","3141414",0.534177517603286,8503,0.584437771274972,7922,-0.0502602536716859,581
"13108","4141414",0.492703186902746,10610,0.542027396153161,10353,-0.0493242092504155,257
"13109","1241414",0.586557121331982,5850,0.614301810169868,6248,-0.0277446888378862,-398
"13110","2241414",0.523333948823793,9070,0.557927325529045,9447,-0.0345933767052518,-377
"13111","3241414",0.48021974001029,11211,0.529133492329265,11046,-0.0489137523189758,165
"13112","4241414",0.43874540930975,12985,0.486723117207455,13063,-0.0479777078977053,-78
"13113","1341414",0.558577651055206,7250,0.58725124283657,7757,-0.0286735917813644,-507
"13114","2341414",0.495354478547017,10473,0.530876758195747,10946,-0.03552227964873,-473
"13115","3341414",0.452240269733513,12454,0.502082924995967,12390,-0.049842655262454,64
"13116","4341414",0.410765939032973,13975,0.459672549874157,14093,-0.0489066108411836,-118
"13117","1441414",0.51964115307021,9245,0.546621738868464,10074,-0.0269805857982546,-829
"13118","2441414",0.456417980562021,12282,0.490247254227641,12920,-0.0338292736656202,-638
"13119","3441414",0.413303771748517,13893,0.461453421027862,14034,-0.0481496492793442,-141
"13120","4441414",0.371829441047977,15011,0.419043045906051,15215,-0.0472136048580738,-204
"13121","1112414",0.767775344649638,574,0.770720005819442,759,-0.00294466116980363,-185
"13122","2112414",0.704552172141449,1601,0.714345521178619,1953,-0.00979334903716922,-352
"13123","3112414",0.661437963327946,2776,0.685551687978839,2907,-0.0241137246508932,-131
"13124","4112414",0.619963632627406,4336,0.643141312857029,4754,-0.0231776802296229,-418
"13125","1212414",0.713817567056642,1387,0.715415726873736,1919,-0.00159815981709355,-532
"13126","2212414",0.650594394548453,3163,0.659041242232912,4009,-0.00844684768445914,-846
"13127","3212414",0.60748018573495,4912,0.630247409033133,5395,-0.0227672232981831,-483
"13128","4212414",0.56600585503441,6888,0.587837033911323,7718,-0.0218311788769128,-830
"13129","1312414",0.685838096779866,2060,0.688365159540438,2798,-0.0025270627605718,-738
"13130","2312414",0.622614924271677,4234,0.631990674899614,5318,-0.00937575062793738,-1084
"13131","3312414",0.579500715458174,6231,0.603196841699835,6868,-0.0236961262416614,-637
"13132","4312414",0.538026384757634,8330,0.560786466578025,9279,-0.022760081820391,-949
"13133","1412414",0.64690159879487,3305,0.647735655572332,4514,-0.000834056777461956,-1209
"13134","2412414",0.583678426286681,6016,0.591361170931509,7533,-0.00768274464482765,-1517
"13135","3412414",0.540564217473178,8206,0.562567337731729,9188,-0.0220031202585517,-982
"13136","4412414",0.499089886772638,10318,0.520156962609919,11485,-0.0210670758372813,-1167
"13137","1122414",0.699796073783218,1699,0.710150694162035,2077,-0.0103546203788168,-378
"13138","2122414",0.636572901275029,3693,0.653776209521212,4243,-0.0172033082461824,-550
"13139","3122414",0.593458692461526,5535,0.624982376321432,5667,-0.0315236838599064,-132
"13140","4122414",0.551984361760986,7598,0.582572001199622,8047,-0.0305876394386361,-449
"13141","1222414",0.645838296190222,3336,0.654846415216329,4194,-0.00900811902610676,-858
"13142","2222414",0.582615123682033,6055,0.598471930575506,7145,-0.0158568068934724,-1090
"13143","3222414",0.53950091486853,8254,0.569678097375726,8792,-0.0301771825071964,-538
"13144","4222414",0.49802658416799,10364,0.527267722253916,11130,-0.029241138085926,-766
"13145","1322414",0.617858825913446,4429,0.627795847883031,5520,-0.00993702196958501,-1091
"13146","2322414",0.554635653405257,7462,0.571421363242208,8700,-0.0167857098369506,-1238
"13147","3322414",0.511521444591754,9693,0.542627530042428,10310,-0.0311060854506746,-617
"13148","4322414",0.470047113891214,11691,0.500217154920618,12485,-0.0301700410294042,-794
"13149","1422414",0.57892232792845,6262,0.587166343914925,7764,-0.00824401598647517,-1502
"13150","2422414",0.515699155420261,9483,0.530791859274102,10952,-0.0150927038538409,-1469
"13151","3422414",0.472584946606758,11589,0.501998026074323,12394,-0.0294130794675649,-805
"13152","4422414",0.431110615906218,13303,0.459587650952512,14098,-0.0284770350462945,-795
"13153","1132414",0.656463551618119,2939,0.671685601714006,3449,-0.0152220500958876,-510
"13154","2132414",0.59324037910993,5541,0.615311117073183,6197,-0.0220707379632532,-656
"13155","3132414",0.550126170296426,7699,0.586517283873404,7807,-0.0363911135769772,-108
"13156","4132414",0.508651839595886,9816,0.544106908751593,10233,-0.0354550691557068,-417
"13157","1232414",0.602505774025123,5109,0.6163813227683,6147,-0.0138755487431775,-1038
"13158","2232414",0.539282601516934,8261,0.560006838127477,9335,-0.0207242366105431,-1074
"13159","3232414",0.49616839270343,10448,0.531213004927697,10928,-0.0350446122242671,-480
"13160","4232414",0.45469406200289,12358,0.488802629805887,12986,-0.0341085678029967,-628
"13161","1332414",0.574526303748346,6457,0.589330755435002,7641,-0.0148044516866558,-1184
"13162","2332414",0.511303131240157,9701,0.532956270794179,10851,-0.0216531395540214,-1150
"13163","3332414",0.468188922426654,11771,0.504162437594399,12289,-0.0359735151677454,-518
"13164","4332414",0.426714591726114,13448,0.461752062472589,14023,-0.035037470746475,-575
"13165","1432414",0.53558980576335,8437,0.548701251466896,9964,-0.0131114457035459,-1527
"13166","2432414",0.472366633255161,11597,0.492326766826073,12836,-0.0199601335709116,-1239
"13167","3432414",0.429252424441658,13369,0.463532933626294,13960,-0.0342805091846356,-591
"13168","4432414",0.387778093741118,14641,0.421122558504483,15168,-0.0333444647633652,-527
"13169","1142414",0.607429987163289,4915,0.631287107586922,5344,-0.0238571204236331,-429
"13170","2142414",0.5442068146551,8006,0.574912622946099,8493,-0.0307058082909987,-487
"13171","3142414",0.501092605841597,10212,0.546118789746319,10108,-0.0450261839047227,104
"13172","4142414",0.459618275141057,12156,0.503708414624509,12312,-0.0440901394834523,-156
"13173","1242414",0.553472209570293,7520,0.575982828641216,8426,-0.022510619070923,-906
"13174","2242414",0.490249037062104,10728,0.519608344000393,11523,-0.0293593069382886,-795
"13175","3242414",0.447134828248601,12673,0.490814510800613,12899,-0.0436796825520125,-226
"13176","4242414",0.405660497548061,14146,0.448404135678803,14465,-0.0427436381307422,-319
"13177","1342414",0.525492739293517,8982,0.548932261307918,9954,-0.0234395220144012,-972
"13178","2342414",0.462269566785328,12031,0.492557776667095,12824,-0.0302882098817668,-793
"13179","3342414",0.419155357971824,13722,0.463763943467315,13954,-0.0446085854954908,-232
"13180","4342414",0.377681027271285,14891,0.421353568345505,15162,-0.0436725410742204,-271
"13181","1442414",0.486556241308521,10930,0.508302757339812,12094,-0.0217465160312914,-1164
"13182","2442414",0.423333068800332,13567,0.451928272698989,14349,-0.028595203898657,-782
"13183","3442414",0.380218859986829,14834,0.42313443949921,15125,-0.042915579512381,-291
"13184","4442414",0.338744529286289,15620,0.380724064377399,15848,-0.0419795350911106,-228
"13185","1113414",0.728892169077153,1104,0.745223415430203,1204,-0.0163312463530503,-100
"13186","2113414",0.665668996568964,2636,0.68884893078938,2779,-0.0231799342204159,-143
"13187","3113414",0.62255478775546,4238,0.6600550975896,3967,-0.0375003098341399,271
"13188","4113414",0.58108045705492,6142,0.61764472246779,6068,-0.0365642654128694,74
"13189","1213414",0.674934391484157,2363,0.689919136484497,2743,-0.0149847450003401,-380
"13190","2213414",0.611711218975968,4710,0.633544651843673,5243,-0.0218334328677057,-533
"13191","3213414",0.568597010162464,6756,0.604750818643894,6788,-0.0361538084814297,-32
"13192","4213414",0.527122679461924,8896,0.562340443522084,9202,-0.0352177640601594,-306
"13193","1313414",0.64695492120738,3302,0.662868569151199,3846,-0.0159136479438183,-544
"13194","2313414",0.583731748699192,6009,0.606494084510375,6675,-0.0227623358111839,-666
"13195","3313414",0.540617539885688,8202,0.577700251310596,8340,-0.0370827114249079,-138
"13196","4313414",0.499143209185148,10309,0.535289876188786,10724,-0.0361466670036377,-415
"13197","1413414",0.608018423222384,4892,0.622239065183093,5817,-0.0142206419607085,-925
"13198","2413414",0.544795250714196,7973,0.56586458054227,8995,-0.0210693298280742,-1022
"13199","3413414",0.501681041900692,10187,0.53707074734249,10632,-0.0353897054417982,-445
"13200","4413414",0.460206711200152,12130,0.49466037222068,12731,-0.0344536610205279,-601
"13201","1123414",0.660912898210733,2786,0.684654103772796,2941,-0.0237412055620635,-155
"13202","2123414",0.597689725702544,5336,0.628279619131973,5487,-0.0305898934294291,-151
"13203","3123414",0.55457551688904,7468,0.599485785932193,7084,-0.0449102690431531,384
"13204","4123414",0.5131011861885,9619,0.557075410810383,9506,-0.0439742246218826,113
"13205","1223414",0.606955120617737,4932,0.62934982482709,5440,-0.0223947042093533,-508
"13206","2223414",0.543731948109548,8026,0.572975340186267,8597,-0.0292433920767189,-571
"13207","3223414",0.500617739296044,10230,0.544181506986487,10226,-0.0435637676904429,4
"13208","4223414",0.459143408595504,12182,0.501771131864677,12409,-0.0426277232691726,-227
"13209","1323414",0.57897565034096,6258,0.602299257493792,6916,-0.0233236071528315,-658
"13210","2323414",0.515752477832772,9480,0.545924772852969,10118,-0.0301722950201971,-638
"13211","3323414",0.472638269019268,11584,0.517130939653189,11658,-0.0444926706339211,-74
"13212","4323414",0.431163938318728,13298,0.474720564531379,13565,-0.0435566262126508,-267
"13213","1423414",0.540039152355964,8229,0.561669753525686,9231,-0.0216306011697217,-1002
"13214","2423414",0.476815979847776,11383,0.505295268884863,12235,-0.0284792890370874,-852
"13215","3423414",0.433701771034272,13202,0.476501435685083,13492,-0.0427996646508114,-290
"13216","4423414",0.392227440333732,14530,0.434091060563273,14864,-0.041863620229541,-334
"13217","1133414",0.617580376045633,4438,0.646189011324767,4597,-0.0286086352791342,-159
"13218","2133414",0.554357203537444,7483,0.589814526683944,7613,-0.0354573231464997,-130
"13219","3133414",0.511242994723941,9705,0.561020693484165,9262,-0.0497776987602238,443
"13220","4133414",0.469768664023401,11702,0.518610318362354,11581,-0.0488416543389535,121
"13221","1233414",0.563622598452637,6977,0.590884732379061,7552,-0.0272621339264242,-575
"13222","2233414",0.500399425944448,10241,0.534510247738238,10763,-0.0341108217937898,-522
"13223","3233414",0.457285217130944,12248,0.505716414538458,12215,-0.0484311974075138,33
"13224","4233414",0.415810886430405,13820,0.463306039416648,13967,-0.0474951529862432,-147
"13225","1333414",0.535643128175861,8434,0.563834165045763,9114,-0.0281910368699024,-680
"13226","2333414",0.472419955667672,11594,0.50745968040494,12139,-0.035039724737268,-545
"13227","3333414",0.429305746854168,13365,0.47866584720516,13384,-0.049360100350992,-19
"13228","4333414",0.387831416153629,14638,0.43625547208335,14812,-0.0484240559297214,-174
"13229","1433414",0.496706630190865,10421,0.523204661077657,11334,-0.0264980308867926,-913
"13230","2433414",0.433483457682676,13213,0.466830176436834,13855,-0.0333467187541582,-642
"13231","3433414",0.390369248869172,14581,0.438036343237055,14759,-0.0476670943678822,-178
"13232","4433414",0.348894918168633,15455,0.395625968115244,15649,-0.0467310499466116,-194
"13233","1143414",0.568546811590803,6762,0.605790517197683,6716,-0.0372437056068797,46
"13234","2143414",0.505323639082615,9987,0.54941603255686,9924,-0.0440923934742453,63
"13235","3143414",0.462209430269111,12036,0.52062219935708,11463,-0.0584127690879693,573
"13236","4143414",0.420735099568571,13659,0.47821182423527,13411,-0.0574767246666988,248
"13237","1243414",0.514589033997807,9528,0.550486238251977,9870,-0.0358972042541695,-342
"13238","2243414",0.451365861489619,12484,0.494111753611154,12753,-0.0427458921215351,-269
"13239","3243414",0.408251652676115,14049,0.465317920411374,13913,-0.0570662677352591,136
"13240","4243414",0.366777321975575,15127,0.422907545289564,15130,-0.0561302233139888,-3
"13241","1343414",0.486609563721031,10925,0.523435670918679,11325,-0.0368261071976478,-400
"13242","2343414",0.423386391212842,13564,0.467061186277856,13848,-0.0436747950650133,-284
"13243","3343414",0.380272182399339,14831,0.438267353078076,14752,-0.0579951706787373,79
"13244","4343414",0.338797851698799,15617,0.395856977956266,15644,-0.057059126257467,-27
"13245","1443414",0.447673065736035,12651,0.482806166950573,13222,-0.0351331012145379,-571
"13246","2443414",0.384449893227846,14720,0.42643168230975,15049,-0.0419817890819035,-329
"13247","3443414",0.341335684414343,15574,0.39763784910997,15624,-0.0563021646956275,-50
"13248","4443414",0.299861353713803,16041,0.35522747398816,16091,-0.0553661202743572,-50
"13249","1114414",0.676685097106583,2324,0.700572802056547,2387,-0.0238877049499642,-63
"13250","2114414",0.613461924598394,4639,0.644198317415724,4689,-0.0307363928173298,-50
"13251","3114414",0.57034771578489,6674,0.615404484215944,6192,-0.0450567684310538,482
"13252","4114414",0.528873385084351,8797,0.572994109094134,8596,-0.0441207240097834,201
"13253","1214414",0.622727319513587,4226,0.645268523110841,4639,-0.0225412035972541,-413
"13254","2214414",0.559504147005398,7193,0.588894038470018,7665,-0.0293898914646197,-472
"13255","3214414",0.516389938191894,9445,0.560100205270238,9325,-0.0437102670783437,120
"13256","4214414",0.474915607491354,11478,0.517689830148428,11631,-0.0427742226570733,-153
"13257","1314414",0.594747849236811,5480,0.618217955777543,6036,-0.0234701065407323,-556
"13258","2314414",0.531524676728622,8648,0.56184347113672,9226,-0.0303187944080979,-578
"13259","3314414",0.488410467915118,10836,0.53304963793694,10845,-0.0446391700218219,-9
"13260","4314414",0.446936137214578,12684,0.49063926281513,12906,-0.0437031256005515,-222
"13261","1414414",0.555811351251815,7408,0.577588451809437,8343,-0.0217771005576225,-935
"13262","2414414",0.492588178743626,10614,0.521213967168614,11434,-0.0286257884249882,-820
"13263","3414414",0.449473969930122,12572,0.492420133968834,12831,-0.0429461640387122,-259
"13264","4414414",0.407999639229582,14064,0.450009758847024,14419,-0.0420101196174418,-355
"13265","1124414",0.608705826240163,4865,0.64000349039914,4917,-0.0312976641589774,-52
"13266","2124414",0.545482653731974,7936,0.583629005758317,7972,-0.038146352026343,-36
"13267","3124414",0.502368444918471,10145,0.554835172558538,9633,-0.052466727640067,512
"13268","4124414",0.460894114217931,12102,0.512424797436727,11911,-0.0515306832187966,191
"13269","1224414",0.554748048647167,7457,0.584699211453434,7907,-0.0299511628062673,-450
"13270","2224414",0.491524876138978,10662,0.528324726812611,11086,-0.0367998506736329,-424
"13271","3224414",0.448410667325474,12622,0.499530893612831,12521,-0.0511202262873569,101
"13272","4224414",0.406936336624934,14102,0.457120518491021,14176,-0.0501841818660865,-74
"13273","1324414",0.526768578370391,8916,0.557648644120136,9467,-0.0308800657497456,-551
"13274","2324414",0.463545405862202,11973,0.501274159479313,12432,-0.0377287536171111,-459
"13275","3324414",0.420431197048698,13677,0.472480326279533,13669,-0.0520491292308351,8
"13276","4324414",0.378956866348158,14858,0.430069951157723,14976,-0.0511130848095647,-118
"13277","1424414",0.487832080385395,10865,0.51701914015203,11663,-0.0291870597666357,-798
"13278","2424414",0.424608907877206,13523,0.460644655511207,14060,-0.0360357476340014,-537
"13279","3424414",0.381494699063702,14795,0.431850822311428,14933,-0.0503561232477253,-138
"13280","4424414",0.340020368363162,15594,0.389440447189617,15737,-0.0494200788264549,-143
"13281","1134414",0.565373304075063,6919,0.601538397951111,6959,-0.0361650938760482,-40
"13282","2134414",0.502150131566874,10156,0.545163913310288,10160,-0.0430137817434137,-4
"13283","3134414",0.459035922753371,12187,0.516370080110509,11699,-0.0573341573571378,488
"13284","4134414",0.417561592052831,13767,0.473959704988698,13602,-0.0563981129358673,165
"13285","1234414",0.511415526482067,9696,0.546234119005405,10098,-0.0348185925233381,-402
"13286","2234414",0.448192353973878,12628,0.489859634364582,12941,-0.0416672803907036,-313
"13287","3234414",0.405078145160375,14166,0.461065801164802,14049,-0.0559876560044276,117
"13288","4234414",0.363603814459835,15193,0.418655426042992,15226,-0.0550516115831572,-33
"13289","1334414",0.483436056205291,11075,0.519183551672107,11548,-0.0357474954668163,-473
"13290","2334414",0.420212883697102,13681,0.462809067031284,13984,-0.0425961833341819,-303
"13291","3334414",0.377098674883599,14906,0.434015233831504,14866,-0.0569165589479058,40
"13292","4334414",0.335624344183059,15659,0.391604858709694,15708,-0.0559805145266354,-49
"13293","1434414",0.444499558220295,12776,0.478554047704001,13388,-0.0340544894837064,-612
"13294","2434414",0.381276385712106,14801,0.422179563063178,15141,-0.0409031773510721,-340
"13295","3434414",0.338162176898603,15628,0.393385729863399,15679,-0.055223552964796,-51
"13296","4434414",0.296687846198063,16059,0.350975354741588,16125,-0.0542875085435257,-66
"13297","1144414",0.516339739620234,9450,0.561139903824027,9258,-0.0448001642037936,192
"13298","2144414",0.453116567112045,12424,0.504765419183204,12254,-0.0516488520711592,170
"13299","3144414",0.410002358298541,13998,0.475971585983425,13510,-0.0659692276848832,488
"13300","4144414",0.368528027598001,15087,0.433561210861614,14878,-0.0650331832636127,209
"13301","1244414",0.462381962027238,12026,0.505835624878321,12211,-0.0434536628510835,-185
"13302","2244414",0.399158789519049,14319,0.449461140237498,14439,-0.0503023507184491,-120
"13303","3244414",0.356044580705545,15326,0.420667307037718,15187,-0.064622726332173,139
"13304","4244414",0.314570250005005,15902,0.378256931915908,15885,-0.0636866819109026,17
"13305","1344414",0.434402491750461,13173,0.478785057545023,13382,-0.0443825657945617,-209
"13306","2344414",0.371179319242273,15022,0.4224105729042,15138,-0.0512312536619273,-116
"13307","3344414",0.328065110428769,15758,0.39361673970442,15676,-0.0655516292756512,82
"13308","4344414",0.286590779728229,16128,0.35120636458261,16124,-0.0646155848543809,4
"13309","1444414",0.395465993765465,14431,0.438155553576917,14753,-0.0426895598114518,-322
"13310","2444414",0.332242821257277,15698,0.381781068936094,15834,-0.0495382476788175,-136
"13311","3444414",0.289128612443773,16108,0.352987235736315,16111,-0.0638586232925415,-3
"13312","4444414",0.247654281743233,16295,0.310576860614504,16309,-0.0629225788712712,-14
"13313","1111124",0.843906316769669,116,0.856760439658038,103,-0.0128541228883684,13
"13314","2111124",0.78068314426148,445,0.800385955017214,420,-0.019702810755734,25
"13315","3111124",0.737568935447977,970,0.771592121817435,745,-0.034023186369458,225
"13316","4111124",0.696094604747437,1792,0.729181746695625,1553,-0.0330871419481877,239
"13317","1211124",0.789948539176673,376,0.801456160712331,411,-0.0115076215356584,-35
"13318","2211124",0.726725366668484,1146,0.745081676071508,1213,-0.018356309403024,-67
"13319","3211124",0.683611157854981,2115,0.716287842871729,1902,-0.032676685016748,213
"13320","4211124",0.642136827154441,3479,0.673877467749918,3352,-0.0317406405954775,127
"13321","1311124",0.761969068899897,642,0.774405593379033,708,-0.0124365244791367,-66
"13322","2311124",0.698745896391708,1722,0.71803110873821,1862,-0.0192852123465023,-140
"13323","3311124",0.655631687578204,2962,0.689237275538431,2766,-0.0336055879602263,196
"13324","4311124",0.614157356877665,4605,0.64682690041662,4569,-0.0326695435389558,36
"13325","1411124",0.723032570914901,1211,0.733776089410928,1442,-0.0107435184960268,-231
"13326","2411124",0.659809398406712,2817,0.677401604770104,3231,-0.0175922063633925,-414
"13327","3411124",0.616695189593208,4474,0.648607771570325,4467,-0.0319125819771165,7
"13328","4411124",0.575220858892669,6423,0.606197396448515,6689,-0.0309765375558461,-266
"13329","1121124",0.775927045903249,490,0.796191128000631,453,-0.0202640820973816,37
"13330","2121124",0.71270387339506,1412,0.739816643359808,1321,-0.0271127699647472,91
"13331","3121124",0.669589664581557,2524,0.711022810160028,2050,-0.0414331455784712,474
"13332","4121124",0.628115333881017,3995,0.668612435038218,3588,-0.040497101157201,407
"13333","1221124",0.721969268310253,1230,0.740886849054925,1295,-0.0189175807446716,-65
"13334","2221124",0.658746095802064,2857,0.684512364414101,2948,-0.0257662686120372,-91
"13335","3221124",0.615631886988561,4515,0.655718531214322,4159,-0.0400866442257612,356
"13336","4221124",0.574157556288021,6471,0.613308156092512,6306,-0.0391505998044908,165
"13337","1321124",0.693989798033477,1843,0.713836281721627,1970,-0.0198464836881499,-127
"13338","2321124",0.630766625525288,3882,0.657461797080803,4085,-0.0266951715555155,-203
"13339","3321124",0.587652416711784,5793,0.628667963881024,5470,-0.0410155471692395,323
"13340","4321124",0.546178086011245,7893,0.586257588759214,7823,-0.040079502747969,70
"13341","1421124",0.655053300048481,2986,0.673206777753521,3388,-0.0181534777050401,-402
"13342","2421124",0.591830127540292,5591,0.616832293112698,6119,-0.0250021655724058,-528
"13343","3421124",0.548715918726788,7756,0.588038459912918,7710,-0.0393225411861298,46
"13344","4421124",0.507241588026249,9888,0.545628084791108,10134,-0.0383864967648593,-246
"13345","1131124",0.73259452373815,1048,0.757726035552602,968,-0.0251315118144525,80
"13346","2131124",0.669371351229961,2529,0.701351550911779,2375,-0.0319801996818181,154
"13347","3131124",0.626257142416457,4065,0.672557717711999,3418,-0.0463005752955421,647
"13348","4131124",0.584782811715917,5962,0.630147342590189,5404,-0.0453645308742716,558
"13349","1231124",0.678636746145153,2266,0.702421756606896,2343,-0.0237850104617423,-77
"13350","2231124",0.615413573636965,4531,0.646047271966072,4608,-0.0306336983291079,-77
"13351","3231124",0.572299364823461,6573,0.617253438766293,6095,-0.0449540739428319,478
"13352","4231124",0.530825034122921,8691,0.574843063644483,8501,-0.0440180295215616,190
"13353","1331124",0.650657275868377,3161,0.675371189273598,3311,-0.0247139134052206,-150
"13354","2331124",0.587434103360188,5805,0.618996704632775,5994,-0.0315626012725861,-189
"13355","3331124",0.544319894546685,7998,0.590202871432995,7591,-0.0458829768863102,407
"13356","4331124",0.502845563846145,10124,0.547792496311185,10019,-0.0449469324650399,105
"13357","1431124",0.611720777883381,4709,0.634741685305492,5197,-0.0230209074221107,-488
"13358","2431124",0.548497605375192,7762,0.578367200664669,8297,-0.0298695952894764,-535
"13359","3431124",0.505383396561689,9981,0.549573367464889,9916,-0.0441899709032004,65
"13360","4431124",0.463909065861149,11960,0.507162992343079,12155,-0.0432539264819302,-195
"13361","1141124",0.68356095928332,2118,0.717327541425518,1879,-0.0337665821421979,239
"13362","2141124",0.620337786775131,4326,0.660953056784695,3932,-0.0406152700095634,394
"13363","3141124",0.577223577961628,6329,0.632159223584915,5307,-0.0549356456232875,1022
"13364","4141124",0.535749247261088,8431,0.589748848463105,7619,-0.0539996012020172,812
"13365","1241124",0.629603181690324,3928,0.662023262479812,3879,-0.0324200807894879,49
"13366","2241124",0.566380009182135,6866,0.605648777838988,6724,-0.0392687686568535,142
"13367","3241124",0.523265800368631,9074,0.576854944639209,8380,-0.0535891442705775,694
"13368","4241124",0.481791469668092,11144,0.534444569517399,10766,-0.052653099849307,378
"13369","1341124",0.601623711413548,5153,0.634972695146514,5181,-0.0333489837329661,-28
"13370","2341124",0.538400538905359,8309,0.57859821050569,8280,-0.0401976716003317,29
"13371","3341124",0.495286330091855,10477,0.549804377305911,9902,-0.0545180472140557,575
"13372","4341124",0.453811999391315,12396,0.507394002184101,12143,-0.0535820027927852,253
"13373","1441124",0.562687213428552,7026,0.594343191178408,7383,-0.0316559777498563,-357
"13374","2441124",0.499464040920363,10293,0.537968706537585,10579,-0.038504665617222,-286
"13375","3441124",0.456349832106859,12285,0.509174873337805,12056,-0.052825041230946,229
"13376","4441124",0.414875501406319,13851,0.466764498215995,13859,-0.0518889968096755,-8
"13377","1112124",0.81082140500798,245,0.818441458129386,282,-0.00762005312140523,-37
"13378","2112124",0.747598232499791,821,0.762066973488562,909,-0.0144687409887708,-88
"13379","3112124",0.704484023686288,1605,0.733273140288783,1458,-0.0287891166024948,147
"13380","4112124",0.663009692985748,2730,0.690862765166972,2713,-0.0278530721812246,17
"13381","1212124",0.756863627414984,696,0.763137179183679,889,-0.00627355176869526,-193
"13382","2212124",0.693640454906795,1854,0.706762694542856,2192,-0.0131222396360609,-338
"13383","3212124",0.650526246093292,3167,0.677968861343077,3208,-0.0274426152497849,-41
"13384","4212124",0.609051915392752,4844,0.635558486221266,5142,-0.0265065708285144,-298
"13385","1312124",0.728884157138208,1105,0.736086611850381,1398,-0.00720245471217351,-293
"13386","2312124",0.665660984630019,2639,0.679712127209558,3151,-0.0140511425795391,-512
"13387","3312124",0.622546775816516,4239,0.650918294009779,4373,-0.0283715181932631,-134
"13388","4312124",0.581072445115976,6144,0.608507918887968,6584,-0.0274354737719926,-440
"13389","1412124",0.689947659153212,1948,0.695457107882276,2560,-0.00550944872906367,-612
"13390","2412124",0.626724486645023,4047,0.639082623241452,4980,-0.0123581365964294,-933
"13391","3412124",0.58361027783152,6022,0.610288790041673,6469,-0.0266785122101534,-447
"13392","4412124",0.54213594713098,8116,0.567878414919863,8894,-0.0257424677888829,-778
"13393","1122124",0.74284213414156,885,0.757872146471979,963,-0.0150300123304185,-78
"13394","2122124",0.679618961633371,2239,0.701497661831155,2367,-0.021878700197784,-128
"13395","3122124",0.636504752819868,3699,0.672703828631376,3406,-0.036199075811508,293
"13396","4122124",0.595030422119328,5470,0.630293453509566,5394,-0.0352630313902378,76
"13397","1222124",0.688884356548564,1968,0.702567867526273,2335,-0.0136835109777085,-367
"13398","2222124",0.625661184040375,4088,0.646193382885449,4596,-0.0205321988450741,-508
"13399","3222124",0.582546975226872,6059,0.61739954968567,6080,-0.0348525744587981,-21
"13400","4222124",0.541072644526332,8171,0.57498917456386,8489,-0.0339165300375276,-318
"13401","1322124",0.660904886271788,2787,0.675517300192975,3306,-0.0146124139211867,-519
"13402","2322124",0.597681713763599,5338,0.619142815552151,5986,-0.0214611017885523,-648
"13403","3322124",0.554567504950096,7469,0.590348982352372,7581,-0.0357814774022763,-112
"13404","4322124",0.513093174249556,9620,0.547938607230562,10012,-0.0348454329810058,-392
"13405","1422124",0.621968388286792,4261,0.634887796224869,5189,-0.0129194079380769,-928
"13406","2422124",0.558745215778603,7235,0.578513311584046,8287,-0.0197680958054426,-1052
"13407","3422124",0.5156310069651,9490,0.549719478384266,9907,-0.0340884714191666,-417
"13408","4422124",0.47415667626456,11516,0.507309103262456,12147,-0.0331524269978961,-631
"13409","1132124",0.69950961197646,1706,0.71940705402395,1820,-0.0198974420474893,-114
"13410","2132124",0.636286439468272,3705,0.663032569383127,3839,-0.0267461299148549,-134
"13411","3132124",0.593172230654768,5547,0.634238736183347,5223,-0.0410665055285789,324
"13412","4132124",0.551697899954228,7616,0.591828361061537,7508,-0.0401304611073084,108
"13413","1232124",0.645551834383465,3344,0.664102775078244,3794,-0.0185509406947791,-450
"13414","2232124",0.582328661875276,6076,0.60772829043742,6618,-0.0253996285621447,-542
"13415","3232124",0.539214453061772,8267,0.578934457237641,8266,-0.0397200041758687,1
"13416","4232124",0.497740122361232,10373,0.536524082115831,10658,-0.0387839597545985,-285
"13417","1332124",0.617572364106688,4439,0.637052207744946,5074,-0.0194798436382574,-635
"13418","2332124",0.5543491915985,7485,0.580677723104122,8151,-0.026328531505623,-666
"13419","3332124",0.511234982784996,9707,0.551883889904343,9801,-0.040648907119347,-94
"13420","4332124",0.469760652084456,11703,0.509473514782533,12045,-0.0397128626980767,-342
"13421","1432124",0.578635866121692,6268,0.59642270377684,7269,-0.0177868376551475,-1001
"13422","2432124",0.515412693613504,9500,0.540048219136017,10470,-0.0246355255225132,-970
"13423","3432124",0.4722984848,11603,0.511254385936237,11975,-0.0389559011362373,-372
"13424","4432124",0.43082415409946,13311,0.468844010814427,13798,-0.0380198567149669,-487
"13425","1142124",0.650476047521631,3170,0.679008559896866,3173,-0.0285325123752347,-3
"13426","2142124",0.587252875013442,5820,0.622634075256043,5800,-0.0353812002426003,20
"13427","3142124",0.544138666199939,8012,0.593840242056263,7415,-0.0497015758563243,597
"13428","4142124",0.502664335499399,10131,0.551429866934453,9820,-0.048765531435054,311
"13429","1242124",0.596518269928635,5388,0.62370428095116,5741,-0.0271860110225247,-353
"13430","2242124",0.533295097420446,8554,0.567329796310336,8920,-0.0340346988898903,-366
"13431","3242124",0.490180888606943,10734,0.538535963110557,10548,-0.0483550745036143,186
"13432","4242124",0.448706557906403,12608,0.496125587988746,12663,-0.0474190300823438,-55
"13433","1342124",0.568538799651859,6763,0.596653713617862,7256,-0.028114913966003,-493
"13434","2342124",0.50531562714367,9989,0.540279228977038,10460,-0.0349636018333686,-471
"13435","3342124",0.462201418330166,12037,0.511485395777259,11962,-0.0492839774470926,75
"13436","4342124",0.420727087629627,13660,0.469075020655449,13791,-0.048347933025822,-131
"13437","1442124",0.529602301666863,8751,0.556024209649756,9574,-0.0264219079828931,-823
"13438","2442124",0.466379129158674,11843,0.499649725008933,12512,-0.0332705958502588,-669
"13439","3442124",0.42326492034517,13573,0.470855891809153,13729,-0.0475909714639828,-156
"13440","4442124",0.38179058964463,14784,0.428445516687343,15014,-0.0466549270427123,-230
"13441","1113124",0.771938229435495,527,0.792944867740146,482,-0.0210066383046519,45
"13442","2113124",0.708715056927306,1499,0.736570383099323,1387,-0.0278553261720175,112
"13443","3113124",0.665600848113802,2644,0.707776549899544,2151,-0.0421757017857415,493
"13444","4113124",0.624126517413262,4174,0.665366174777733,3728,-0.041239657364471,446
"13445","1213124",0.717980451842499,1303,0.73764058879444,1358,-0.0196601369519417,-55
"13446","2213124",0.65475727933431,2991,0.681266104153617,3084,-0.0265088248193073,-93
"13447","3213124",0.611643070520806,4716,0.652472270953838,4301,-0.0408292004330313,415
"13448","4213124",0.570168739820266,6682,0.610061895832027,6481,-0.039893156011761,201
"13449","1313124",0.690000981565722,1947,0.710590021461142,2064,-0.0205890398954199,-117
"13450","2313124",0.626777809057534,4041,0.654215536820319,4228,-0.0274377277627855,-187
"13451","3313124",0.58366360024403,6017,0.62542170362054,5642,-0.0417581033765095,375
"13452","4313124",0.54218926954349,8113,0.583011328498729,8018,-0.0408220589552393,95
"13453","1413124",0.651064483580726,3154,0.669960517493037,3511,-0.0188960339123101,-357
"13454","2413124",0.587841311072538,5781,0.613586032852213,6292,-0.0257447217796758,-511
"13455","3413124",0.544727102259034,7982,0.584792199652434,7897,-0.0400650973933998,85
"13456","4413124",0.503252771558494,10104,0.542381824530624,10325,-0.0391290529721295,-221
"13457","1123124",0.703958958569075,1609,0.73237555608274,1484,-0.0284165975136651,125
"13458","2123124",0.640735786060886,3532,0.676001071441916,3290,-0.0352652853810307,242
"13459","3123124",0.597621577247382,5344,0.647207238242137,4545,-0.0495856609947547,799
"13460","4123124",0.556147246546842,7389,0.604796863120327,6787,-0.0486496165734842,602
"13461","1223124",0.650001180976079,3190,0.677071277137034,3246,-0.0270700961609549,-56
"13462","2223124",0.58677800846789,5835,0.62069679249621,5903,-0.0339187840283205,-68
"13463","3223124",0.543663799654386,8028,0.591902959296431,7505,-0.0482391596420445,523
"13464","4223124",0.502189468953846,10153,0.54949258417462,9921,-0.0473031152207742,232
"13465","1323124",0.622021710699302,4259,0.650020709803736,4422,-0.0279989991044332,-163
"13466","2323124",0.558798538191114,7231,0.593646225162912,7427,-0.0348476869717987,-196
"13467","3323124",0.51568432937761,9484,0.564852391963133,9048,-0.0491680625855228,436
"13468","4323124",0.47420999867707,11513,0.522442016841323,11377,-0.0482320181642525,136
"13469","1423124",0.583085212714306,6044,0.60939120583563,6527,-0.0263059931213233,-483
"13470","2423124",0.519862040206118,9241,0.553016721194807,9746,-0.033154680988689,-505
"13471","3423124",0.476747831392614,11387,0.524222887995027,11287,-0.047475056602413,100
"13472","4423124",0.435273500692074,13132,0.481812512873217,13261,-0.0465390121811427,-129
"13473","1133124",0.660626436403975,2795,0.693910463634711,2612,-0.0332840272307358,183
"13474","2133124",0.597403263895786,5355,0.637535978993888,5061,-0.0401327150981013,294
"13475","3133124",0.554289055082283,7488,0.608742145794108,6570,-0.0544530907118254,918
"13476","4133124",0.512814724381743,9636,0.566331770672298,8974,-0.0535170462905551,662
"13477","1233124",0.606668658810979,4946,0.638606184689005,5010,-0.0319375258780258,-64
"13478","2233124",0.54344548630279,8046,0.582231700048181,8069,-0.0387862137453914,-23
"13479","3233124",0.500331277489287,10245,0.553437866848402,9721,-0.0531065893591154,524
"13480","4233124",0.458856946788747,12196,0.511027491726592,11982,-0.0521705449378449,214
"13481","1333124",0.578689188534203,6267,0.611555617355707,6417,-0.032866428821504,-150
"13482","2333124",0.515466016026014,9497,0.555181132714883,9616,-0.0397151166888696,-119
"13483","3333124",0.47235180721251,11598,0.526387299515104,11178,-0.0540354923025936,420
"13484","4333124",0.43087747651197,13308,0.483976924393294,13182,-0.0530994478813231,126
"13485","1433124",0.539752690549207,8242,0.570926113387601,8730,-0.0311734228383942,-488
"13486","2433124",0.476529518041018,11400,0.514551628746778,11804,-0.0380221107057599,-404
"13487","3433124",0.433415309227514,13215,0.485757795546998,13107,-0.0523424863194838,108
"13488","4433124",0.391940978526974,14542,0.443347420425188,14625,-0.0514064418982134,-83
"13489","1143124",0.611592871949145,4718,0.653511969507627,4258,-0.0419190975584813,460
"13490","2143124",0.548369699440957,7773,0.597137484866804,7226,-0.0487677854258469,547
"13491","3143124",0.505255490627453,9993,0.568343651667024,8866,-0.0630881610395709,1127
"13492","4143124",0.463781159926913,11965,0.525933276545214,11204,-0.0621521166183004,761
"13493","1243124",0.557635094356149,7291,0.598207690561921,7167,-0.0405725962057711,124
"13494","2243124",0.494411921847961,10522,0.541833205921097,10368,-0.0474212840731367,154
"13495","3243124",0.451297713034457,12489,0.513039372721318,11876,-0.0617416596868607,613
"13496","4243124",0.409823382333917,14003,0.470628997599507,13738,-0.0608056152655904,265
"13497","1343124",0.529655624079373,8748,0.571157123228623,8717,-0.0415014991492494,31
"13498","2343124",0.466432451571184,11838,0.514782638587799,11792,-0.048350187016615,46
"13499","3343124",0.423318242757681,13569,0.48598880538802,13095,-0.0626705626303389,474
"13500","4343124",0.381843912057141,14783,0.44357843026621,14616,-0.0617345182090687,167
"13501","1443124",0.490719126094377,10698,0.530527619260517,10970,-0.0398084931661395,-272
"13502","2443124",0.427495953586188,13412,0.474153134619694,13592,-0.0466571810335052,-180
"13503","3443124",0.384381744772685,14722,0.445359301419914,14561,-0.0609775566472293,161
"13504","4443124",0.342907414072145,15546,0.402948926298104,15544,-0.0600415122259589,2
"13505","1114124",0.719731157464925,1277,0.748294254366491,1141,-0.0285630969015659,136
"13506","2114124",0.656507984956736,2938,0.691919769725667,2675,-0.0354117847689315,263
"13507","3114124",0.613393776143232,4645,0.663125936525888,3832,-0.0497321603826555,813
"13508","4114124",0.571919445442693,6592,0.620715561404078,5900,-0.048796115961385,692
"13509","1214124",0.665773379871929,2631,0.692989975420784,2642,-0.0272165955488557,-11
"13510","2214124",0.60255020736374,5107,0.636615490779961,5094,-0.0340652834162213,13
"13511","3214124",0.559435998550236,7197,0.607821657580182,6614,-0.0483856590299453,583
"13512","4214124",0.517961667849696,9353,0.565411282458371,9020,-0.047449614608675,333
"13513","1314124",0.637793909595153,3643,0.665939408087487,3699,-0.0281454984923339,-56
"13514","2314124",0.574570737086964,6454,0.609564923446663,6520,-0.0349941863596995,-66
"13515","3314124",0.53145652827346,8653,0.580771090246884,8144,-0.0493145619734235,509
"13516","4314124",0.48998219757292,10748,0.538360715125073,10560,-0.0483785175521533,188
"13517","1414124",0.598857411610157,5282,0.625309904119381,5652,-0.0264524925092241,-370
"13518","2414124",0.535634239101968,8435,0.568935419478558,8837,-0.0333011803765898,-402
"13519","3414124",0.492520030288464,10620,0.540141586278778,10466,-0.0476215559903138,154
"13520","4414124",0.451045699587924,12506,0.497731211156968,12589,-0.0466855115690435,-83
"13521","1124124",0.651751886598505,3127,0.687724942709084,2820,-0.0359730561105791,307
"13522","2124124",0.588528714090316,5754,0.631350458068261,5342,-0.0428217439779447,412
"13523","3124124",0.545414505276812,7943,0.602556624868481,6897,-0.0571421195916687,1046
"13524","4124124",0.503940174576273,10066,0.560146249746671,9322,-0.0562060751703982,744
"13525","1224124",0.597794109005509,5328,0.632420663763378,5292,-0.0346265547578689,36
"13526","2224124",0.53457093649732,8481,0.576046179122554,8423,-0.0414752426252345,58
"13527","3224124",0.491456727683816,10665,0.547252345922775,10044,-0.0557956182389585,621
"13528","4224124",0.449982396983276,12545,0.504841970800965,12252,-0.0548595738176882,293
"13529","1324124",0.569814638728733,6700,0.60537009643008,6751,-0.0355554577013472,-51
"13530","2324124",0.506591466220544,9922,0.548995611789256,9951,-0.0424041455687127,-29
"13531","3324124",0.46347725740704,11977,0.520201778589477,11483,-0.0567245211824368,494
"13532","4324124",0.4220029267065,13613,0.477791403467667,13432,-0.0557884767611664,181
"13533","1424124",0.530878140743737,8687,0.564740592461974,9053,-0.0338624517182373,-366
"13534","2424124",0.467654968235548,11790,0.508366107821151,12090,-0.040711139585603,-300
"13535","3424124",0.424540759422044,13527,0.479572274621371,13349,-0.055031515199327,178
"13536","4424124",0.383066428721504,14755,0.437161899499561,14779,-0.0540954707780567,-24
"13537","1134124",0.608419364433405,4877,0.649259850261055,4445,-0.0408404858276498,432
"13538","2134124",0.545196191925216,7955,0.592885365620232,7463,-0.0476891736950154,492
"13539","3134124",0.502081983111713,10163,0.564091532420452,9099,-0.0620095493087394,1064
"13540","4134124",0.460607652411173,12115,0.521681157298642,11412,-0.0610735048874691,703
"13541","1234124",0.554461586840409,7478,0.593955571315349,7408,-0.0394939844749398,70
"13542","2234124",0.49123841433222,10680,0.537581086674526,10606,-0.0463426723423054,74
"13543","3234124",0.448124205518717,12631,0.508787253474746,12076,-0.0606630479560294,555
"13544","4234124",0.406649874818177,14110,0.466376878352936,13873,-0.0597270035347588,237
"13545","1334124",0.526482116563633,8933,0.566905003982051,8948,-0.040422887418418,-15
"13546","2334124",0.463258944055444,11990,0.510530519341228,12010,-0.0472715752857836,-20
"13547","3334124",0.42014473524194,13685,0.481736686141448,13265,-0.0615919508995076,420
"13548","4334124",0.378670404541401,14865,0.439326311019638,14727,-0.0606559064782372,138
"13549","1434124",0.487545618578637,10879,0.526275500013945,11187,-0.0387298814353082,-308
"13550","2434124",0.424322446070448,13538,0.469901015373122,13768,-0.0455785693026738,-230
"13551","3434124",0.381208237256945,14804,0.441107182173342,14684,-0.0598989449163978,120
"13552","4434124",0.339733906556405,15604,0.398696807051532,15603,-0.0589629004951275,1
"13553","1144124",0.559385799978576,7203,0.608861356133971,6563,-0.0494755561553953,640
"13554","2144124",0.496162627470387,10449,0.552486871493148,9775,-0.0563242440227609,674
"13555","3144124",0.453048418656883,12429,0.523693038293368,11312,-0.0706446196364849,1117
"13556","4144124",0.411574087956343,13951,0.481282663171558,13284,-0.0697085752152144,667
"13557","1244124",0.50542802238558,9978,0.553557077188265,9711,-0.0481290548026851,267
"13558","2244124",0.442204849877391,12859,0.497182592547441,12614,-0.0549777426700507,245
"13559","3244124",0.399090641063887,14321,0.468388759347662,13812,-0.0692981182837747,509
"13560","4244124",0.357616310363347,15301,0.425978384225852,15060,-0.0683620738625044,241
"13561","1344124",0.477448552108803,11348,0.526506509854967,11170,-0.0490579577461634,178
"13562","2344124",0.414225379600615,13869,0.470132025214143,13760,-0.0559066456135289,109
"13563","3344124",0.371111170787111,15026,0.441338192014364,14677,-0.070227021227253,349
"13564","4344124",0.329636840086571,15731,0.398927816892554,15600,-0.0692909768059827,131
"13565","1444124",0.438512054123807,12993,0.485877005886861,13102,-0.0473649517630535,-109
"13566","2444124",0.375288881615619,14935,0.429502521246038,14991,-0.0542136396304193,-56
"13567","3444124",0.332174672802115,15700,0.400708688046258,15581,-0.0685340152441433,119
"13568","4444124",0.290700342101575,16098,0.358298312924448,16070,-0.0675979708228729,28
"13569","1111224",0.798057482621459,326,0.811425593003256,327,-0.0133681103817966,-1
"13570","2111224",0.73483431011327,1011,0.755051108362432,1008,-0.0202167982491622,3
"13571","3111224",0.691720101299767,1916,0.726257275162653,1632,-0.0345371738628862,284
"13572","4111224",0.650245770599227,3183,0.683846900040843,2974,-0.033601129441616,209
"13573","1211224",0.744099705028463,864,0.75612131405755,992,-0.0120216090290867,-128
"13574","2211224",0.680876532520274,2201,0.699746829416726,2417,-0.0188702968964523,-216
"13575","3211224",0.63776232370677,3645,0.670952996216947,3474,-0.0331906725101763,171
"13576","4211224",0.596287993006231,5408,0.628542621095136,5473,-0.0322546280889058,-65
"13577","1311224",0.716120234751687,1345,0.729070746724252,1556,-0.0129505119725649,-211
"13578","2311224",0.652897062243498,3080,0.672696262083428,3408,-0.0197991998399305,-328
"13579","3311224",0.609782853429994,4806,0.643902428883649,4708,-0.0341195754536545,98
"13580","4311224",0.568308522729454,6783,0.601492053761838,6963,-0.033183531032384,-180
"13581","1411224",0.677183736766691,2312,0.688441242756146,2795,-0.0112575059894551,-483
"13582","2411224",0.613960564258502,4616,0.632066758115323,5313,-0.0181061938568208,-697
"13583","3411224",0.570846355444998,6644,0.603272924915543,6863,-0.0324265694705448,-219
"13584","4411224",0.529372024744458,8771,0.560862549793733,9272,-0.0314905250492743,-501
"13585","1121224",0.730078211755039,1093,0.750856281345849,1085,-0.0207780695908099,8
"13586","2121224",0.66685503924685,2600,0.694481796705026,2592,-0.0276267574581754,8
"13587","3121224",0.623740830433347,4190,0.665687963505246,3710,-0.0419471330718995,480
"13588","4121224",0.582266499732807,6081,0.623277588383436,5768,-0.0410110886506292,313
"13589","1221224",0.676120434162043,2337,0.695552002400143,2555,-0.0194315682380999,-218
"13590","2221224",0.612897261653854,4664,0.639177517759319,4973,-0.0262802561054655,-309
"13591","3221224",0.56978305284035,6703,0.61038368455954,6464,-0.0406006317191895,239
"13592","4221224",0.528308722139811,8824,0.56797330943773,8888,-0.039664587297919,-64
"13593","1321224",0.648140963885267,3263,0.668501435066845,3592,-0.0203604711815781,-329
"13594","2321224",0.584917791377078,5953,0.612126950426021,6381,-0.0272091590489437,-428
"13595","3321224",0.541803582563574,8131,0.583333117226242,7992,-0.0415295346626677,139
"13596","4321224",0.500329251863034,10246,0.540922742104432,10427,-0.0405934902413972,-181
"13597","1421224",0.609204465900271,4841,0.627871931098739,5515,-0.0186674651984683,-674
"13598","2421224",0.545981293392082,7906,0.571497446457916,8694,-0.025516153065834,-788
"13599","3421224",0.502867084578578,10123,0.542703613258136,10305,-0.039836528679558,-182
"13600","4421224",0.461392753878038,12073,0.500293238136326,12480,-0.0389004842582875,-407
"13601","1131224",0.686745689589939,2031,0.71239118889782,1995,-0.0256454993078807,36
"13602","2131224",0.62352251708175,4204,0.656016704256997,4144,-0.0324941871752463,60
"13603","3131224",0.580408308268247,6182,0.627222871057217,5548,-0.0468145627889703,634
"13604","4131224",0.538933977567707,8282,0.584812495935407,7896,-0.0458785183676998,386
"13605","1231224",0.632787911996943,3816,0.657086909952114,4100,-0.0242989979551705,-284
"13606","2231224",0.569564739488754,6719,0.60071242531129,7023,-0.0311476858225361,-304
"13607","3231224",0.526450530675251,8935,0.571918592111511,8663,-0.0454680614362601,272
"13608","4231224",0.484976199974711,10999,0.529508216989701,11028,-0.0445320170149899,-29
"13609","1331224",0.604808441720167,5012,0.630036342618816,5409,-0.0252279008986488,-397
"13610","2331224",0.541585269211978,8141,0.573661857977993,8563,-0.0320765887660144,-422
"13611","3331224",0.498471060398475,10335,0.544868024778213,10181,-0.0463969643797384,154
"13612","4331224",0.456996729697935,12261,0.502457649656403,12370,-0.0454609199584681,-109
"13613","1431224",0.565871943735171,6893,0.58940683865071,7639,-0.023534894915539,-746
"13614","2431224",0.502648771226982,10133,0.533032354009887,10847,-0.0303835827829047,-714
"13615","3431224",0.459534562413479,12160,0.504238520810107,12286,-0.0447039583966287,-126
"13616","4431224",0.418060231712939,13750,0.461828145688297,14020,-0.0437679139753583,-270
"13617","1141224",0.63771212513511,3648,0.671992694770736,3438,-0.0342805696356261,210
"13618","2141224",0.574488952626921,6460,0.615618210129913,6186,-0.0411292575029917,274
"13619","3141224",0.531374743813418,8662,0.586824376930133,7791,-0.0554496331167157,871
"13620","4141224",0.489900413112877,10751,0.544414001808323,10216,-0.0545135886954454,535
"13621","1241224",0.583754347542114,6008,0.61668841582503,6128,-0.0329340682829161,-120
"13622","2241224",0.520531175033925,9209,0.560313931184206,9308,-0.0397827561502817,-99
"13623","3241224",0.477416966220421,11350,0.531520097984427,10916,-0.0541031317640057,434
"13624","4241224",0.435942635519881,13102,0.489109722862617,12972,-0.0531670873427352,130
"13625","1341224",0.555774877265337,7411,0.589637848491732,7625,-0.0338629712263944,-214
"13626","2341224",0.492551704757149,10617,0.533263363850909,10832,-0.04071165909376,-215
"13627","3341224",0.449437495943645,12575,0.504469530651129,12274,-0.055032034707484,301
"13628","4341224",0.407963165243105,14067,0.462059155529319,14012,-0.0540959902862134,55
"13629","1441224",0.516838379280341,9417,0.549008344523626,9949,-0.0321699652432845,-532
"13630","2441224",0.453615206772153,12403,0.492633859882803,12820,-0.0390186531106502,-417
"13631","3441224",0.410500997958649,13980,0.463840026683023,13950,-0.0533390287243742,30
"13632","4441224",0.369026667258109,15072,0.421429651561213,15161,-0.0524029843031038,-89
"13633","1112224",0.76497257085977,610,0.773106611474604,726,-0.00813404061483347,-116
"13634","2112224",0.701749398351581,1659,0.71673212683378,1894,-0.0149827284821991,-235
"13635","3112224",0.658635189538078,2864,0.687938293634001,2812,-0.0293031040959231,52
"13636","4112224",0.617160858837538,4458,0.64552791851219,4628,-0.0283670596746528,-170
"13637","1212224",0.711014793266774,1446,0.717802332528897,1866,-0.0067875392621235,-420
"13638","2212224",0.647791620758585,3270,0.661427847888074,3913,-0.0136362271294891,-643
"13639","3212224",0.604677411945082,5017,0.632634014688295,5284,-0.0279566027432131,-267
"13640","4212224",0.563203081244542,7006,0.590223639566484,7586,-0.0270205583219426,-580
"13641","1312224",0.683035322989998,2135,0.6907517651956,2717,-0.00771644220560175,-582
"13642","2312224",0.619812150481809,4342,0.634377280554776,5214,-0.0145651300729673,-872
"13643","3312224",0.576697941668305,6347,0.605583447354997,6730,-0.0288855056866913,-383
"13644","4312224",0.535223610967765,8455,0.563173072233186,9152,-0.0279494612654209,-697
"13645","1412224",0.644098825005002,3397,0.650122261227494,4418,-0.00602343622249191,-1021
"13646","2412224",0.580875652496813,6158,0.59374777658667,7422,-0.0128721240898576,-1264
"13647","3412224",0.537761443683309,8340,0.564953943386891,9044,-0.0271924997035816,-704
"13648","4412224",0.49628711298277,10444,0.522543568265081,11370,-0.0262564552823111,-926
"13649","1122224",0.69699329999335,1776,0.712537299817197,1992,-0.0155439998238467,-216
"13650","2122224",0.633770127485161,3784,0.656162815176374,4139,-0.0223926876912123,-355
"13651","3122224",0.590655918671658,5649,0.627368981976594,5540,-0.0367130633049363,109
"13652","4122224",0.549181587971118,7737,0.584958606854784,7889,-0.035777018883666,-152
"13653","1222224",0.643035522400354,3440,0.657233020871491,4094,-0.0141974984711367,-654
"13654","2222224",0.579812349892165,6214,0.600858536230667,7010,-0.0210461863385023,-796
"13655","3222224",0.536698141078662,8380,0.572064703030888,8652,-0.0353665619522263,-272
"13656","4222224",0.495223810378122,10485,0.529654327909078,11020,-0.0344305175309558,-535
"13657","1322224",0.615056052123578,4554,0.630182453538193,5400,-0.015126401414615,-846
"13658","2322224",0.551832879615389,7605,0.573807968897369,8555,-0.0219750892819806,-950
"13659","3322224",0.508718670801885,9812,0.54501413569759,10170,-0.0362954648957046,-358
"13660","4322224",0.467244340101346,11805,0.50260376057578,12363,-0.0353594204744341,-558
"13661","1422224",0.576119554138582,6380,0.589552949570087,7630,-0.0134333954315051,-1250
"13662","2422224",0.512896381630393,9632,0.533178464929264,10837,-0.0202820832988708,-1205
"13663","3422224",0.469782172816889,11701,0.504384631729484,12277,-0.0346024589125948,-576
"13664","4422224",0.42830784211635,13394,0.461974256607674,14014,-0.0336664144913243,-620
"13665","1132224",0.65366077782825,3049,0.674072207369168,3345,-0.0204114295409176,-296
"13666","2132224",0.590437605320062,5672,0.617697722728345,6065,-0.0272601174082832,-393
"13667","3132224",0.547323396506558,7827,0.588903889528565,7664,-0.0415804930220072,163
"13668","4132224",0.505849065806018,9956,0.546493514406755,10086,-0.0406444486007367,-130
"13669","1232224",0.599703000235254,5244,0.618767928423462,6004,-0.0190649281882074,-760
"13670","2232224",0.536479827727065,8400,0.562393443782638,9201,-0.025913616055573,-801
"13671","3232224",0.493365618913562,10574,0.533599610582859,10818,-0.040233991669297,-244
"13672","4232224",0.451891288213022,12464,0.491189235461049,12880,-0.0392979472480267,-416
"13673","1332224",0.571723529958478,6596,0.591717361090164,7513,-0.0199938311316856,-917
"13674","2332224",0.508500357450289,9824,0.535342876449341,10722,-0.0268425189990512,-898
"13675","3332224",0.465386148636786,11880,0.506549043249561,12183,-0.0411628946127752,-303
"13676","4332224",0.423911817936246,13549,0.464138668127751,13940,-0.0402268501915049,-391
"13677","1432224",0.532787031973482,8583,0.551087857122058,9841,-0.0183008251485758,-1258
"13678","2432224",0.469563859465293,11718,0.494713372481235,12728,-0.0251495130159414,-1010
"13679","3432224",0.42644965065179,13454,0.465919539281455,13892,-0.0394698886296654,-438
"13680","4432224",0.38497531995125,14706,0.423509164159645,15114,-0.0385338442083951,-408
"13681","1142224",0.604627213373421,5022,0.633673713242084,5237,-0.0290464998686629,-215
"13682","2142224",0.541404040865232,8155,0.577299228601261,8361,-0.0358951877360285,-206
"13683","3142224",0.498289832051729,10348,0.548505395401481,9981,-0.0502155633497525,367
"13684","4142224",0.456815501351189,12268,0.506095020279671,12202,-0.0492795189284823,66
"13685","1242224",0.550669435780425,7669,0.578369434296378,8296,-0.027699998515953,-627
"13686","2242224",0.487446263272236,10886,0.521994949655554,11400,-0.0345486863833185,-514
"13687","3242224",0.444332054458732,12785,0.493201116455775,12793,-0.0488690619970425,-8
"13688","4242224",0.402857723758193,14219,0.450790741333965,14386,-0.047933017575772,-167
"13689","1342224",0.522689965503649,9109,0.55131886696308,9828,-0.0286289014594312,-719
"13690","2342224",0.45946679299546,12165,0.494944382322256,12720,-0.0354775893267967,-555
"13691","3342224",0.416352584181956,13800,0.466150549122477,13880,-0.0497979649405207,-80
"13692","4342224",0.374878253481416,14944,0.423740174000667,15109,-0.0488619205192503,-165
"13693","1442224",0.483753467518653,11066,0.510689362994974,12000,-0.0269358954763214,-934
"13694","2442224",0.420530295010464,13673,0.454314878354151,14276,-0.033784583343687,-603
"13695","3442224",0.37741608619696,14900,0.425521045154371,15072,-0.048104958957411,-172
"13696","4442224",0.33594175549642,15656,0.383110670032561,15818,-0.0471689145361406,-162
"13697","1113224",0.726089395287284,1158,0.747610021085365,1156,-0.0215206257980801,2
"13698","2113224",0.662866222779096,2731,0.691235536444541,2699,-0.0283693136654457,32
"13699","3113224",0.619752013965592,4346,0.662441703244762,3860,-0.0426896892791697,486
"13700","4113224",0.578277683265052,6286,0.620031328122951,5936,-0.0417536448578992,350
"13701","1213224",0.672131617694288,2443,0.692305742139658,2658,-0.0201741244453699,-215
"13702","2213224",0.6089084451861,4850,0.635931257498835,5126,-0.0270228123127355,-276
"13703","3213224",0.565794236372596,6897,0.607137424299056,6643,-0.0413431879264595,254
"13704","4213224",0.524319905672056,9031,0.564727049177245,9054,-0.0404071435051893,-23
"13705","1313224",0.644152147417512,3396,0.66525517480636,3730,-0.0211030273888482,-334
"13706","2313224",0.580928974909323,6151,0.608880690165537,6559,-0.0279517152562138,-408
"13707","3313224",0.53781476609582,8338,0.580086856965758,8188,-0.0422720908699378,150
"13708","4313224",0.49634043539528,10442,0.537676481843947,10597,-0.0413360464486675,-155
"13709","1413224",0.605215649432516,4999,0.624625670838255,5687,-0.0194100214057383,-688
"13710","2413224",0.541992476924327,8124,0.568251186197431,8874,-0.026258709273104,-750
"13711","3413224",0.498878268110824,10323,0.539457352997652,10502,-0.040579084886828,-179
"13712","4413224",0.457403937410284,12245,0.497046977875842,12616,-0.0396430404655577,-371
"13713","1123224",0.658110124420864,2886,0.687040709427958,2852,-0.0289305850070933,34
"13714","2123224",0.594886951912676,5475,0.630666224787135,5373,-0.0357792728744589,102
"13715","3123224",0.551772743099172,7610,0.601872391587355,6938,-0.0500996484881829,672
"13716","4123224",0.510298412398632,9748,0.559462016465545,9363,-0.0491636040669124,385
"13717","1223224",0.604152346827868,5045,0.631736430482252,5330,-0.0275840836543831,-285
"13718","2223224",0.54092917431968,8182,0.575361945841428,8468,-0.0344327715217487,-286
"13719","3223224",0.497814965506176,10370,0.546568112641649,10079,-0.0487531471354727,291
"13720","4223224",0.456340634805636,12286,0.504157737519839,12290,-0.0478171027142025,-4
"13721","1323224",0.576172876551092,6377,0.604685863148954,6792,-0.0285129865978614,-415
"13722","2323224",0.512949704042903,9627,0.54831137850813,9989,-0.035361674465227,-362
"13723","3323224",0.4698354952294,11698,0.519517545308351,11528,-0.049682050078951,170
"13724","4323224",0.42836116452886,13391,0.47710717018654,13467,-0.0487460056576807,-76
"13725","1423224",0.537236378566096,8359,0.564056359180848,9101,-0.0268199806147515,-742
"13726","2423224",0.474013206057907,11527,0.507681874540025,12132,-0.0336686684821172,-605
"13727","3423224",0.430898997244404,13307,0.478888041340245,13378,-0.0479890440958412,-71
"13728","4423224",0.389424666543864,14602,0.436477666218435,14800,-0.047052999674571,-198
"13729","1133224",0.614777602255765,4564,0.648575616979929,4470,-0.033798014724164,94
"13730","2133224",0.551554429747576,7622,0.592201132339106,7492,-0.0406467025915296,130
"13731","3133224",0.508440220934073,9830,0.563407299139326,9138,-0.0549670782052536,692
"13732","4133224",0.466965890233533,11816,0.520996924017516,11441,-0.0540310337839833,375
"13733","1233224",0.560819824662769,7129,0.593271338034223,7442,-0.032451513371454,-313
"13734","2233224",0.49759665215458,10386,0.536896853393399,10642,-0.0393002012388196,-256
"13735","3233224",0.454482443341076,12363,0.50810302019362,12107,-0.0536205768525436,256
"13736","4233224",0.413008112640536,13901,0.46569264507181,13901,-0.0526845324312731,0
"13737","1333224",0.532840354385993,8581,0.566220770700925,8980,-0.0333804163149323,-399
"13738","2333224",0.469617181877804,11710,0.509846286060102,12032,-0.0402291041822979,-322
"13739","3333224",0.4265029730643,13453,0.481052452860322,13296,-0.0545494797960218,157
"13740","4333224",0.38502864236376,14704,0.438642077738512,14744,-0.0536134353747514,-40
"13741","1433224",0.493903856400997,10549,0.525591266732819,11220,-0.0316874103318224,-671
"13742","2433224",0.430680683892808,13318,0.469216782091996,13789,-0.0385360981991881,-471
"13743","3433224",0.387566475079304,14645,0.440422948892216,14702,-0.0528564738129121,-57
"13744","4433224",0.346092144378764,15488,0.398012573770406,15617,-0.0519204293916417,-129
"13745","1143224",0.565744037800935,6898,0.608177122852845,6601,-0.0424330850519096,297
"13746","2143224",0.502520865292746,10137,0.551802638212022,9805,-0.0492817729192752,332
"13747","3143224",0.459406656479243,12170,0.523008805012242,11348,-0.0636021485329992,822
"13748","4143224",0.417932325778703,13755,0.480598429890432,13316,-0.0626661041117286,439
"13749","1243224",0.511786260207939,9681,0.552872843907139,9756,-0.0410865836991994,-75
"13750","2243224",0.44856308769975,12615,0.496498359266315,12645,-0.0479352715665649,-30
"13751","3243224",0.405448878886247,14152,0.467704526066536,13833,-0.0622556471802889,319
"13752","4243224",0.363974548185707,15182,0.425294150944726,15079,-0.0613196027590187,103
"13753","1343224",0.483806789931163,11061,0.525822276573841,11209,-0.0420154866426776,-148
"13754","2343224",0.420583617422974,13667,0.469447791933017,13780,-0.0488641745100432,-113
"13755","3343224",0.377469408609471,14897,0.440653958733238,14695,-0.0631845501237672,202
"13756","4343224",0.335995077908931,15654,0.398243583611428,15614,-0.062248505702497,40
"13757","1443224",0.444870291946167,12761,0.485192772605735,13131,-0.0403224806595677,-370
"13758","2443224",0.381647119437978,14789,0.428818287964912,15006,-0.0471711685269335,-217
"13759","3443224",0.338532910624475,15622,0.400024454765132,15588,-0.0614915441406575,34
"13760","4443224",0.297058579923935,16057,0.357614079643322,16077,-0.0605554997193872,-20
"13761","1114224",0.673882323316715,2391,0.702959407711709,2320,-0.0290770843949941,71
"13762","2114224",0.610659150808526,4764,0.646584923070885,4581,-0.0359257722623597,183
"13763","3114224",0.567544941995022,6818,0.617791089871106,6060,-0.0502461478760837,758
"13764","4114224",0.526070611294482,8957,0.575380714749296,8465,-0.0493101034548132,492
"13765","1214224",0.619924545723719,4337,0.647655128766003,4526,-0.0277305830422839,-189
"13766","2214224",0.55670137321553,7358,0.591280644125179,7541,-0.0345792709096495,-183
"13767","3214224",0.513587164402026,9588,0.5624868109254,9196,-0.0488996465233735,392
"13768","4214224",0.472112833701486,11614,0.520076435803589,11492,-0.0479636021021033,122
"13769","1314224",0.591945075446942,5586,0.620604561432705,5909,-0.0286594859857622,-323
"13770","2314224",0.528721902938754,8800,0.564230076791881,9090,-0.0355081738531278,-290
"13771","3314224",0.48560769412525,10971,0.535436243592102,10714,-0.0498285494668518,257
"13772","4314224",0.44413336342471,12799,0.493025868470291,12801,-0.0488925050455815,-2
"13773","1414224",0.553008577461946,7542,0.579975057464599,8199,-0.0269664800026523,-657
"13774","2414224",0.489785404953758,10755,0.523600572823776,11316,-0.033815167870018,-561
"13775","3414224",0.446671196140254,12694,0.494806739623996,12725,-0.048135543483742,-31
"13776","4414224",0.405196865439714,14164,0.452396364502186,14332,-0.0471994990624717,-168
"13777","1124224",0.605903052450295,4976,0.642390096054302,4795,-0.0364870436040073,181
"13778","2124224",0.542679879942106,8085,0.586015611413479,7833,-0.0433357314713729,252
"13779","3124224",0.499565671128602,10285,0.557221778213699,9500,-0.0576561070850969,785
"13780","4124224",0.458091340428062,12230,0.514811403091889,11790,-0.0567200626638265,440
"13781","1224224",0.551945274857299,7599,0.587085817108596,7771,-0.0351405422512971,-172
"13782","2224224",0.48872210234911,10814,0.530711332467772,10958,-0.0419892301186627,-144
"13783","3224224",0.445607893535606,12726,0.501917499267993,12401,-0.0563096057323867,325
"13784","4224224",0.404133562835066,14185,0.459507124146183,14102,-0.0553735613111164,83
"13785","1324224",0.523965804580522,9047,0.560035249775298,9332,-0.0360694451947754,-285
"13786","2324224",0.460742632072334,12106,0.503660765134475,12313,-0.042918133062141,-207
"13787","3324224",0.41762842325883,13761,0.474866931934695,13558,-0.0572385086758649,203
"13788","4324224",0.37615409255829,14921,0.432456556812885,14917,-0.0563024642545946,4
"13789","1424224",0.485029306595526,10995,0.519405745807192,11535,-0.0343764392116656,-540
"13790","2424224",0.421806134087338,13623,0.463031261166369,13974,-0.0412251270790312,-351
"13791","3424224",0.378691925273834,14863,0.434237427966589,14862,-0.0555455026927553,1
"13792","4424224",0.337217594573294,15640,0.391827052844779,15705,-0.0546094582714849,-65
"13793","1134224",0.562570530285195,7033,0.603925003606273,6830,-0.041354473321078,203
"13794","2134224",0.499347357777006,10300,0.54755051896545,10030,-0.0482031611884436,270
"13795","3134224",0.456233148963503,12294,0.51875668576567,11571,-0.0625235368021676,723
"13796","4134224",0.414758818262963,13855,0.47634631064386,13497,-0.0615874923808973,358
"13797","1234224",0.508612752692199,9817,0.548620724660567,9974,-0.040007971968368,-157
"13798","2234224",0.44538958018401,12742,0.492246240019744,12840,-0.0468566598357336,-98
"13799","3234224",0.402275371370507,14237,0.463452406819964,13963,-0.0611770354494576,274
"13800","4234224",0.360801040669967,15242,0.421042031698154,15173,-0.0602409910281871,69
"13801","1334224",0.480633282415423,11193,0.521570157327269,11418,-0.0409368749118463,-225
"13802","2334224",0.417410109907234,13771,0.465195672686446,13915,-0.0477855627792118,-144
"13803","3334224",0.37429590109373,14955,0.436401839486666,14806,-0.0621059383929358,149
"13804","4334224",0.33282157039319,15691,0.393991464364856,15670,-0.0611698939716654,21
"13805","1434224",0.441696784430427,12875,0.480940653359163,13302,-0.0392438689287364,-427
"13806","2434224",0.378473611922238,14872,0.42456616871834,15096,-0.046092556796102,-224
"13807","3434224",0.335359403108734,15662,0.39577233551856,15646,-0.060412932409826,16
"13808","4434224",0.293885072408194,16077,0.35336196039675,16106,-0.0594768879885557,-29
"13809","1144224",0.513536965830365,9592,0.563526509479189,9129,-0.0499895436488236,463
"13810","2144224",0.450313793322177,12533,0.507152024838366,12158,-0.0568382315161892,375
"13811","3144224",0.407199584508673,14095,0.478358191638586,13404,-0.0711586071299131,691
"13812","4144224",0.365725253808133,15154,0.435947816516776,14822,-0.0702225627086427,332
"13813","1244224",0.459579188237369,12157,0.508222230533483,12103,-0.0486430422961134,54
"13814","2244224",0.39635601572918,14407,0.45184774589266,14354,-0.055491730163479,53
"13815","3244224",0.353241806915677,15380,0.42305391269288,15128,-0.069812105777203,252
"13816","4244224",0.311767476215137,15934,0.38064353757107,15852,-0.0688760613559326,82
"13817","1344224",0.431599717960593,13283,0.481171663200185,13286,-0.0495719452395916,-3
"13818","2344224",0.368376545452404,15089,0.424797178559362,15089,-0.0564206331069572,0
"13819","3344224",0.325262336638901,15786,0.396003345359582,15641,-0.0707410087206812,145
"13820","4344224",0.283788005938361,16143,0.353592970237772,16103,-0.0698049642994109,40
"13821","1444224",0.392663219975597,14516,0.440542159232079,14697,-0.0478789392564818,-181
"13822","2444224",0.329440047467408,15735,0.384167674591256,15804,-0.0547276271238475,-69
"13823","3444224",0.286325838653905,16131,0.355373841391476,16089,-0.0690480027375716,42
"13824","4444224",0.244851507953365,16303,0.312963466269666,16299,-0.0681119583163012,4
"13825","1111324",0.775603503616151,495,0.793375603075581,475,-0.01777209945943,20
"13826","2111324",0.712380331107962,1420,0.737001118434758,1373,-0.0246207873267956,47
"13827","3111324",0.669266122294459,2535,0.708207285234978,2137,-0.0389411629405196,398
"13828","4111324",0.627791791593919,4003,0.665796910113168,3704,-0.0380051185192494,299
"13829","1211324",0.721645726023155,1241,0.738071324129875,1351,-0.0164255981067201,-110
"13830","2211324",0.658422553514966,2877,0.681696839489052,3068,-0.0232742859740857,-191
"13831","3211324",0.615308344701462,4539,0.652903006289272,4286,-0.0375946615878097,253
"13832","4211324",0.573834014000923,6486,0.610492631167462,6457,-0.0366586171665392,29
"13833","1311324",0.693666255746379,1852,0.711020756796577,2051,-0.0173545010501983,-199
"13834","2311324",0.63044308323819,3896,0.654646272155754,4205,-0.0242031889175639,-309
"13835","3311324",0.587328874424686,5811,0.625852438955974,5621,-0.0385235645312879,190
"13836","4311324",0.545854543724146,7916,0.583442063834164,7982,-0.0375875201100174,-66
"13837","1411324",0.654729757761383,2995,0.670391252828471,3496,-0.0156614950670885,-501
"13838","2411324",0.591506585253194,5605,0.614016768187648,6268,-0.0225101829344542,-663
"13839","3411324",0.54839237643969,7771,0.585222934987868,7875,-0.0368305585481782,-104
"13840","4411324",0.50691804573915,9909,0.542812559866058,10300,-0.0358945141269077,-391
"13841","1121324",0.707624232749731,1531,0.732806291418174,1472,-0.0251820586684433,59
"13842","2121324",0.644401060241542,3386,0.676431806777351,3278,-0.0320307465358088,108
"13843","3121324",0.601286851428039,5176,0.647637973577572,4527,-0.0463511221495329,649
"13844","4121324",0.559812520727499,7181,0.605227598455761,6761,-0.0454150777282626,420
"13845","1221324",0.653666455156735,3048,0.677502012472468,3226,-0.0238355573157333,-178
"13846","2221324",0.590443282648546,5670,0.621127527831645,5881,-0.0306842451830989,-211
"13847","3221324",0.547329073835042,7825,0.592333694631865,7485,-0.0450046207968229,340
"13848","4221324",0.505854743134503,9955,0.549923319510055,9896,-0.0440685763755524,59
"13849","1321324",0.625686984879959,4086,0.65045144513917,4398,-0.0247644602592115,-312
"13850","2321324",0.56246381237177,7037,0.594076960498347,7399,-0.0316131481265771,-362
"13851","3321324",0.519349603558266,9259,0.565283127298567,9026,-0.0459335237403011,233
"13852","4321324",0.477875272857726,11327,0.522872752176757,11354,-0.0449974793190306,-27
"13853","1421324",0.586750486894963,5838,0.609821941171064,6501,-0.0230714542761017,-663
"13854","2421324",0.523527314386774,9063,0.553447456530241,9720,-0.0299201421434674,-657
"13855","3421324",0.48041310557327,11201,0.524653623330462,11268,-0.0442405177571914,-67
"13856","4421324",0.43893877487273,12978,0.482243248208651,13245,-0.0433044733359209,-267
"13857","1131324",0.664291710584631,2686,0.694341198970145,2597,-0.0300494883855141,89
"13858","2131324",0.601068538076442,5184,0.637966714329322,5040,-0.0368981762528797,144
"13859","3131324",0.557954329262939,7277,0.609172881129543,6542,-0.0512185518666037,735
"13860","4131324",0.516479998562399,9440,0.566762506007732,8953,-0.0502825074453332,487
"13861","1231324",0.610333932991635,4784,0.639036920024439,4987,-0.0287029870328039,-203
"13862","2231324",0.547110760483446,7848,0.582662435383616,8043,-0.0355516749001695,-195
"13863","3231324",0.503996551669943,10063,0.553868602183836,9694,-0.0498720505138935,369
"13864","4231324",0.462522220969403,12020,0.511458227062026,11964,-0.0489360060926233,56
"13865","1331324",0.582354462714859,6073,0.611986352691141,6395,-0.0296318899762822,-322
"13866","2331324",0.51913129020667,9277,0.555611868050318,9596,-0.0364805778436478,-319
"13867","3331324",0.476017081393167,11423,0.526818034850539,11153,-0.0508009534573718,270
"13868","4331324",0.434542750692627,13165,0.484407659728728,13166,-0.0498649090361015,-1
"13869","1431324",0.543417964729863,8048,0.571356848723035,8705,-0.0279388839931723,-657
"13870","2431324",0.480194792221674,11214,0.514982364082212,11778,-0.034787571860538,-564
"13871","3431324",0.437080583408171,13054,0.486188530882433,13089,-0.049107947474262,-35
"13872","4431324",0.395606252707631,14426,0.443778155760622,14611,-0.0481719030529918,-185
"13873","1141324",0.615258146129802,4543,0.653942704843061,4238,-0.0386845587132595,305
"13874","2141324",0.552034973621613,7595,0.597568220202238,7203,-0.0455332465806251,392
"13875","3141324",0.50892076480811,9805,0.568774387002459,8847,-0.0598536221943491,958
"13876","4141324",0.46744643410757,11796,0.526364011880648,11180,-0.0589175777730788,616
"13877","1241324",0.561300368536806,7103,0.598638425897355,7134,-0.0373380573605495,-31
"13878","2241324",0.498077196028617,10362,0.542263941256532,10335,-0.0441867452279151,27
"13879","3241324",0.454962987215113,12345,0.513470108056752,11858,-0.0585071208416391,487
"13880","4241324",0.413488656514573,13885,0.471059732934942,13720,-0.0575710764203686,165
"13881","1341324",0.53332089826003,8552,0.571587858564057,8685,-0.0382669603040278,-133
"13882","2341324",0.470097725751841,11686,0.515213373923234,11764,-0.0451156481713934,-78
"13883","3341324",0.426983516938337,13439,0.486419540723454,13076,-0.0594360237851173,363
"13884","4341324",0.385509186237797,14694,0.444009165601644,14603,-0.0584999793638469,91
"13885","1441324",0.494384400275033,10525,0.530958354595951,10943,-0.0365739543209179,-418
"13886","2441324",0.431161227766845,13299,0.474583869955128,13572,-0.0434226421882836,-273
"13887","3441324",0.388047018953341,14633,0.445790036755349,14548,-0.0577430178020076,85
"13888","4441324",0.346572688252801,15482,0.403379661633538,15533,-0.0568069733807371,-51
"13889","1112324",0.742518591854462,890,0.755056621546929,1007,-0.0125380296924669,-117
"13890","2112324",0.679295419346273,2250,0.698682136906106,2454,-0.0193867175598325,-204
"13891","3112324",0.63618121053277,3708,0.669888303706326,3515,-0.0337070931735565,193
"13892","4112324",0.59470687983223,5482,0.627477928584516,5537,-0.0327710487522862,-55
"13893","1212324",0.688560814261466,1982,0.699752342601223,2416,-0.0111915283397569,-434
"13894","2212324",0.625337641753277,4112,0.6433778579604,4740,-0.0180402162071225,-628
"13895","3212324",0.582223432939774,6086,0.61458402476062,6232,-0.0323605918208465,-146
"13896","4212324",0.540749102239234,8193,0.57217364963881,8643,-0.031424547399576,-450
"13897","1312324",0.66058134398469,2797,0.672701775267925,3407,-0.0121204312832351,-610
"13898","2312324",0.597358171476501,5359,0.616327290627102,6150,-0.0189691191506007,-791
"13899","3312324",0.554243962662997,7491,0.587533457427322,7739,-0.0332894947643247,-248
"13900","4312324",0.512769631962458,9640,0.545123082305512,10163,-0.0323534503430543,-523
"13901","1412324",0.621644845999694,4268,0.632072271299819,5312,-0.0104274253001253,-1044
"13902","2412324",0.558421673491505,7257,0.575697786658996,8448,-0.017276113167491,-1191
"13903","3412324",0.515307464678001,9504,0.546903953459216,10061,-0.031596488781215,-557
"13904","4412324",0.473833133977462,11534,0.504493578337406,12272,-0.0306604443599445,-738
"13905","1122324",0.674539320988042,2384,0.694487309889522,2591,-0.0199479889014801,-207
"13906","2122324",0.611316148479853,4742,0.638112825248699,5037,-0.0267966767688457,-295
"13907","3122324",0.56820193966635,6791,0.60931899204892,6532,-0.0411170523825697,259
"13908","4122324",0.52672760896581,8919,0.566908616927109,8946,-0.0401810079612994,-27
"13909","1222324",0.620581543395046,4309,0.639183030943816,4972,-0.0186014875487701,-663
"13910","2222324",0.557358370886857,7318,0.582808546302993,8030,-0.0254501754161357,-712
"13911","3222324",0.514244162073354,9551,0.554014713103213,9682,-0.0397705510298597,-131
"13912","4222324",0.472769831372814,11576,0.511604337981403,11953,-0.0388345066085892,-377
"13913","1322324",0.59260207311827,5562,0.612132463610518,6380,-0.0195303904922484,-818
"13914","2322324",0.529378900610081,8769,0.555757978969695,9590,-0.026379078359614,-821
"13915","3322324",0.486264691796577,10940,0.526964145769915,11145,-0.040699453973338,-205
"13916","4322324",0.444790361096038,12766,0.484553770648105,13158,-0.0397634095520674,-392
"13917","1422324",0.553665575133274,7514,0.571502959642412,8693,-0.0178373845091385,-1179
"13918","2422324",0.490442402625085,10716,0.515128475001589,11772,-0.0246860723765042,-1056
"13919","3422324",0.447328193811581,12666,0.48633464180181,13080,-0.0390064479902282,-414
"13920","4422324",0.405853863111042,14141,0.443924266679999,14606,-0.0380704035689577,-465
"13921","1132324",0.631206798822942,3873,0.656022217441493,4142,-0.024815418618551,-269
"13922","2132324",0.567983626314754,6800,0.59964773280067,7078,-0.0316641064859166,-278
"13923","3132324",0.52486941750125,9003,0.570853899600891,8733,-0.0459844820996406,270
"13924","4132324",0.48339508680071,11078,0.52844352447908,11078,-0.0450484376783701,0
"13925","1232324",0.577249021229946,6328,0.600717938495787,7022,-0.0234689172658408,-694
"13926","2232324",0.514025848721757,9568,0.544343453854964,10220,-0.0303176051332064,-652
"13927","3232324",0.470911639908254,11651,0.515549620655184,11747,-0.0446379807469304,-96
"13928","4232324",0.429437309207714,13361,0.473139245533374,13640,-0.04370193632566,-279
"13929","1332324",0.54926955095317,7731,0.573667371162489,8562,-0.024397820209319,-831
"13930","2332324",0.486046378444981,10952,0.517292886521666,11650,-0.0312465080766846,-698
"13931","3332324",0.442932169631478,12829,0.488499053321886,12998,-0.0455668836904086,-169
"13932","4332324",0.401457838930938,14264,0.446088678200076,14539,-0.0446308392691383,-275
"13933","1432324",0.510333052968174,9746,0.533037867194383,10846,-0.0227048142262092,-1100
"13934","2432324",0.447109880459985,12676,0.47666338255356,13487,-0.0295535020935748,-811
"13935","3432324",0.403995671646482,14191,0.447869549353781,14488,-0.0438738777072988,-297
"13936","4432324",0.362521340945942,15216,0.40545917423197,15496,-0.0429378332860286,-280
"13937","1142324",0.582173234368113,6091,0.615623723314409,6185,-0.0334504889462963,-94
"13938","2142324",0.518950061859924,9289,0.559249238673586,9380,-0.0402991768136619,-91
"13939","3142324",0.475835853046421,11435,0.530455405473807,10979,-0.0546195524273859,456
"13940","4142324",0.434361522345881,13176,0.488045030351996,13020,-0.0536835080061156,156
"13941","1242324",0.528215456775117,8834,0.560319444368703,9306,-0.0321039875935863,-472
"13942","2242324",0.464992284266928,11906,0.50394495972788,12302,-0.0389526754609519,-396
"13943","3242324",0.421878075453424,13621,0.4751511265281,13544,-0.0532730510746759,77
"13944","4242324",0.380403744752884,14828,0.43274075140629,14903,-0.0523370066534055,-75
"13945","1342324",0.500235986498341,10255,0.533268877035405,10831,-0.0330328905370646,-576
"13946","2342324",0.437012813990152,13059,0.476894392394582,13474,-0.0398815784044301,-415
"13947","3342324",0.393898605176648,14481,0.448100559194802,14478,-0.0542019540181542,3
"13948","4342324",0.352424274476108,15400,0.405690184072992,15490,-0.0532659095968837,-90
"13949","1442324",0.461299488513345,12084,0.492639373067299,12819,-0.0313398845539547,-735
"13950","2442324",0.398076316005156,14352,0.436264888426476,14811,-0.0381885724213205,-459
"13951","3442324",0.354962107191652,15350,0.407471055226697,15453,-0.0525089480350445,-103
"13952","4442324",0.313487776491112,15920,0.365060680104886,16018,-0.051572903613774,-98
"13953","1113324",0.703635416281976,1617,0.72956003115769,1541,-0.0259246148757135,76
"13954","2113324",0.640412243773788,3548,0.673185546516867,3390,-0.0327733027430791,158
"13955","3113324",0.597298034960284,5362,0.644391713317087,4681,-0.0470936783568031,681
"13956","4113324",0.555823704259744,7406,0.601981338195277,6934,-0.0461576339355326,472
"13957","1213324",0.64967763868898,3204,0.674255752211984,3338,-0.0245781135230033,-134
"13958","2213324",0.586454466180792,5854,0.61788126757116,6053,-0.0314268013903689,-199
"13959","3213324",0.543340257367288,8051,0.589087434371381,7653,-0.0457471770040929,398
"13960","4213324",0.501865926666748,10173,0.546677059249571,10071,-0.0448111325828227,102
"13961","1313324",0.621698168412204,4267,0.647205184878686,4546,-0.0255070164664816,-279
"13962","2313324",0.558474995904015,7251,0.590830700237863,7555,-0.0323557043338472,-304
"13963","3313324",0.515360787090512,9502,0.562036867038083,9213,-0.0466760799475712,289
"13964","4313324",0.473886456389972,11532,0.519626491916273,11519,-0.0457400355263009,13
"13965","1413324",0.582761670427208,6053,0.60657568091058,6669,-0.0238140104833717,-616
"13966","2413324",0.519538497919019,9249,0.550201196269757,9883,-0.0306626983507374,-634
"13967","3413324",0.476424289105516,11404,0.521407363069977,11428,-0.0449830739644614,-24
"13968","4413324",0.434949958404976,13152,0.478996987948167,13374,-0.0440470295431911,-222
"13969","1123324",0.635656145415556,3721,0.668990719500283,3567,-0.0333345740847267,154
"13970","2123324",0.572432972907368,6564,0.61261623485946,6357,-0.0401832619520923,207
"13971","3123324",0.529318764093864,8779,0.58382240165968,7960,-0.0545036375658163,819
"13972","4123324",0.487844433393324,10862,0.54141202653787,10398,-0.0535675931445458,464
"13973","1223324",0.58169836782256,6105,0.613686440554577,6286,-0.0319880727320165,-181
"13974","2223324",0.518475195314372,9312,0.557311955913754,9489,-0.0388367605993821,-177
"13975","3223324",0.475360986500868,11449,0.528518122713974,11075,-0.0531571362131061,374
"13976","4223324",0.433886655800328,13188,0.486107747592164,13091,-0.0522210917918358,97
"13977","1323324",0.553718897545784,7510,0.586635873221279,7798,-0.0329169756754948,-288
"13978","2323324",0.490495725037595,10707,0.530261388580456,10989,-0.0397656635428604,-282
"13979","3323324",0.447381516224092,12660,0.501467555380676,12422,-0.0540860391565844,238
"13980","4323324",0.405907185523552,14137,0.459057180258866,14119,-0.0531499947353141,18
"13981","1423324",0.514782399560788,9524,0.546006369253173,10113,-0.0312239696923849,-589
"13982","2423324",0.451559227052599,12478,0.48963188461235,12951,-0.0380726575597506,-473
"13983","3423324",0.408445018239096,14046,0.460838051412571,14055,-0.0523930331734746,-9
"13984","4423324",0.366970687538556,15124,0.41842767629076,15229,-0.0514569887522044,-105
"13985","1133324",0.592323623250457,5575,0.630525627052254,5383,-0.0382020038017974,192
"13986","2133324",0.529100450742268,8786,0.574151142411431,8541,-0.045050691669163,245
"13987","3133324",0.485986241928765,10956,0.545357309211652,10154,-0.059371067282887,802
"13988","4133324",0.444511911228225,12774,0.502946934089841,12351,-0.0584350228616167,423
"13989","1233324",0.538365845657461,8311,0.575221348106548,8477,-0.0368555024490874,-166
"13990","2233324",0.475142673149272,11465,0.518846863465725,11565,-0.043704190316453,-100
"13991","3233324",0.432028464335768,13265,0.490053030265945,12932,-0.058024565930177,333
"13992","4233324",0.390554133635228,14574,0.447642655144135,14496,-0.0570885215089065,78
"13993","1333324",0.510386375380685,9742,0.54817078077325,10003,-0.0377844053925657,-261
"13994","2333324",0.447163202872496,12670,0.491796296132427,12855,-0.0446330932599312,-185
"13995","3333324",0.404048994058992,14188,0.463002462932647,13978,-0.0589534688736552,210
"13996","4333324",0.362574663358452,15215,0.420592087810837,15189,-0.0580174244523848,26
"13997","1433324",0.471449877395689,11635,0.507541276805144,12136,-0.0360913994094558,-501
"13998","2433324",0.4082267048875,14053,0.451166792164321,14372,-0.0429400872768215,-319
"13999","3433324",0.365112496073996,15164,0.422372958964542,15139,-0.0572604628905455,25
"14000","4433324",0.323638165373456,15806,0.379962583842731,15867,-0.0563244184692751,-61
"14001","1143324",0.543290058795627,8054,0.59012713292517,7597,-0.046837074129543,457
"14002","2143324",0.480066886287438,11217,0.533752648284347,10809,-0.0536857619969086,408
"14003","3143324",0.436952677473935,13064,0.504958815084568,12249,-0.0680061376106326,815
"14004","4143324",0.395478346773395,14429,0.462548439962757,13997,-0.0670700931893621,432
"14005","1243324",0.489332281202631,10779,0.534822853979464,10748,-0.0454905727768328,31
"14006","2243324",0.426109108694442,13470,0.478448369338641,13398,-0.0523392606441983,72
"14007","3243324",0.382994899880939,14759,0.449654536138861,14430,-0.0666596362579224,329
"14008","4243324",0.341520569180399,15567,0.407244161017051,15463,-0.0657235918366522,104
"14009","1343324",0.461352810925855,12078,0.507772286646166,12128,-0.046419475720311,-50
"14010","2343324",0.398129638417666,14347,0.451397802005343,14367,-0.0532681635876766,-20
"14011","3343324",0.355015429604163,15349,0.422603968805563,15135,-0.0675885392014006,214
"14012","4343324",0.313541098903623,15919,0.380193593683753,15864,-0.0666524947801304,55
"14013","1443324",0.422416312940859,13598,0.46714278267806,13846,-0.0447264697372011,-248
"14014","2443324",0.35919314043267,15271,0.410768298037237,15386,-0.0515751576045669,-115
"14015","3443324",0.316078931619167,15889,0.381974464837458,15833,-0.065895533218291,56
"14016","4443324",0.274604600918627,16195,0.339564089715647,16198,-0.0649594887970206,-3
"14017","1114324",0.651428344311407,3142,0.684909417784034,2931,-0.0334810734726275,211
"14018","2114324",0.588205171803218,5770,0.628534933143211,5475,-0.0403297613399931,295
"14019","3114324",0.545090962989714,7961,0.599741099943431,7069,-0.0546501369537171,892
"14020","4114324",0.503616632289174,10083,0.557330724821621,9487,-0.0537140925324466,596
"14021","1214324",0.597470566718411,5354,0.629605138838328,5428,-0.0321345721199173,-74
"14022","2214324",0.534247394210222,8500,0.573230654197505,8586,-0.0389832599872829,-86
"14023","3214324",0.491133185396718,10685,0.544436820997725,10214,-0.0533036356010069,471
"14024","4214324",0.449658854696178,12563,0.502026445875915,12393,-0.0523675911797367,170
"14025","1314324",0.569491096441634,6722,0.60255457150503,6898,-0.0330634750633956,-176
"14026","2314324",0.506267923933446,9939,0.546180086864207,10103,-0.0399121629307612,-164
"14027","3314324",0.463153715119942,11994,0.517386253664427,11644,-0.0542325385444852,350
"14028","4314324",0.421679384419402,13630,0.474975878542617,13554,-0.0532964941232149,76
"14029","1414324",0.530554598456638,8706,0.561925067536924,9220,-0.0313704690802857,-514
"14030","2414324",0.46733142594845,11800,0.505550582896101,12222,-0.0382191569476514,-422
"14031","3414324",0.424217217134946,13541,0.476756749696321,13481,-0.0525395325613754,60
"14032","4414324",0.382742886434406,14769,0.434346374574511,14858,-0.0516034881401052,-89
"14033","1124324",0.583449073444987,6031,0.624340106126627,5702,-0.0408910326816407,329
"14034","2124324",0.520225900936798,9225,0.567965621485804,8889,-0.0477397205490063,336
"14035","3124324",0.477111692123294,11371,0.539171788286025,10515,-0.0620600961627303,856
"14036","4124324",0.435637361422754,13118,0.496761413164214,12633,-0.0611240517414598,485
"14037","1224324",0.529491295851991,8759,0.569035827180921,8830,-0.0395445313289305,-71
"14038","2224324",0.466268123343802,11847,0.512661342540098,11895,-0.0463932191962961,-48
"14039","3224324",0.423153914530298,13577,0.483867509340318,13187,-0.0607135948100201,390
"14040","4224324",0.381679583829758,14787,0.441457134218508,14672,-0.0597775503887499,115
"14041","1324324",0.501511825575214,10196,0.541985259847623,10357,-0.0404734342724088,-161
"14042","2324324",0.438288653067026,13003,0.4856107752068,13116,-0.0473221221397743,-113
"14043","3324324",0.395174444253522,14442,0.45681694200702,14187,-0.0616424977534984,255
"14044","4324324",0.353700113552982,15370,0.41440656688521,15318,-0.0607064533322281,52
"14045","1424324",0.462575327590218,12017,0.501355755879517,12427,-0.038780428289299,-410
"14046","2424324",0.39935215508203,14315,0.444981271238694,14573,-0.0456291161566646,-258
"14047","3424324",0.356237946268526,15325,0.416187438038915,15276,-0.0599494917703887,49
"14048","4424324",0.314763615567986,15900,0.373777062917104,15937,-0.0590134473491183,-37
"14049","1134324",0.540116551279887,8226,0.585875013678599,7842,-0.0457584623987114,384
"14050","2134324",0.476893378771698,11378,0.529500529037775,11029,-0.052607150266077,349
"14051","3134324",0.433779169958195,13193,0.500706695837996,12458,-0.066927525879801,735
"14052","4134324",0.392304839257655,14524,0.458296320716185,14145,-0.0659914814585307,379
"14053","1234324",0.486158773686891,10949,0.530570734732892,10965,-0.0444119610460014,-16
"14054","2234324",0.422935601178702,13584,0.474196250092069,13588,-0.051260648913367,-4
"14055","3234324",0.379821392365198,14845,0.44540241689229,14560,-0.065581024527091,285
"14056","4234324",0.338347061664659,15624,0.402992041770479,15543,-0.0646449801058206,81
"14057","1334324",0.458179303410115,12224,0.503520167399594,12320,-0.0453408639894797,-96
"14058","2334324",0.394956130901926,14449,0.447145682758771,14512,-0.0521895518568453,-63
"14059","3334324",0.351841922088422,15408,0.418351849558992,15232,-0.0665099274705693,176
"14060","4334324",0.310367591387882,15952,0.375941474437181,15914,-0.0655738830492988,38
"14061","1434324",0.419242805425119,13721,0.462890663431488,13982,-0.0436478580063698,-261
"14062","2434324",0.35601963291693,15329,0.406516178790665,15474,-0.0504965458737355,-145
"14063","3434324",0.312905424103426,15924,0.377722345590886,15890,-0.0648169214874595,34
"14064","4434324",0.271431093402886,16214,0.335311970469076,16221,-0.0638808770661892,-7
"14065","1144324",0.491082986825057,10688,0.545476519551514,10142,-0.054393532726457,546
"14066","2144324",0.427859814316869,13404,0.489102034910691,12973,-0.0612422205938225,431
"14067","3144324",0.384745605503365,14712,0.460308201710912,14071,-0.0755625962075466,641
"14068","4144324",0.343271274802825,15538,0.417897826589101,15240,-0.0746265517862761,298
"14069","1244324",0.437125209232061,13052,0.490172240605808,12925,-0.0530470313737467,127
"14070","2244324",0.373902036723873,14967,0.433797755964985,14872,-0.0598957192411124,95
"14071","3244324",0.330787827910369,15719,0.405003922765205,15504,-0.0742160948548364,215
"14072","4244324",0.289313497209829,16104,0.362593547643395,16045,-0.0732800504335661,59
"14073","1344324",0.409145738955285,14028,0.46312167327251,13973,-0.053975934317225,55
"14074","2344324",0.345922566447096,15492,0.406747188631687,15470,-0.0608246221845906,22
"14075","3344324",0.302808357633593,16013,0.377953355431908,15888,-0.0751449977983147,125
"14076","4344324",0.261334026933053,16248,0.335542980310097,16220,-0.0742089533770444,28
"14077","1444324",0.370209240970289,15048,0.422492169304404,15137,-0.0522829283341152,-89
"14078","2444324",0.3069860684621,15979,0.366117684663581,16006,-0.0591316162014809,-27
"14079","3444324",0.263871859648597,16241,0.337323851463802,16211,-0.073451991815205,30
"14080","4444324",0.222397528948057,16341,0.294913476341991,16338,-0.0725159473939346,3
"14081","1111424",0.745811486604004,846,0.759250463238466,942,-0.0134389766344623,-96
"14082","2111424",0.682588314095815,2151,0.702875978597643,2323,-0.0202876645018278,-172
"14083","3111424",0.639474105282311,3589,0.674082145397863,3344,-0.0346080401155519,245
"14084","4111424",0.597999774581771,5324,0.631671770276053,5334,-0.0336719956942816,-10
"14085","1211424",0.691853709011007,1907,0.70394618429276,2277,-0.0120924752817523,-370
"14086","2211424",0.628630536502818,3979,0.647571699651936,4529,-0.0189411631491179,-550
"14087","3211424",0.585516327689315,5923,0.618777866452157,6003,-0.0332615387628419,-80
"14088","4211424",0.544041996988775,8016,0.576367491330346,8403,-0.0323254943415714,-387
"14089","1311424",0.663874238734231,2701,0.676895616959462,3253,-0.0130213782252305,-552
"14090","2311424",0.600651066226042,5196,0.620521132318638,5914,-0.0198700660925961,-718
"14091","3311424",0.557536857412539,7302,0.591727299118859,7512,-0.0341904417063201,-210
"14092","4311424",0.516062526711999,9467,0.549316923997049,9931,-0.0332543972850496,-464
"14093","1411424",0.624937740749235,4134,0.636266112991356,5110,-0.0113283722421207,-976
"14094","2411424",0.561714568241046,7077,0.579891628350533,8204,-0.0181770601094864,-1127
"14095","3411424",0.518600359427543,9307,0.551097795150753,9840,-0.0324974357232104,-533
"14096","4411424",0.477126028727003,11369,0.508687420028943,12080,-0.0315613913019399,-711
"14097","1121424",0.677832215737584,2294,0.698681151581059,2455,-0.0208489358434755,-161
"14098","2121424",0.614609043229395,4574,0.642306666940236,4799,-0.0276976237108411,-225
"14099","3121424",0.571494834415891,6613,0.613512833740456,6297,-0.0420179993245651,316
"14100","4121424",0.530020503715351,8735,0.571102458618646,8723,-0.0410819549032948,12
"14101","1221424",0.623874438144587,4182,0.643376872635353,4741,-0.0195024344907655,-559
"14102","2221424",0.560651265636398,7139,0.58700238799453,7777,-0.0263511223581311,-638
"14103","3221424",0.517537056822895,9379,0.55820855479475,9433,-0.0406714979718551,-54
"14104","4221424",0.476062726122355,11419,0.51579817967294,11729,-0.0397354535505846,-310
"14105","1321424",0.595894967867811,5427,0.616326305302055,6151,-0.0204313374342437,-724
"14106","2321424",0.532671795359622,8587,0.559951820661232,9337,-0.0272800253016093,-750
"14107","3321424",0.489557586546119,10766,0.531157987461452,10932,-0.0416004009153333,-166
"14108","4321424",0.448083255845579,12633,0.488747612339642,12988,-0.0406643564940628,-355
"14109","1421424",0.556958469882815,7346,0.575696801333949,8449,-0.0187383314511339,-1103
"14110","2421424",0.493735297374626,10559,0.519322316693126,11540,-0.0255870193184996,-981
"14111","3421424",0.450621088561123,12521,0.490528483493346,12908,-0.0399073949322236,-387
"14112","4421424",0.409146757860583,14027,0.448118108371536,14476,-0.0389713505109531,-449
"14113","1131424",0.634499693572484,3762,0.66021605913303,3960,-0.0257163655605464,-198
"14114","2131424",0.571276521064295,6624,0.603841574492207,6831,-0.0325650534279119,-207
"14115","3131424",0.528162312250791,8838,0.575047741292427,8485,-0.046885429041636,353
"14116","4131424",0.486687981550252,10921,0.532637366170617,10867,-0.0459493846203655,54
"14117","1231424",0.580541915979488,6172,0.604911780187324,6779,-0.0243698642078362,-607
"14118","2231424",0.517318743471299,9395,0.548537295546501,9978,-0.0312185520752017,-583
"14119","3231424",0.474204534657795,11514,0.519743462346721,11512,-0.0455389276889258,2
"14120","4231424",0.432730203957255,13241,0.477333087224911,13457,-0.0446028832676554,-216
"14121","1331424",0.552562445702712,7563,0.577861212854026,8330,-0.0252987671513144,-767
"14122","2331424",0.489339273194523,10778,0.521486728213203,11423,-0.03214745501868,-645
"14123","3331424",0.446225064381019,12706,0.492692895013423,12815,-0.046467830632404,-109
"14124","4331424",0.404750733680479,14172,0.450282519891613,14409,-0.0455317862111337,-237
"14125","1431424",0.513625947717716,9586,0.53723170888592,10623,-0.0236057611682046,-1037
"14126","2431424",0.450402775209527,12528,0.480857224245097,13306,-0.0304544490355702,-778
"14127","3431424",0.407288566396023,14090,0.452063391045318,14343,-0.0447748246492942,-253
"14128","4431424",0.365814235695483,15152,0.409653015923507,15412,-0.0438387802280239,-260
"14129","1141424",0.585466129117654,5927,0.619817565005946,5948,-0.0343514358882917,-21
"14130","2141424",0.522242956609466,9137,0.563443080365123,9133,-0.0412001237556573,4
"14131","3141424",0.479128747795962,11270,0.534649247165343,10756,-0.0555204993693813,514
"14132","4141424",0.437654417095422,13033,0.492238872043533,12841,-0.054584454948111,192
"14133","1241424",0.531508351524658,8650,0.56451328606024,9072,-0.0330049345355817,-422
"14134","2241424",0.468285179016469,11767,0.508138801419417,12105,-0.0398536224029473,-338
"14135","3241424",0.425170970202966,13505,0.479344968219637,13361,-0.0541739980166713,144
"14136","4241424",0.383696639502426,14741,0.436934593097827,14790,-0.0532379535954008,-49
"14137","1341424",0.503528881247882,10090,0.537462718726942,10612,-0.03393383747906,-522
"14138","2341424",0.440305708739693,12932,0.481088234086119,13291,-0.0407825253464255,-359
"14139","3341424",0.39719149992619,14379,0.452294400886339,14335,-0.0551029009601495,44
"14140","4341424",0.35571716922565,15337,0.409884025764529,15405,-0.0541668565388791,-68
"14141","1441424",0.464592383262886,11928,0.496833214758836,12626,-0.0322408314959501,-698
"14142","2441424",0.401369210754697,14268,0.440458730118013,14700,-0.0390895193633158,-432
"14143","3441424",0.358255001941194,15288,0.411664896918233,15368,-0.0534098949770397,-80
"14144","4441424",0.316780671240654,15880,0.369254521796423,15976,-0.0524738505557693,-96
"14145","1112424",0.712726574842315,1411,0.720931481709814,1780,-0.00820490686749908,-369
"14146","2112424",0.649503402334126,3212,0.66455699706899,3774,-0.0150535947348647,-562
"14147","3112424",0.606389193520622,4963,0.635763163869211,5133,-0.0293739703485887,-170
"14148","4112424",0.564914862820082,6937,0.593352788747401,7440,-0.0284379259273184,-503
"14149","1212424",0.658768797249318,2855,0.665627202764107,3713,-0.00685840551478911,-858
"14150","2212424",0.59554562474113,5444,0.609252718123284,6535,-0.0137070933821547,-1091
"14151","3212424",0.552431415927626,7572,0.580458884923505,8160,-0.0280274689958787,-588
"14152","4212424",0.510957085227086,9722,0.538048509801694,10573,-0.0270914245746082,-851
"14153","1312424",0.630789326972542,3881,0.63857663543081,5011,-0.00778730845826736,-1130
"14154","2312424",0.567566154464353,6817,0.582202150789986,8070,-0.014635996325633,-1253
"14155","3312424",0.52445194565085,9022,0.553408317590207,9723,-0.028956371939357,-701
"14156","4312424",0.48297761495031,11097,0.510997942468396,11984,-0.0280203275180865,-887
"14157","1412424",0.591852828987546,5589,0.597947131462704,7184,-0.00609430247515752,-1595
"14158","2412424",0.528629656479357,8805,0.541572646821881,10385,-0.0129429903425232,-1580
"14159","3412424",0.485515447665854,10974,0.512778813622101,11888,-0.0272633659562472,-914
"14160","4412424",0.444041116965314,12803,0.470368438500291,13751,-0.0263273215349767,-948
"14161","1122424",0.644747303975895,3373,0.660362170052407,3954,-0.0156148660765123,-581
"14162","2122424",0.581524131467706,6120,0.603987685411584,6826,-0.0224635539438779,-706
"14163","3122424",0.538409922654202,8308,0.575193852211804,8478,-0.0367839295576019,-170
"14164","4122424",0.496935591953662,10414,0.532783477089994,10862,-0.0358478851363316,-448
"14165","1222424",0.590789526382898,5641,0.605057891106701,6766,-0.0142683647238023,-1125
"14166","2222424",0.52756635387471,8864,0.548683406465877,9968,-0.0211170525911679,-1104
"14167","3222424",0.484452145061206,11017,0.519889573266098,11502,-0.0354374282048919,-485
"14168","4222424",0.442977814360666,12828,0.477479198144288,13447,-0.0345013837836214,-619
"14169","1322424",0.562810056106122,7020,0.578007323773403,8319,-0.0151972676672806,-1299
"14170","2322424",0.499586883597933,10282,0.52163283913258,11415,-0.0220459555346462,-1133
"14171","3322424",0.45647267478443,12279,0.4928390059328,12810,-0.0363663311483701,-531
"14172","4322424",0.41499834408389,13848,0.45042863081099,14404,-0.0354302867270996,-556
"14173","1422424",0.523873558121126,9053,0.537377819805297,10619,-0.0135042616841707,-1566
"14174","2422424",0.460650385612937,12112,0.481003335164474,13298,-0.0203529495515364,-1186
"14175","3422424",0.417536176799434,13768,0.452209501964694,14338,-0.0346733251652604,-570
"14176","4422424",0.376061846098894,14925,0.409799126842884,15409,-0.03373728074399,-484
"14177","1132424",0.601414781810795,5165,0.621897077604378,5832,-0.0204822957935832,-667
"14178","2132424",0.538191609302606,8321,0.565522592963555,9014,-0.0273309836609488,-693
"14179","3132424",0.495077400489103,10493,0.536728759763775,10650,-0.0416513592746728,-157
"14180","4132424",0.453603069788563,12404,0.494318384641965,12745,-0.0407153148534022,-341
"14181","1232424",0.547457004217799,7814,0.566592798658672,8962,-0.019135794440873,-1148
"14182","2232424",0.48423383170961,11037,0.510218314017849,12022,-0.0259844823082386,-985
"14183","3232424",0.441119622896107,12898,0.481424480818069,13280,-0.0403048579219625,-382
"14184","4232424",0.399645292195566,14306,0.439014105696259,14735,-0.0393688135006923,-429
"14185","1332424",0.519477533941023,9254,0.539542231325374,10496,-0.0200646973843512,-1242
"14186","2332424",0.456254361432834,12292,0.483167746684551,13212,-0.0269133852517168,-920
"14187","3332424",0.41314015261933,13897,0.454373913484771,14275,-0.0412337608654408,-378
"14188","4332424",0.37166582191879,15014,0.411963538362961,15365,-0.0402977164441705,-351
"14189","1432424",0.480541035956027,11198,0.498912727357268,12552,-0.0183716914012413,-1354
"14190","2432424",0.417317863447838,13779,0.442538242716445,14646,-0.025220379268607,-867
"14191","3432424",0.374203654634334,14958,0.413744409516665,15331,-0.0395407548823311,-373
"14192","4432424",0.332729323933794,15694,0.371334034394855,15962,-0.0386047104610607,-268
"14193","1142424",0.552381217355965,7576,0.581498583477294,8104,-0.0291173661213285,-528
"14194","2142424",0.489158044847777,10793,0.525124098836471,11242,-0.0359660539886941,-449
"14195","3142424",0.446043836034273,12716,0.496330265636691,12657,-0.0502864296024181,59
"14196","4142424",0.404569505333733,14178,0.453919890514881,14291,-0.0493503851811478,-113
"14197","1242424",0.498423439762969,10339,0.526194304531588,11188,-0.0277708647686186,-849
"14198","2242424",0.43520026725478,13137,0.469819819890764,13771,-0.0346195526359841,-634
"14199","3242424",0.392086058441277,14537,0.441025986690985,14685,-0.0489399282497081,-148
"14200","4242424",0.350611727740737,15429,0.398615611569175,15605,-0.0480038838284377,-176
"14201","1342424",0.470443969486193,11672,0.49914373719829,12540,-0.0286997677120968,-868
"14202","2342424",0.407220796978004,14094,0.442769252557467,14640,-0.0355484555794623,-546
"14203","3342424",0.364106588164501,15180,0.413975419357687,15326,-0.0498688311931863,-146
"14204","4342424",0.322632257463961,15817,0.371565044235877,15960,-0.0489327867719159,-143
"14205","1442424",0.431507471501197,13288,0.458514233230184,14135,-0.0270067617289869,-847
"14206","2442424",0.368284298993008,15094,0.402139748589361,15563,-0.0338554495963526,-469
"14207","3442424",0.325170090179505,15789,0.373345915389581,15940,-0.0481758252100765,-151
"14208","4442424",0.283695759478965,16146,0.330935540267771,16242,-0.0472397807888061,-96
"14209","1113424",0.673843399269829,2392,0.695434891320575,2562,-0.0215914920507457,-170
"14210","2113424",0.61062022676164,4766,0.639060406679751,4985,-0.0284401799181113,-219
"14211","3113424",0.567506017948137,6820,0.610266573479972,6471,-0.0427605555318353,349
"14212","4113424",0.526031687247597,8958,0.567856198358162,8897,-0.0418245111105648,61
"14213","1213424",0.619885621676833,4338,0.640130612374868,4907,-0.0202449906980355,-569
"14214","2213424",0.556662449168644,7359,0.583756127734045,7963,-0.0270936785654011,-604
"14215","3213424",0.513548240355141,9591,0.554962294534266,9626,-0.0414140541791251,-35
"14216","4213424",0.4720739096546,11615,0.512551919412455,11900,-0.0404780097578549,-285
"14217","1313424",0.591906151400057,5587,0.61308004504157,6321,-0.0211738936415138,-734
"14218","2313424",0.528682978891868,8801,0.556705560400747,9529,-0.0280225815088794,-728
"14219","3313424",0.485568770078364,10972,0.527911727200968,11100,-0.0423429571226034,-128
"14220","4313424",0.444094439377824,12802,0.485501352079157,13120,-0.0414069127013331,-318
"14221","1413424",0.552969653415061,7545,0.572450541073465,8625,-0.0194808876584039,-1080
"14222","2413424",0.489746480906872,10758,0.516076056432642,11713,-0.0263295755257696,-955
"14223","3413424",0.446632272093368,12696,0.487282223232862,13041,-0.0406499511394936,-345
"14224","4413424",0.405157941392828,14165,0.444871848111052,14575,-0.0397139067182233,-410
"14225","1123424",0.605864128403409,4977,0.634865579663168,5190,-0.029001451259759,-213
"14226","2123424",0.54264095589522,8087,0.578491095022345,8288,-0.0358501391271245,-201
"14227","3123424",0.499526747081717,10289,0.549697261822565,9908,-0.0501705147408485,381
"14228","4123424",0.458052416381177,12231,0.507286886700755,12148,-0.0492344703195781,83
"14229","1223424",0.551906350810413,7601,0.579561300717462,8220,-0.0276549499070488,-619
"14230","2223424",0.488683178302224,10815,0.523186816076638,11336,-0.0345036377744143,-521
"14231","3223424",0.445568969488721,12728,0.494392982876859,12740,-0.0488240133881383,-12
"14232","4223424",0.40409463878818,14186,0.451982607755049,14345,-0.047887968966868,-159
"14233","1323424",0.523926880533637,9049,0.552510733384164,9772,-0.028583852850527,-723
"14234","2323424",0.460703708025448,12108,0.49613624874334,12662,-0.0354325407178925,-554
"14235","3323424",0.417589499211944,13764,0.467342415543561,13841,-0.0497529163316165,-77
"14236","4323424",0.376115168511404,14923,0.424932040421751,15087,-0.0488168719103463,-164
"14237","1423424",0.484990382548641,10998,0.511881229416058,11939,-0.0268908468674172,-941
"14238","2423424",0.421767210040452,13626,0.455506744775235,14229,-0.0337395347347828,-603
"14239","3423424",0.378653001226948,14866,0.426712911575455,15044,-0.0480599103485069,-178
"14240","4423424",0.337178670526408,15641,0.384302536453645,15802,-0.0471238659272366,-161
"14241","1133424",0.562531606238309,7034,0.596400487215139,7270,-0.0338688809768296,-236
"14242","2133424",0.499308433730121,10301,0.540026002574316,10473,-0.0407175688441952,-172
"14243","3133424",0.456194224916617,12297,0.511232169374536,11976,-0.0550379444579192,321
"14244","4133424",0.414719894216077,13857,0.468821794252726,13800,-0.0541019000366489,57
"14245","1233424",0.508573828645313,9818,0.541096208269433,10415,-0.0325223796241196,-597
"14246","2233424",0.445350656137124,12745,0.48472172362861,13150,-0.0393710674914852,-405
"14247","3233424",0.402236447323621,14239,0.45592789042883,14215,-0.0536914431052092,24
"14248","4233424",0.360762116623081,15243,0.41351751530702,15337,-0.0527553986839387,-94
"14249","1333424",0.480594358368537,11195,0.514045640936135,11828,-0.0334512825675979,-633
"14250","2333424",0.417371185860348,13773,0.457671156295312,14158,-0.0402999704349634,-385
"14251","3333424",0.374256977046845,14956,0.428877323095532,15005,-0.0546203460486875,-49
"14252","4333424",0.332782646346305,15692,0.386466947973722,15777,-0.0536843016274169,-85
"14253","1433424",0.441657860383541,12877,0.473416136968029,13626,-0.031758276584488,-749
"14254","2433424",0.378434687875352,14876,0.417041652327206,15257,-0.0386069644518537,-381
"14255","3433424",0.335320479061849,15663,0.388247819127426,15751,-0.0529273400655777,-88
"14256","4433424",0.293846148361309,16078,0.345837444005616,16159,-0.0519912956443072,-81
"14257","1143424",0.51349804178348,9594,0.556001993088055,9577,-0.0425039513045752,17
"14258","2143424",0.450274869275291,12534,0.499627508447232,12514,-0.0493526391719407,20
"14259","3143424",0.407160660461787,14097,0.470833675247452,13731,-0.0636730147856647,366
"14260","4143424",0.365686329761248,15155,0.428423300125642,15016,-0.0627369703643943,139
"14261","1243424",0.459540264190484,12159,0.500697714142349,12460,-0.041157449951865,-301
"14262","2243424",0.396317091682295,14408,0.444323229501525,14593,-0.0480061378192306,-185
"14263","3243424",0.353202882868791,15382,0.415529396301746,15290,-0.0623265134329546,92
"14264","4243424",0.311728552168251,15935,0.373119021179936,15944,-0.0613904690116843,-9
"14265","1343424",0.431560793913708,13285,0.473647146809051,13616,-0.0420863528953432,-331
"14266","2343424",0.368337621405519,15091,0.417272662168228,15253,-0.0489350407627088,-162
"14267","3343424",0.325223412592015,15788,0.388478828968448,15748,-0.0632554163764328,40
"14268","4343424",0.283749081891475,16145,0.346068453846638,16158,-0.0623193719551625,-13
"14269","1443424",0.392624295928712,14519,0.433017642840945,14894,-0.0403933469122334,-375
"14270","2443424",0.329401123420523,15737,0.376643158200122,15903,-0.047242034779599,-166
"14271","3443424",0.286286914607019,16132,0.347849325000342,16145,-0.061562410393323,-13
"14272","4443424",0.244812583906479,16304,0.305438949878532,16320,-0.0606263659720527,-16
"14273","1114424",0.621636327299259,4269,0.650784277946919,4378,-0.0291479506476597,-109
"14274","2114424",0.55841315479107,7258,0.594409793306096,7377,-0.0359966385150253,-119
"14275","3114424",0.515298945977567,9505,0.565615960106316,9007,-0.0503170141287493,498
"14276","4114424",0.473824615277027,11535,0.523205584984506,11333,-0.0493809697074789,202
"14277","1214424",0.567678549706263,6812,0.595479999001213,7318,-0.0278014492949495,-506
"14278","2214424",0.504455377198074,10034,0.539105514360389,10518,-0.0346501371623151,-484
"14279","3214424",0.461341168384571,12079,0.51031168116061,12017,-0.0489705127760391,62
"14280","4214424",0.419866837684031,13701,0.4679013060388,13824,-0.0480344683547688,-123
"14281","1314424",0.539699079429487,8244,0.568429431667915,8863,-0.0287303522384278,-619
"14282","2314424",0.476475906921298,11402,0.512054947027091,11928,-0.0355790401057934,-526
"14283","3314424",0.433361698107795,13216,0.483261113827312,13208,-0.0498994157195173,8
"14284","4314424",0.391887367407255,14548,0.440850738705502,14689,-0.048963371298247,-141
"14285","1414424",0.500762581444491,10224,0.527799927699809,11107,-0.027037346255318,-883
"14286","2414424",0.437539408936302,13038,0.471425443058986,13707,-0.0338860341226836,-669
"14287","3414424",0.394425200122799,14465,0.442631609859206,14643,-0.0482064097364077,-178
"14288","4414424",0.352950869422259,15393,0.400221234737396,15586,-0.0472703653151373,-193
"14289","1124424",0.553657056432839,7516,0.590214966289512,7589,-0.036557909856673,-73
"14290","2124424",0.49043388392465,10718,0.533840481648689,10799,-0.0434065977240385,-81
"14291","3124424",0.447319675111147,12668,0.505046648448909,12242,-0.0577269733377626,426
"14292","4124424",0.405845344410607,14143,0.462636273327099,13992,-0.056790928916492,151
"14293","1224424",0.499699278839843,10278,0.534910687343806,10742,-0.0352114085039628,-464
"14294","2224424",0.436476106331654,13077,0.478536202702983,13392,-0.0420600963713283,-315
"14295","3224424",0.393361897518151,14493,0.449742369503203,14426,-0.0563804719850524,67
"14296","4224424",0.351887566817611,15407,0.407331994381393,15457,-0.055444427563782,-50
"14297","1324424",0.471719808563067,11626,0.507860120010508,12125,-0.036140311447441,-499
"14298","2324424",0.408496636054878,14044,0.451485635369685,14363,-0.0429889993148065,-319
"14299","3324424",0.365382427241375,15158,0.422691802169905,15134,-0.0573093749285306,24
"14300","4324424",0.323908096540835,15804,0.380281427048095,15862,-0.0563733305072602,-58
"14301","1424424",0.432783310578071,13239,0.467230616042402,13844,-0.0344473054643311,-605
"14302","2424424",0.369560138069882,15061,0.410856131401579,15383,-0.0412959933316969,-322
"14303","3424424",0.326445929256379,15772,0.382062298201799,15832,-0.0556163689454208,-60
"14304","4424424",0.284971598555839,16138,0.339651923079989,16197,-0.0546803245241504,-59
"14305","1134424",0.51032453426774,9747,0.551749873841483,9807,-0.0414253395737436,-60
"14306","2134424",0.447101361759551,12677,0.49537538920066,12701,-0.0482740274411091,-24
"14307","3134424",0.403987152946047,14192,0.46658155600088,13864,-0.0625944030548332,328
"14308","4134424",0.362512822245507,15217,0.42417118087907,15104,-0.0616583586335628,113
"14309","1234424",0.456366756674743,12284,0.496445594895777,12648,-0.0400788382210336,-364
"14310","2234424",0.393143584166555,14501,0.440071110254954,14711,-0.0469275260883991,-210
"14311","3234424",0.350029375353051,15438,0.411277277055174,15376,-0.0612479017021231,62
"14312","4234424",0.308555044652511,15967,0.368866901933364,15981,-0.0603118572808527,-14
"14313","1334424",0.428387286397967,13390,0.469395027562479,13783,-0.0410077411645118,-393
"14314","2334424",0.365164113889778,15162,0.413020542921656,15349,-0.0478564290318774,-187
"14315","3334424",0.322049905076275,15822,0.384226709721876,15803,-0.0621768046456013,19
"14316","4334424",0.280575574375735,16162,0.341816334600066,16185,-0.0612407602243309,-23
"14317","1434424",0.389450788412971,14601,0.428765523594373,15008,-0.0393147351814019,-407
"14318","2434424",0.326227615904782,15777,0.37239103895355,15954,-0.0461634230487676,-177
"14319","3434424",0.283113407091279,16148,0.34359720575377,16173,-0.0604837986624915,-25
"14320","4434424",0.241639076390739,16312,0.30118683063196,16330,-0.0595477542412212,-18
"14321","1144424",0.46129096981291,12085,0.511351379714399,11970,-0.0500604099014892,115
"14322","2144424",0.398067797304721,14353,0.454976895073576,14248,-0.0569090977688547,105
"14323","3144424",0.354953588491218,15351,0.426183061873796,15056,-0.0712294733825787,295
"14324","4144424",0.313479257790678,15921,0.383772686751986,15811,-0.0702934289613082,110
"14325","1244424",0.407333192219914,14088,0.456047100768693,14210,-0.0487139085487789,-122
"14326","2244424",0.344110019711725,15526,0.39967261612787,15591,-0.0555625964161446,-65
"14327","3244424",0.300995810898222,16029,0.37087878292809,15966,-0.0698829720298685,63
"14328","4244424",0.259521480197682,16257,0.32846840780628,16246,-0.0689469276085981,11
"14329","1344424",0.379353721943138,14853,0.428996533435395,15002,-0.0496428114922572,-149
"14330","2344424",0.316130549434949,15888,0.372622048794572,15951,-0.0564914993596228,-63
"14331","3344424",0.273016340621445,16204,0.343828215594792,16172,-0.0708118749733467,32
"14332","4344424",0.231542009920905,16328,0.301417840472982,16329,-0.0698758305520764,-1
"14333","1444424",0.340417223958142,15590,0.388367029467289,15749,-0.0479498055091473,-159
"14334","2444424",0.277194051449953,16183,0.331992544826466,16237,-0.054798493376513,-54
"14335","3444424",0.234079842636449,16324,0.303198711626686,16326,-0.0691188689902371,-2
"14336","4444424",0.192605511935909,16372,0.260788336504876,16374,-0.0681828245689667,-2
"14337","1111134",0.814856490971402,221,0.836168989564295,182,-0.0213124985928929,39
"14338","2111134",0.751633318463213,762,0.779794504923471,639,-0.0281611864602584,123
"14339","3111134",0.708519109649709,1508,0.751000671723692,1081,-0.0424815620739825,427
"14340","4111134",0.667044778949169,2596,0.708590296601881,2129,-0.0415455176527121,467
"14341","1211134",0.760898713378406,656,0.780864710618588,629,-0.0199659972401828,27
"14342","2211134",0.697675540870217,1750,0.724490225977765,1688,-0.0268146851075484,62
"14343","3211134",0.654561332056713,3007,0.695696392777986,2551,-0.0411350607212724,456
"14344","4211134",0.613087001356173,4655,0.653286017656175,4272,-0.040199016300002,383
"14345","1311134",0.732919243101629,1042,0.75381414328529,1025,-0.020894900183661,17
"14346","2311134",0.66969607059344,2513,0.697439658644467,2489,-0.0277435880510266,24
"14347","3311134",0.626581861779937,4051,0.668645825444688,3583,-0.0420639636647506,468
"14348","4311134",0.585107531079397,5947,0.626235450322877,5605,-0.0411279192434802,342
"14349","1411134",0.693982745116633,1844,0.713184639317185,1978,-0.0192018942005512,-134
"14350","2411134",0.630759572608445,3883,0.656810154676361,4111,-0.0260505820679169,-228
"14351","3411134",0.587645363794941,5794,0.628016321476582,5501,-0.0403709576816409,293
"14352","4411134",0.546171033094401,7894,0.585605946354772,7855,-0.0394349132603705,39
"14353","1121134",0.746877220104982,828,0.775599677906888,687,-0.0287224578019061,141
"14354","2121134",0.683654047596793,2113,0.719225193266064,1824,-0.0355711456692717,289
"14355","3121134",0.640539838783289,3543,0.690431360066285,2732,-0.0498915212829957,811
"14356","4121134",0.599065508082749,5276,0.648020984944475,4503,-0.0489554768617253,773
"14357","1221134",0.692919442511986,1876,0.720295398961182,1802,-0.027375956449196,74
"14358","2221134",0.629696270003797,3924,0.663920914320358,3802,-0.0342246443165616,122
"14359","3221134",0.586582061190293,5846,0.635127081120579,5172,-0.0485450199302856,674
"14360","4221134",0.545107730489753,7959,0.592716705998768,7470,-0.0476089755090152,489
"14361","1321134",0.664939972235209,2663,0.693244831627884,2632,-0.0283048593926742,31
"14362","2321134",0.60171679972702,5146,0.63687034698706,5082,-0.0351535472600398,64
"14363","3321134",0.558602590913517,7247,0.608076513787281,6603,-0.0494739228737638,644
"14364","4321134",0.517128260212977,9408,0.56566613866547,9004,-0.0485378784524935,404
"14365","1421134",0.626003474250213,4072,0.652615327659778,4297,-0.0266118534095644,-225
"14366","2421134",0.562780301742025,7023,0.596240843018955,7279,-0.0334605412769301,-256
"14367","3421134",0.519666092928521,9243,0.567447009819175,8914,-0.0477809168906541,329
"14368","4421134",0.478191762227981,11311,0.525036634697365,11246,-0.0468448724693837,65
"14369","1131134",0.703544697939882,1620,0.737134585458859,1370,-0.0335898875189768,250
"14370","2131134",0.640321525431693,3552,0.680760100818036,3099,-0.0404385753863424,453
"14371","3131134",0.59720731661819,5366,0.651966267618256,4322,-0.0547589510000664,1044
"14372","4131134",0.55573298591765,7415,0.609555892496446,6521,-0.0538229065787961,894
"14373","1231134",0.649586920346886,3206,0.681830306513153,3058,-0.0322433861662668,148
"14374","2231134",0.586363747838697,5862,0.625455821872329,5641,-0.0390920740336324,221
"14375","3231134",0.543249539025194,8057,0.59666198867255,7255,-0.0534124496473564,802
"14376","4231134",0.501775208324654,10178,0.55425161355074,9669,-0.052476405226086,509
"14377","1331134",0.62160745007011,4270,0.654779739179855,4198,-0.033172289109745,72
"14378","2331134",0.558384277561921,7260,0.598405254539031,7152,-0.0400209769771106,108
"14379","3331134",0.515270068748417,9510,0.569611421339252,8799,-0.0543413525908346,711
"14380","4331134",0.473795738047877,11537,0.527201046217442,11134,-0.0534053081695642,403
"14381","1431134",0.582670952085114,6054,0.614150235211749,6258,-0.0314792831266352,-204
"14382","2431134",0.519447779576925,9255,0.557775750570926,9457,-0.0383279709940009,-202
"14383","3431134",0.476333570763421,11408,0.528981917371146,11053,-0.0526483466077249,355
"14384","4431134",0.434859240062881,13154,0.486571542249336,13071,-0.0517123021864545,83
"14385","1141134",0.654511133485053,3011,0.696736091331775,2513,-0.0422249578467223,498
"14386","2141134",0.591287960976864,5619,0.640361606690952,4897,-0.0490736457140879,722
"14387","3141134",0.54817375216336,7781,0.611567773491172,6416,-0.0633940213278119,1365
"14388","4141134",0.50669942146282,9918,0.569157398369362,8823,-0.0624579769065415,1095
"14389","1241134",0.600553355892056,5203,0.641431812386069,4850,-0.0408784564940122,353
"14390","2241134",0.537330183383868,8354,0.585057327745245,7883,-0.0477271443613778,471
"14391","3241134",0.494215974570364,10535,0.556263494545466,9558,-0.0620475199751018,977
"14392","4241134",0.452741643869824,12434,0.513853119423656,11839,-0.0611114755538315,595
"14393","1341134",0.57257388561528,6558,0.614381245052771,6243,-0.0418073594374905,315
"14394","2341134",0.509350713107091,9780,0.558006760411947,9445,-0.0486560473048561,335
"14395","3341134",0.466236504293588,11849,0.529212927212168,11041,-0.0629764229185801,808
"14396","4341134",0.424762173593048,13520,0.486802552090358,13060,-0.0620403784973096,460
"14397","1441134",0.533637387630284,8531,0.573751741084665,8557,-0.0401143534543806,-26
"14398","2441134",0.470414215122095,11673,0.517377256443842,11645,-0.0469630413217463,28
"14399","3441134",0.427300006308592,13420,0.488583423244062,12994,-0.0612834169354703,426
"14400","4441134",0.385825675608052,14683,0.446173048122252,14537,-0.0603473725141999,146
"14401","1112134",0.781771579209713,434,0.797850008035642,433,-0.0160784288259297,1
"14402","2112134",0.718548406701524,1297,0.741475523394819,1279,-0.0229271166932953,18
"14403","3112134",0.67543419788802,2355,0.71268169019504,1989,-0.0372474923070193,366
"14404","4112134",0.63395986718748,3778,0.670271315073229,3501,-0.0363114478857489,277
"14405","1212134",0.727813801616717,1119,0.742545729089936,1259,-0.0147319274732196,-140
"14406","2212134",0.664590629108528,2673,0.686171244449113,2884,-0.0215806153405852,-211
"14407","3212134",0.621476420295024,4274,0.657377411249333,4087,-0.0359009909543092,187
"14408","4212134",0.580002089594484,6204,0.614967036127523,6214,-0.0349649465330388,-10
"14409","1312134",0.69983433133994,1697,0.715495161756638,1917,-0.0156608304166979,-220
"14410","2312134",0.636611158831752,3690,0.659120677115815,4002,-0.0225095182840634,-312
"14411","3312134",0.593496950018248,5533,0.630326843916036,5391,-0.0368298938977875,142
"14412","4312134",0.552022619317708,7597,0.587916468794225,7713,-0.0358938494765171,-116
"14413","1412134",0.660897833354944,2788,0.674865657788532,3323,-0.013967824433588,-535
"14414","2412134",0.597674660846756,5339,0.618491173147709,6018,-0.0208165123009537,-679
"14415","3412134",0.554560452033252,7471,0.58969733994793,7622,-0.0351368879146777,-151
"14416","4412134",0.513086121332712,9621,0.54728696482612,10042,-0.0342008434934074,-421
"14417","1122134",0.713792308343293,1389,0.737280696378236,1367,-0.0234883880349429,22
"14418","2122134",0.650569135835104,3164,0.680906211737412,3097,-0.0303370759023085,67
"14419","3122134",0.6074549270216,4914,0.652112378537633,4316,-0.0446574515160325,598
"14420","4122134",0.56598059632106,6889,0.609702003415823,6512,-0.0437214070947621,377
"14421","1222134",0.659834530750297,2815,0.68197641743253,3053,-0.0221418866822328,-238
"14422","2222134",0.596611358242108,5385,0.625601932791706,5634,-0.0289905745495984,-249
"14423","3222134",0.553497149428604,7519,0.596808099591927,7248,-0.0433109501633224,271
"14424","4222134",0.512022818728064,9672,0.554397724470116,9659,-0.042374905742052,13
"14425","1322134",0.63185506047352,3850,0.654925850099232,4193,-0.0230707896257111,-343
"14426","2322134",0.568631887965332,6755,0.598551365458408,7139,-0.0299194774930767,-384
"14427","3322134",0.525517679151828,8978,0.569757532258629,8787,-0.0442398531068007,191
"14428","4322134",0.484043348451288,11050,0.527347157136818,11127,-0.0433038086855303,-77
"14429","1422134",0.592918562488524,5552,0.614296346131126,6250,-0.0213777836426012,-698
"14430","2422134",0.529695389980336,8746,0.557921861490303,9448,-0.0282264715099669,-702
"14431","3422134",0.486581181166832,10928,0.529128028290523,11047,-0.0425468471236909,-119
"14432","4422134",0.445106850466292,12756,0.486717653168713,13064,-0.0416108027024205,-308
"14433","1132134",0.670459786178193,2491,0.698815603930207,2448,-0.0283558177520137,43
"14434","2132134",0.607236613670004,4920,0.642441119289384,4790,-0.0352045056193793,130
"14435","3132134",0.564122404856501,6964,0.613647286089604,6288,-0.0495248812331033,676
"14436","4132134",0.522648074155961,9112,0.571236910967794,8713,-0.0485888368118329,399
"14437","1232134",0.616502008585197,4479,0.643511324984501,4735,-0.0270093163993036,-256
"14438","2232134",0.553278836077008,7529,0.587136840343677,7767,-0.0338580042666692,-238
"14439","3232134",0.510164627263505,9753,0.558343007143898,9430,-0.0481783798803932,323
"14440","4232134",0.468690296562965,11749,0.515932632022088,11722,-0.0472423354591228,27
"14441","1332134",0.588522538308421,5755,0.616460757651203,6143,-0.0279382193427818,-388
"14442","2332134",0.525299365800232,8987,0.560086273010379,9326,-0.0347869072101474,-339
"14443","3332134",0.482185156986728,11132,0.5312924398106,10925,-0.0491072828238714,207
"14444","4332134",0.440710826286189,12919,0.48888206468879,12984,-0.048171238402601,-65
"14445","1432134",0.549586040323425,7717,0.575831253683097,8437,-0.026245213359672,-720
"14446","2432134",0.486362867815236,10936,0.519456769042274,11531,-0.0330939012270377,-595
"14447","3432134",0.443248659001732,12819,0.490662935842494,12904,-0.0474142768407617,-85
"14448","4432134",0.401774328301193,14258,0.448252560720684,14469,-0.0464782324194913,-211
"14449","1142134",0.621426221723364,4276,0.658417109803123,4033,-0.0369908880797591,243
"14450","2142134",0.558203049215175,7269,0.6020426251623,6930,-0.0438395759471247,339
"14451","3142134",0.515088840401671,9514,0.57324879196252,8585,-0.0581599515608487,929
"14452","4142134",0.473614509701131,11540,0.53083841684071,10950,-0.0572239071395784,590
"14453","1242134",0.567468444130367,6823,0.603112830857417,6874,-0.0356443867270491,-51
"14454","2242134",0.504245271622179,10049,0.546738346216593,10068,-0.0424930745944146,-19
"14455","3242134",0.461131062808675,12092,0.517944513016814,11616,-0.0568134502081387,476
"14456","4242134",0.419656732108135,13709,0.475534137895003,13526,-0.0558774057868682,183
"14457","1342134",0.539488973853591,8255,0.576062263524119,8422,-0.0365732896705273,-167
"14458","2342134",0.476265801345402,11409,0.519687778883295,11515,-0.0434219775378929,-106
"14459","3342134",0.433151592531899,13227,0.490893945683516,12894,-0.0577423531516169,333
"14460","4342134",0.391677261831359,14552,0.448483570561705,14463,-0.0568063087303465,89
"14461","1442134",0.500552475868595,10233,0.535432759556013,10715,-0.0348802836874175,-482
"14462","2442134",0.437329303360406,13044,0.47905827491519,13372,-0.0417289715547831,-328
"14463","3442134",0.394215094546903,14472,0.45026444171541,14411,-0.0560493471685071,61
"14464","4442134",0.352740763846363,15395,0.4078540665936,15446,-0.0551133027472367,-51
"14465","1113134",0.742888403637227,881,0.772353417646403,735,-0.0294650140091763,146
"14466","2113134",0.679665231129038,2235,0.71597893300558,1909,-0.0363137018765419,326
"14467","3113134",0.636551022315535,3694,0.687185099805801,2847,-0.0506340774902659,847
"14468","4113134",0.595076691614995,5467,0.64477472468399,4665,-0.0496980330689955,802
"14469","1213134",0.688930626044231,1966,0.717049138700697,1887,-0.0281185126564661,79
"14470","2213134",0.625707453536042,4084,0.660674654059874,3945,-0.0349672005238317,139
"14471","3213134",0.582593244722539,6057,0.631880820860094,5326,-0.0492875761375557,731
"14472","4213134",0.541118914021999,8168,0.589470445738284,7638,-0.0483515317162855,530
"14473","1313134",0.660951155767455,2785,0.689998571367399,2741,-0.0290474155999444,44
"14474","2313134",0.597727983259266,5333,0.633624086726576,5239,-0.03589610346731,94
"14475","3313134",0.554613774445763,7465,0.604830253526797,6783,-0.050216479081034,682
"14476","4313134",0.513139443745222,9616,0.562419878404986,9200,-0.0492804346597637,416
"14477","1413134",0.622014657782459,4260,0.649369067399293,4441,-0.0273544096168346,-181
"14478","2413134",0.55879148527427,7232,0.59299458275847,7452,-0.0342030974842003,-220
"14479","3413134",0.515677276460767,9485,0.564200749558691,9092,-0.0485234730979243,393
"14480","4413134",0.474202945760226,11515,0.52179037443688,11409,-0.047587428676654,106
"14481","1123134",0.674909132770807,2364,0.711784105988997,2019,-0.0368749732181896,345
"14482","2123134",0.611685960262618,4713,0.655409621348173,4169,-0.0437236610855551,544
"14483","3123134",0.568571751449115,6760,0.626615788148394,5588,-0.0580440366992792,1172
"14484","4123134",0.527097420748575,8898,0.584205413026584,7939,-0.0571079922780087,959
"14485","1223134",0.620951355177811,4290,0.65647982704329,4129,-0.0355284718654794,161
"14486","2223134",0.557728182669622,7286,0.600105342402467,7052,-0.042377159732845,234
"14487","3223134",0.514613973856119,9526,0.571311509202688,8707,-0.056697535346569,819
"14488","4223134",0.473139643155579,11560,0.528901134080877,11058,-0.0557614909252987,502
"14489","1323134",0.592971884901035,5551,0.629429259709993,5436,-0.0364573748089576,115
"14490","2323134",0.529748712392846,8743,0.573054775069169,8593,-0.0433060626763232,150
"14491","3323134",0.486634503579343,10923,0.54426094186939,10222,-0.0576264382900472,701
"14492","4323134",0.445160172878802,12752,0.501850566747579,12405,-0.056690393868777,347
"14493","1423134",0.554035386916039,7500,0.588799755741887,7669,-0.0347643688258478,-169
"14494","2423134",0.49081221440785,10695,0.532425271101064,10872,-0.0416130566932135,-177
"14495","3423134",0.447698005594347,12649,0.503631437901284,12315,-0.0559334323069375,334
"14496","4423134",0.406223674893807,14126,0.461221062779474,14043,-0.0549973878856672,83
"14497","1133134",0.631576610605708,3857,0.673319013540968,3380,-0.0417424029352602,477
"14498","2133134",0.568353438097519,6777,0.616944528900145,6107,-0.0485910908026258,670
"14499","3133134",0.525239229284015,8991,0.588150695700365,7702,-0.0629114664163498,1289
"14500","4133134",0.483764898583475,11064,0.545740320578555,10128,-0.0619754219950795,936
"14501","1233134",0.577618833012711,6312,0.618014734595262,6045,-0.0403959015825502,267
"14502","2233134",0.514395660504522,9540,0.561640249954438,9233,-0.0472445894499158,307
"14503","3233134",0.471281451691019,11639,0.532846416754659,10858,-0.0615649650636398,781
"14504","4233134",0.429807120990479,13349,0.490436041632848,12912,-0.0606289206423693,437
"14505","1333134",0.549639362735935,7715,0.590964167261964,7548,-0.0413248045260285,167
"14506","2333134",0.486416190227746,10932,0.53458968262114,10759,-0.0481734923933941,173
"14507","3333134",0.443301981414243,12816,0.505795849421361,12213,-0.0624938680071181,603
"14508","4333134",0.401827650713703,14256,0.46338547429955,13965,-0.0615578235858475,291
"14509","1433134",0.510702864750939,9735,0.550334663293858,9876,-0.0396317985429187,-141
"14510","2433134",0.44747969224275,12656,0.493960178653035,12757,-0.0464804864102843,-101
"14511","3433134",0.404365483429247,14180,0.465166345453255,13916,-0.0608008620240083,264
"14512","4433134",0.362891152728707,15208,0.422755970331445,15133,-0.0598648176027378,75
"14513","1143134",0.582543046150878,6061,0.632920519413884,5268,-0.0503774732630058,793
"14514","2143134",0.519319873642689,9265,0.57654603477306,8397,-0.0572261611303714,868
"14515","3143134",0.476205664829186,11413,0.547752201573281,10021,-0.0715465367440954,1392
"14516","4143134",0.434731334128646,13157,0.505341826451471,12232,-0.0706104923228249,925
"14517","1243134",0.528585268557882,8808,0.577616240468177,8341,-0.0490309719102956,467
"14518","2243134",0.465362096049693,11883,0.521241755827354,11433,-0.0558796597776612,450
"14519","3243134",0.42224788723619,13604,0.492447922627575,12830,-0.0702000353913851,774
"14520","4243134",0.38077355653565,14817,0.450037547505764,14418,-0.0692639909701149,399
"14521","1343134",0.500605798281106,10231,0.55056567313488,9864,-0.0499598748537738,367
"14522","2343134",0.437382625772917,13040,0.494191188494056,12751,-0.0568085627211394,289
"14523","3343134",0.394268416959413,14469,0.465397355294277,13911,-0.0711289383348634,558
"14524","4343134",0.352794086258873,15394,0.422986980172466,15129,-0.0701928939135931,265
"14525","1443134",0.46166930029611,12061,0.509936169166774,12029,-0.048266868870664,32
"14526","2443134",0.398446127787921,14336,0.45356168452595,14299,-0.0551155567380296,37
"14527","3443134",0.355331918974417,15345,0.424767851326171,15090,-0.0694359323517537,255
"14528","4443134",0.313857588273877,15915,0.382357476204361,15830,-0.0684998879304833,85
"14529","1114134",0.690681331666657,1937,0.727702804272748,1594,-0.0370214726060902,343
"14530","2114134",0.627458159158468,4021,0.671328319631924,3460,-0.0438701604734558,561
"14531","3114134",0.584343950344965,5988,0.642534486432145,4786,-0.0581905360871798,1202
"14532","4114134",0.542869619644425,8076,0.600124111310334,7050,-0.0572544916659095,1026
"14533","1214134",0.636723554073661,3685,0.672398525327041,3426,-0.0356749712533801,259
"14534","2214134",0.573500381565472,6507,0.616024040686218,6167,-0.0425236591207457,340
"14535","3214134",0.530386172751969,8713,0.587230207486439,7760,-0.0568440347344698,953
"14536","4214134",0.488911842051429,10803,0.544819832364628,10185,-0.0559079903131994,618
"14537","1314134",0.608744083796885,4860,0.645347957993743,4633,-0.0366038741968584,227
"14538","2314134",0.545520911288696,7932,0.58897347335292,7659,-0.043452562064224,273
"14539","3314134",0.502406702475193,10142,0.560179640153141,9319,-0.057772937677948,823
"14540","4314134",0.460932371774653,12100,0.51776926503133,11627,-0.0568368932566776,473
"14541","1414134",0.569807585811889,6702,0.604718454025638,6790,-0.0349108682137486,-88
"14542","2414134",0.5065844133037,9923,0.548343969384814,9988,-0.0417595560811143,-65
"14543","3414134",0.463470204490197,11978,0.519550136185035,11526,-0.0560799316948383,452
"14544","4414134",0.421995873789657,13614,0.477139761063225,13465,-0.0551438872735678,149
"14545","1124134",0.622702060800237,4228,0.667133492615341,3644,-0.0444314318151035,584
"14546","2124134",0.559478888292049,7194,0.610759007974518,6447,-0.051280119682469,747
"14547","3124134",0.516364679478545,9447,0.581965174774738,8085,-0.065600495296193,1362
"14548","4124134",0.474890348778005,11479,0.539554799652928,10495,-0.0646644508749227,984
"14549","1224134",0.568744283207241,6748,0.611829213669635,6407,-0.0430849304623934,341
"14550","2224134",0.505521110699052,9974,0.555454729028811,9606,-0.049933618329759,368
"14551","3224134",0.462406901885549,12024,0.526660895829032,11161,-0.064253993943483,863
"14552","4224134",0.420932571185009,13651,0.484250520707221,13171,-0.0633179495222125,480
"14553","1324134",0.540764812930465,8191,0.584778646336337,7903,-0.0440138334058716,288
"14554","2324134",0.477541640422276,11342,0.528404161695513,11083,-0.0508625212732372,259
"14555","3324134",0.434427431608773,13170,0.499610328495734,12517,-0.0651828968869612,653
"14556","4324134",0.392953100908233,14506,0.457199953373924,14171,-0.0642468524656908,335
"14557","1424134",0.501828314945469,10175,0.544149142368231,10230,-0.0423208274227618,-55
"14558","2424134",0.43860514243728,12988,0.487774657727408,13028,-0.0491695152901274,-40
"14559","3424134",0.395490933623777,14427,0.458980824527628,14121,-0.0634898909038514,306
"14560","4424134",0.354016602923237,15361,0.416570449405818,15268,-0.062553846482581,93
"14561","1134134",0.579369538635138,6236,0.628668400167312,5469,-0.0492988615321742,767
"14562","2134134",0.516146366126949,9458,0.572293915526489,8635,-0.0561475493995398,823
"14563","3134134",0.473032157313445,11564,0.543500082326709,10262,-0.0704679250132638,1302
"14564","4134134",0.431557826612905,13286,0.501089707204899,12440,-0.0695318805919934,846
"14565","1234134",0.525411761042142,8985,0.573364121221606,8581,-0.0479523601794641,404
"14566","2234134",0.462188588533953,12040,0.516989636580782,11665,-0.0548010480468297,375
"14567","3234134",0.419074379720449,13723,0.488195803381003,13011,-0.0691214236605537,712
"14568","4234134",0.377600049019909,14892,0.445785428259193,14549,-0.0681853792392833,343
"14569","1334134",0.497432290765365,10394,0.546313553888308,10093,-0.0488812631229424,301
"14570","2334134",0.434209118257177,13178,0.489939069247484,12938,-0.0557299509903079,240
"14571","3334134",0.391094909443673,14560,0.461145236047705,14046,-0.0700503266040319,514
"14572","4334134",0.349620578743133,15443,0.418734860925895,15223,-0.0691142821827616,220
"14573","1434134",0.458495792780369,12214,0.505684049920202,12216,-0.0471882571398325,-2
"14574","2434134",0.395272620272181,14439,0.449309565279379,14440,-0.0540369450071982,-1
"14575","3434134",0.352158411458677,15402,0.420515732079599,15190,-0.0683573206209222,212
"14576","4434134",0.310684080758137,15949,0.378105356957789,15886,-0.0674212761996518,63
"14577","1144134",0.530335974180308,8716,0.588269906040228,7697,-0.0579339318599197,1019
"14578","2144134",0.467112801672119,11808,0.531895421399405,10897,-0.0647826197272853,911
"14579","3144134",0.423998592858616,13546,0.503101588199625,12342,-0.0791029953410093,1204
"14580","4144134",0.382524262158076,14772,0.460691213077815,14059,-0.0781669509197389,713
"14581","1244134",0.476378196587312,11406,0.532965627094522,10850,-0.0565874305072096,556
"14582","2244134",0.413155024079123,13896,0.476591142453698,13488,-0.0634361183745751,408
"14583","3244134",0.37004081526562,15049,0.447797309253919,14490,-0.0777564939882991,559
"14584","4244134",0.32856648456508,15748,0.405386934132109,15497,-0.0768204495670288,251
"14585","1344134",0.448398726310536,12623,0.505915059761224,12207,-0.0575163334506879,416
"14586","2344134",0.385175553802347,14702,0.4495405751204,14435,-0.0643650213180534,267
"14587","3344134",0.342061344988844,15560,0.420746741920621,15184,-0.0786853969317774,376
"14588","4344134",0.300587014288304,16035,0.378336366798811,15883,-0.077749352510507,152
"14589","1444134",0.40946222832554,14017,0.465285555793118,13914,-0.055823327467578,103
"14590","2444134",0.346239055817351,15487,0.408911071152295,15427,-0.0626720153349437,60
"14591","3444134",0.303124847003848,16011,0.380117237952515,15865,-0.0769923909486677,146
"14592","4444134",0.261650516303308,16247,0.337706862830705,16209,-0.0760563465273973,38
"14593","1111234",0.769007656823191,564,0.790834142909513,505,-0.0218264860863211,59
"14594","2111234",0.705784484315003,1570,0.734459658268689,1428,-0.0286751739536867,142
"14595","3111234",0.662670275501499,2740,0.70566582506891,2227,-0.0429955495674107,513
"14596","4111234",0.621195944800959,4283,0.6632554499471,3828,-0.0420595051461403,455
"14597","1211234",0.715049879230195,1365,0.735529863963806,1409,-0.020479984733611,-44
"14598","2211234",0.651826706722006,3123,0.679155379322983,3168,-0.0273286726009766,-45
"14599","3211234",0.608712497908503,4863,0.650361546123204,4405,-0.0416490482147006,458
"14600","4211234",0.567238167207963,6835,0.607951171001393,6610,-0.0407130037934302,225
"14601","1311234",0.687070408953419,2022,0.708479296630508,2131,-0.0214088876770893,-109
"14602","2311234",0.62384723644523,4183,0.652104811989685,4318,-0.0282575755444548,-135
"14603","3311234",0.580733027631727,6162,0.623310978789906,5764,-0.0425779511581789,398
"14604","4311234",0.539258696931187,8262,0.580900603668095,8139,-0.0416419067369085,123
"14605","1411234",0.648133910968423,3264,0.667849792662403,3618,-0.0197158816939794,-354
"14606","2411234",0.584910738460234,5954,0.61147530802158,6420,-0.0265645695613451,-466
"14607","3411234",0.541796529646731,8132,0.5826814748218,8041,-0.0408849451750691,91
"14608","4411234",0.500322198946191,10248,0.54027109969999,10461,-0.0399489007537988,-213
"14609","1121234",0.701028385956772,1674,0.730264831252106,1521,-0.0292364452953343,153
"14610","2121234",0.637805213448583,3642,0.673890346611283,3351,-0.0360851331626999,291
"14611","3121234",0.594691004635079,5483,0.645096513411503,4647,-0.0504055087764239,836
"14612","4121234",0.553216673934539,7532,0.602686138289693,6892,-0.0494694643551535,640
"14613","1221234",0.647070608363775,3299,0.6749605523064,3318,-0.0278899439426242,-19
"14614","2221234",0.583847435855587,6005,0.618586067665576,6012,-0.0347386318099898,-7
"14615","3221234",0.540733227042083,8194,0.589792234465797,7614,-0.0490590074237138,580
"14616","4221234",0.499258896341543,10303,0.547381859343987,10037,-0.0481229630024435,266
"14617","1321234",0.619091138086999,4384,0.647909984973102,4507,-0.0288188468861025,-123
"14618","2321234",0.55586796557881,7404,0.591535500332278,7526,-0.0356675347534681,-122
"14619","3321234",0.512753756765307,9641,0.562741667132499,9178,-0.0499879103671921,463
"14620","4321234",0.471279426064767,11640,0.520331292010689,11478,-0.0490518659459217,162
"14621","1421234",0.580154640102003,6200,0.607280481004996,6637,-0.0271258409029926,-437
"14622","2421234",0.516931467593814,9413,0.550905996364173,9850,-0.0339745287703583,-437
"14623","3421234",0.473817258780311,11536,0.522112163164393,11396,-0.0482949043840823,140
"14624","4421234",0.432342928079771,13252,0.479701788042583,13345,-0.0473588599628119,-93
"14625","1131234",0.657695863791672,2897,0.691799738804077,2679,-0.0341038750124051,218
"14626","2131234",0.594472691283483,5495,0.635425254163254,5154,-0.0409525628797707,341
"14627","3131234",0.55135848246998,7632,0.606631420963474,6667,-0.0552729384934947,965
"14628","4131234",0.50988415176944,9762,0.564221045841664,9091,-0.0543368940722243,671
"14629","1231234",0.603738086198676,5056,0.636495459858371,5099,-0.032757373659695,-43
"14630","2231234",0.540514913690487,8209,0.580120975217547,8187,-0.0396060615270606,22
"14631","3231234",0.497400704876983,10396,0.551327142017768,9827,-0.0539264371407846,569
"14632","4231234",0.455926374176443,12312,0.508916766895958,12068,-0.0529903927195142,244
"14633","1331234",0.5757586159219,6392,0.609444892525073,6525,-0.0336862766031732,-133
"14634","2331234",0.512535443413711,9645,0.55307040788425,9742,-0.0405349644705388,-97
"14635","3331234",0.469421234600207,11722,0.52427657468447,11285,-0.0548553400842628,437
"14636","4331234",0.427946903899667,13403,0.48186619956266,13258,-0.0539192956629924,145
"14637","1431234",0.536822117936904,8377,0.568815388556967,8842,-0.0319932706200634,-465
"14638","2431234",0.473598945428715,11541,0.512440903916144,11909,-0.0388419584874291,-368
"14639","3431234",0.430484736615211,13323,0.483647070716364,13197,-0.0531623341011531,126
"14640","4431234",0.389010405914671,14609,0.441236695594554,14680,-0.0522262896798827,-71
"14641","1141234",0.608662299336842,4867,0.651401244676993,4345,-0.0427389453401505,522
"14642","2141234",0.545439126828653,7939,0.59502676003617,7342,-0.0495876332075161,597
"14643","3141234",0.50232491801515,10147,0.56623292683639,8979,-0.0639080088212401,1168
"14644","4141234",0.46085058731461,12103,0.52382255171458,11307,-0.0629719643999698,796
"14645","1241234",0.554704521743846,7458,0.596096965731287,7284,-0.0413924439874405,174
"14646","2241234",0.491481349235657,10664,0.539722481090463,10487,-0.048241131854806,177
"14647","3241234",0.448367140422154,12624,0.510928647890684,11989,-0.0625615074685301,635
"14648","4241234",0.406892809721614,14103,0.468518272768874,13808,-0.0616254630472596,295
"14649","1341234",0.52672505146707,8920,0.569046398397989,8829,-0.0423213469309187,91
"14650","2341234",0.463501878958881,11975,0.512671913757165,11894,-0.0491700347982843,81
"14651","3341234",0.420387670145378,13678,0.483878080557386,13186,-0.0634904104120083,492
"14652","4341234",0.378913339444838,14859,0.441467705435576,14671,-0.0625543659907379,188
"14653","1441234",0.487788553482074,10867,0.528416894429883,11080,-0.0406283409478089,-213
"14654","2441234",0.424565380973885,13525,0.47204240978906,13689,-0.0474770288151745,-164
"14655","3441234",0.381451172160382,14797,0.44324857658928,14630,-0.0617974044288985,167
"14656","4441234",0.339976841459842,15596,0.40083820146747,15580,-0.0608613600076282,16
"14657","1112234",0.735922745061503,994,0.75251516138086,1051,-0.0165924163193579,-57
"14658","2112234",0.672699572553314,2420,0.696140676740037,2531,-0.0234411041867235,-111
"14659","3112234",0.62958536373981,3929,0.667346843540258,3633,-0.0377614798004475,296
"14660","4112234",0.58811103303927,5774,0.624936468418447,5671,-0.0368254353791772,103
"14661","1212234",0.681964967468506,2167,0.697210882435154,2499,-0.0152459149666478,-332
"14662","2212234",0.618741794960318,4389,0.640836397794331,4877,-0.0220946028340134,-488
"14663","3212234",0.575627586146814,6393,0.612042564594552,6389,-0.0364149784477374,4
"14664","4212234",0.534153255446274,8505,0.569632189472741,8794,-0.0354789340264671,-289
"14665","1312234",0.65398549719173,3035,0.670160315101856,3503,-0.0161748179101261,-468
"14666","2312234",0.590762324683541,5642,0.613785830461033,6282,-0.0230235057774917,-640
"14667","3312234",0.547648115870038,7804,0.584991997261254,7885,-0.0373438813912157,-81
"14668","4312234",0.506173785169498,9943,0.542581622139443,10313,-0.0364078369699453,-370
"14669","1412234",0.615048999206734,4555,0.62953081113375,5433,-0.0144818119270163,-878
"14670","2412234",0.551825826698545,7606,0.573156326492927,8589,-0.021330499794382,-983
"14671","3412234",0.508711617885042,9813,0.544362493293148,10218,-0.035650875408106,-405
"14672","4412234",0.467237287184502,11806,0.501952118171338,12397,-0.0347148309868356,-591
"14673","1122234",0.667943474195083,2574,0.691945849723454,2670,-0.0240023755283711,-96
"14674","2122234",0.604720301686894,5015,0.63557136508263,5140,-0.0308510633957367,-125
"14675","3122234",0.56160609287339,7082,0.606777531882851,6657,-0.0451714390094607,425
"14676","4122234",0.52013176217285,9229,0.564367156761041,9080,-0.0442353945881904,149
"14677","1222234",0.613985696602086,4614,0.636641570777748,5092,-0.0226558741756611,-478
"14678","2222234",0.550762524093898,7663,0.580267086136924,8171,-0.0295045620430266,-508
"14679","3222234",0.507648315280394,9869,0.551473252937145,9817,-0.0438249376567507,52
"14680","4222234",0.466173984579854,11853,0.509062877815334,12060,-0.0428888932354803,-207
"14681","1322234",0.58600622632531,5892,0.60959100344445,6516,-0.0235847771191393,-624
"14682","2322234",0.522783053817121,9103,0.553216518803626,9732,-0.0304334649865049,-629
"14683","3322234",0.479668845003618,11233,0.524422685603847,11276,-0.0447538406002289,-43
"14684","4322234",0.438194514303078,13010,0.482012310482036,13250,-0.0438177961789585,-240
"14685","1422234",0.547069728340314,7851,0.568961499476344,8835,-0.0218917711360295,-984
"14686","2422234",0.483846555832125,11059,0.512587014835521,11898,-0.0287404590033952,-839
"14687","3422234",0.440732347018622,12918,0.483793181635741,13188,-0.0430608346171191,-270
"14688","4422234",0.399258016318082,14318,0.441382806513931,14673,-0.0421247901958487,-355
"14689","1132234",0.624610952029983,4149,0.653480757275425,4262,-0.0288698052454419,-113
"14690","2132234",0.561387779521794,7095,0.597106272634602,7230,-0.0357184931128075,-135
"14691","3132234",0.518273570708291,9330,0.568312439434822,8871,-0.0500388687265315,459
"14692","4132234",0.476799240007751,11385,0.525902064313012,11206,-0.0491028243052611,179
"14693","1232234",0.570653174436987,6653,0.598176478329719,7170,-0.0275233038927318,-517
"14694","2232234",0.507430001928798,9877,0.541801993688895,10369,-0.0343719917600974,-492
"14695","3232234",0.464315793115294,11938,0.513008160489116,11878,-0.0486923673738214,60
"14696","4232234",0.422841462414755,13586,0.470597785367306,13739,-0.047756322952551,-153
"14697","1332234",0.542673704160211,8086,0.571125910996421,8720,-0.0284522068362101,-634
"14698","2332234",0.479450531652022,11242,0.514751426355597,11794,-0.0353008947035757,-552
"14699","3332234",0.436336322838518,13083,0.485957593155818,13098,-0.0496212703172996,-15
"14700","4332234",0.394861992137978,14454,0.443547218034008,14617,-0.0486852258960292,-163
"14701","1432234",0.503737206175215,10079,0.530496407028315,10973,-0.0267592008531002,-894
"14702","2432234",0.440514033667026,12924,0.474121922387492,13594,-0.0336078887204659,-670
"14703","3432234",0.397399824853522,14370,0.445328089187712,14563,-0.0479282643341899,-193
"14704","4432234",0.355925494152982,15331,0.402917714065902,15545,-0.0469922199129195,-214
"14705","1142234",0.575577387575153,6397,0.613082263148341,6319,-0.0375048755731874,78
"14706","2142234",0.512354215066965,9652,0.556707778507518,9528,-0.044353563440553,124
"14707","3142234",0.469240006253461,11730,0.527913945307738,11099,-0.058673939054277,631
"14708","4142234",0.427765675552921,13406,0.485503570185928,13119,-0.0577378946330065,287
"14709","1242234",0.521619609982157,9165,0.557777984202635,9456,-0.0361583742204773,-291
"14710","2242234",0.458396437473968,12216,0.501403499561811,12424,-0.0430070620878429,-208
"14711","3242234",0.415282228660465,13838,0.472609666362032,13662,-0.0573274377015668,176
"14712","4242234",0.373807897959925,14969,0.430199291240221,14971,-0.0563913932802965,-2
"14713","1342234",0.493640139705381,10565,0.530727416869337,10955,-0.0370872771639555,-390
"14714","2342234",0.430416967197192,13325,0.474352932228513,13581,-0.0439359650313211,-256
"14715","3342234",0.387302758383689,14650,0.445559099028734,14555,-0.0582563406450451,95
"14716","4342234",0.345828427683149,15495,0.403148723906924,15536,-0.0573202962237747,-41
"14717","1442234",0.454703641720385,12357,0.490097912901231,12929,-0.0353942711808456,-572
"14718","2442234",0.391480469212196,14555,0.433723428260408,14874,-0.0422429590482113,-319
"14719","3442234",0.348366260398693,15466,0.404929595060628,15506,-0.0565633346619354,-40
"14720","4442234",0.306891929698153,15981,0.362519219938818,16046,-0.055627290240665,-65
"14721","1113234",0.697039569489017,1773,0.727018570991621,1614,-0.0299790015026046,159
"14722","2113234",0.633816396980828,3781,0.670644086350798,3484,-0.0368276893699702,297
"14723","3113234",0.590702188167325,5645,0.641850253151019,4823,-0.0511480649836942,822
"14724","4113234",0.549227857466785,7735,0.599439878029208,7087,-0.0502120205624237,648
"14725","1213234",0.643081791896021,3438,0.671714292045915,3448,-0.0286325001498944,-10
"14726","2213234",0.579858619387832,6209,0.615339807405092,6196,-0.03548118801726,13
"14727","3213234",0.536744410574329,8379,0.586545974205313,7804,-0.049801563630984,575
"14728","4213234",0.495270079873788,10480,0.544135599083502,10231,-0.0488655192097137,249
"14729","1313234",0.615102321619245,4551,0.644663724712617,4669,-0.0295614030933726,-118
"14730","2313234",0.551879149111056,7602,0.588289240071794,7696,-0.0364100909607382,-94
"14731","3313234",0.508764940297552,9811,0.559495406872015,9361,-0.0507304665744622,450
"14732","4313234",0.467290609597012,11801,0.517085031750204,11661,-0.049794422153192,140
"14733","1413234",0.576165823634249,6378,0.604034220744512,6824,-0.0278683971102628,-446
"14734","2413234",0.51294265112606,9628,0.547659736103688,10026,-0.0347170849776285,-398
"14735","3413234",0.469828442312556,11699,0.518865902903909,11563,-0.0490374605913525,136
"14736","4413234",0.428354111612016,13392,0.476455527782098,13494,-0.0481014161700822,-102
"14737","1123234",0.629060298622597,3960,0.666449259334215,3671,-0.0373889607116178,289
"14738","2123234",0.565837126114408,6895,0.610074774693391,6480,-0.0442376485789834,415
"14739","3123234",0.522722917300905,9106,0.581280941493612,8117,-0.0585580241927074,989
"14740","4123234",0.481248586600365,11173,0.538870566371802,10528,-0.0576219797714369,645
"14741","1223234",0.575102521029601,6432,0.611144980388509,6431,-0.0360424593589076,1
"14742","2223234",0.511879348521412,9676,0.554770495747685,9636,-0.0428911472262732,40
"14743","3223234",0.468765139707909,11747,0.525976662547906,11203,-0.0572115228399972,544
"14744","4223234",0.427290809007368,13421,0.483566287426095,13202,-0.0562754784187269,219
"14745","1323234",0.547123050752825,7847,0.584094413055211,7943,-0.0369713623023858,-96
"14746","2323234",0.483899878244636,11058,0.527719928414387,11111,-0.0438200501697514,-53
"14747","3323234",0.440785669431132,12916,0.498926095214608,12551,-0.0581404257834754,365
"14748","4323234",0.399311338730592,14317,0.456515720092797,14194,-0.0572043813622051,123
"14749","1423234",0.508186552767829,9849,0.543464909087105,10264,-0.035278356319276,-415
"14750","2423234",0.44496338025964,12759,0.487090424446282,13047,-0.0421270441866416,-288
"14751","3423234",0.401849171446136,14255,0.458296591246502,14144,-0.0564474198003657,111
"14752","4423234",0.360374840745596,15254,0.415886216124692,15280,-0.0555113753790954,-26
"14753","1133234",0.585727776457497,5903,0.627984166886186,5505,-0.0422563904286885,398
"14754","2133234",0.522504603949309,9119,0.571609682245363,8684,-0.049105078296054,435
"14755","3133234",0.479390395135805,11246,0.542815849045583,10298,-0.063425453909778,948
"14756","4133234",0.437916064435265,13018,0.500405473923773,12474,-0.0624894094885078,544
"14757","1233234",0.531769998864501,8637,0.57267988794048,8609,-0.0409098890759785,28
"14758","2233234",0.468546826356312,11755,0.516305403299656,11701,-0.0477585769433441,54
"14759","3233234",0.425432617542809,13494,0.487511570099877,13034,-0.062078952557068,460
"14760","4233234",0.383958286842269,14732,0.445101194978066,14569,-0.0611429081357975,163
"14761","1333234",0.503790528587725,10076,0.545629320607182,10133,-0.0418387920194567,-57
"14762","2333234",0.440567356079536,12922,0.489254835966358,12965,-0.0486874798868223,-43
"14763","3333234",0.397453147266033,14368,0.460461002766579,14066,-0.0630078555005463,302
"14764","4333234",0.355978816565493,15330,0.418050627644769,15236,-0.0620718110792758,94
"14765","1433234",0.464854030602729,11917,0.504999816639076,12244,-0.0401457860363469,-327
"14766","2433234",0.40163085809454,14262,0.448625331998253,14459,-0.0469944739037125,-197
"14767","3433234",0.358516649281037,15284,0.419831498798473,15205,-0.0613148495174365,79
"14768","4433234",0.317042318580497,15873,0.377421123676663,15893,-0.060378805096166,-20
"14769","1143234",0.536694212002668,8381,0.587585672759102,7734,-0.050891460756434,647
"14770","2143234",0.473471039494479,11545,0.531211188118278,10929,-0.0577401486237996,616
"14771","3143234",0.430356830680975,13328,0.502417354918499,12372,-0.0720605242375236,956
"14772","4143234",0.388882499980436,14612,0.460006979796689,14083,-0.0711244798162531,529
"14773","1243234",0.482736434409672,11106,0.532281393813396,10877,-0.0495449594037238,229
"14774","2243234",0.419513261901483,13712,0.475906909172572,13512,-0.0563936472710894,200
"14775","3243234",0.376399053087979,14917,0.447113075972793,14513,-0.0707140228848134,404
"14776","4243234",0.334924722387439,15668,0.404702700850982,15511,-0.0697779784635431,157
"14777","1343234",0.454756964132896,12354,0.505230826480098,12236,-0.0504738623472021,118
"14778","2343234",0.391533791624707,14554,0.448856341839274,14448,-0.0573225502145676,106
"14779","3343234",0.348419582811203,15465,0.420062508639495,15198,-0.0716429258282916,267
"14780","4343234",0.306945252110663,15980,0.377652133517685,15891,-0.0707068814070214,89
"14781","1443234",0.4158204661479,13819,0.464601322511992,13931,-0.0487808563640922,-112
"14782","2443234",0.352597293639711,15397,0.408226837871169,15437,-0.0556295442314579,-40
"14783","3443234",0.309483084826207,15962,0.379433004671389,15873,-0.0699499198451819,89
"14784","4443234",0.268008754125667,16228,0.337022629549579,16212,-0.0690138754239115,16
"14785","1114234",0.644832497518447,3367,0.682367957617966,3029,-0.0375354600995185,338
"14786","2114234",0.581609325010258,6111,0.625993472977142,5615,-0.0443841479668841,496
"14787","3114234",0.538495116196755,8300,0.597199639777363,7222,-0.0587045235806081,1078
"14788","4114234",0.497020785496215,10410,0.554789264655553,9635,-0.0577684791593377,775
"14789","1214234",0.590874719925451,5635,0.627063678672259,5558,-0.0361889587468084,77
"14790","2214234",0.527651547417262,8861,0.570689194031436,8743,-0.043037646614174,118
"14791","3214234",0.484537338603759,11012,0.541895360831657,10360,-0.057358022227898,652
"14792","4214234",0.443063007903219,12826,0.499484985709846,12524,-0.0564219778066276,302
"14793","1314234",0.562895249648675,7017,0.600013111338962,7056,-0.0371178616902866,-39
"14794","2314234",0.499672077140486,10279,0.543638626698138,10258,-0.0439665495576522,21
"14795","3314234",0.456557868326983,12276,0.514844793498359,11786,-0.0582869251713762,490
"14796","4314234",0.415083537626443,13843,0.472434418376548,13672,-0.0573508807501058,171
"14797","1414234",0.523958751663679,9048,0.559383607370856,9368,-0.0354248557071768,-320
"14798","2414234",0.46073557915549,12107,0.503009122730033,12345,-0.0422735435745425,-238
"14799","3414234",0.417621370341987,13763,0.474215289530253,13586,-0.0565939191882665,177
"14800","4414234",0.376147039641447,14922,0.431804914408443,14936,-0.0556578747669961,-14
"14801","1124234",0.576853226652027,6342,0.621798645960559,5839,-0.0449454193085317,503
"14802","2124234",0.513630054143838,9585,0.565424161319736,9019,-0.0517941071758973,566
"14803","3124234",0.470515845330335,11666,0.536630328119956,10655,-0.0661144827896213,1011
"14804","4124234",0.429041514629795,13375,0.494219952998146,12750,-0.0651784383683509,625
"14805","1224234",0.522895449059031,9098,0.566494367014853,8967,-0.0435989179558216,131
"14806","2224234",0.459672276550842,12154,0.510119882374029,12024,-0.0504476058231872,130
"14807","3224234",0.416558067737339,13793,0.48132604917425,13282,-0.0647679814369111,511
"14808","4224234",0.375083737036799,14937,0.43891567405244,14739,-0.0638319370156408,198
"14809","1324234",0.494915978782255,10505,0.539443799681555,10504,-0.0445278208992999,1
"14810","2324234",0.431692806274066,13280,0.483069315040731,13216,-0.0513765087666654,64
"14811","3324234",0.388578597460563,14620,0.454275481840952,14277,-0.0656968843803894,343
"14812","4324234",0.347104266760023,15475,0.411865106719142,15366,-0.064760839959119,109
"14813","1424234",0.455979480797259,12310,0.498814295713449,12556,-0.04283481491619,-246
"14814","2424234",0.39275630828907,14512,0.442439811072626,14649,-0.0496835027835557,-137
"14815","3424234",0.349642099475567,15442,0.413645977872846,15335,-0.0640038783972797,107
"14816","4424234",0.308167768775027,15971,0.371235602751036,15963,-0.0630678339760093,8
"14817","1134234",0.533520704486928,8536,0.58333355351253,7991,-0.0498128490256025,545
"14818","2134234",0.470297531978739,11677,0.526959068871707,11146,-0.056661536892968,531
"14819","3134234",0.427183323165235,13428,0.498165235671927,12575,-0.070981912506692,853
"14820","4134234",0.385708992464695,14685,0.455754860550117,14223,-0.0700458680854216,462
"14821","1234234",0.479562926893931,11235,0.528029274566824,11096,-0.0484663476728924,139
"14822","2234234",0.416339754385743,13801,0.471654789926,13699,-0.0553150355402579,102
"14823","3234234",0.373225545572239,14979,0.442860956726221,14638,-0.0696354111539819,341
"14824","4234234",0.331751214871699,15704,0.400450581604411,15584,-0.0686993667327115,120
"14825","1334234",0.451583456617155,12475,0.500978707233526,12442,-0.0493952506163706,33
"14826","2334234",0.388360284108966,14624,0.444604222592703,14582,-0.0562439384837362,42
"14827","3334234",0.345246075295463,15506,0.415810389392923,15282,-0.0705643140974602,224
"14828","4334234",0.303771744594923,16005,0.373400014271113,15939,-0.0696282696761898,66
"14829","1434234",0.412646958632159,13919,0.46034920326542,14068,-0.0477022446332607,-149
"14830","2434234",0.34942378612397,15445,0.403974718624597,15520,-0.0545509325006264,-75
"14831","3434234",0.306309577310467,15986,0.375180885424817,15922,-0.0688713081143504,64
"14832","4434234",0.264835246609927,16236,0.332770510303007,16233,-0.0679352636930801,3
"14833","1144234",0.484487140032098,11014,0.542935059385446,10289,-0.0584479193533479,725
"14834","2144234",0.421263967523909,13639,0.486560574744623,13073,-0.0652966072207135,566
"14835","3144234",0.378149758710406,14882,0.457766741544843,14156,-0.0796169828344375,726
"14836","4144234",0.336675428009866,15645,0.415356366423033,15295,-0.0786809384131671,350
"14837","1244234",0.430529362439102,13319,0.48763078043974,13029,-0.0571014180006378,290
"14838","2244234",0.367306189930913,15115,0.431256295798916,14954,-0.0639501058680034,161
"14839","3244234",0.32419198111741,15798,0.402462462599137,15557,-0.0782704814817274,241
"14840","4244234",0.28271765041687,16149,0.360052087477327,16063,-0.077334437060457,86
"14841","1344234",0.402549892162326,14232,0.460580213106442,14061,-0.058030320944116,171
"14842","2344234",0.339326719654137,15610,0.404205728465618,15516,-0.0648790088114816,94
"14843","3344234",0.296212510840633,16065,0.375411895265839,15918,-0.0791993844252056,147
"14844","4344234",0.254738180140093,16270,0.333001520144029,16231,-0.0782633400039353,39
"14845","1444234",0.36361339417733,15192,0.419950709138336,15200,-0.0563373149610062,-8
"14846","2444234",0.300390221669141,16036,0.363576224497513,16033,-0.0631860028283719,3
"14847","3444234",0.257276012855637,16266,0.334782391297733,16224,-0.0775063784420959,42
"14848","4444234",0.215801682155097,16353,0.292372016175923,16344,-0.0765703340208255,9
"14849","1111334",0.746553677817884,834,0.772784152981838,729,-0.0262304751639545,105
"14850","2111334",0.683330505309695,2127,0.716409668341015,1900,-0.0330791630313201,227
"14851","3111334",0.640216296496191,3558,0.687615835141235,2827,-0.0473995386450441,731
"14852","4111334",0.598741965795651,5288,0.645205460019425,4643,-0.0464634942237738,645
"14853","1211334",0.692595900224887,1889,0.717479874036132,1873,-0.0248839738112445,16
"14854","2211334",0.629372727716698,3943,0.661105389395308,3928,-0.0317326616786101,15
"14855","3211334",0.586258518903195,5870,0.632311556195529,5300,-0.0460530372923341,570
"14856","4211334",0.544784188202655,7976,0.589901181073719,7607,-0.0451169928710636,369
"14857","1311334",0.664616429948111,2670,0.690429306702834,2733,-0.0258128767547228,-63
"14858","2311334",0.601393257439922,5166,0.634054822062011,5228,-0.0326615646220884,-62
"14859","3311334",0.558279048626419,7264,0.605260988862231,6758,-0.0469819402358124,506
"14860","4311334",0.516804717925879,9420,0.562850613740421,9174,-0.0460458958145419,246
"14861","1411334",0.625679931963115,4087,0.649799802734728,4425,-0.0241198707716129,-338
"14862","2411334",0.562456759454926,7038,0.593425318093905,7436,-0.0309685586389786,-398
"14863","3411334",0.519342550641423,9260,0.564631484894125,9062,-0.0452889342527026,198
"14864","4411334",0.477868219940883,11328,0.522221109772315,11389,-0.0443528898314322,-61
"14865","1121334",0.678574406951464,2269,0.712214841324431,2001,-0.0336404343729677,268
"14866","2121334",0.615351234443275,4536,0.655840356683608,4154,-0.0404891222403333,382
"14867","3121334",0.572237025629771,6576,0.627046523483828,5561,-0.0548094978540573,1015
"14868","4121334",0.530762694929231,8696,0.584636148362018,7911,-0.053873453432787,785
"14869","1221334",0.624616629358467,4147,0.656910562378725,4105,-0.0322939330202577,42
"14870","2221334",0.561393456850278,7093,0.600536077737902,7032,-0.0391426208876233,61
"14871","3221334",0.518279248036775,9328,0.571742244538122,8673,-0.0534629965013473,655
"14872","4221334",0.476804917336235,11384,0.529331869416312,11035,-0.0525269520800768,349
"14873","1321334",0.596637159081691,5383,0.629859995045427,5418,-0.033222835963736,-35
"14874","2321334",0.533413986573502,8544,0.573485510404604,8576,-0.0400715238311016,-32
"14875","3321334",0.490299777759999,10727,0.544691677204824,10195,-0.0543918994448256,532
"14876","4321334",0.448825447059459,12602,0.502281302083014,12381,-0.0534558550235551,221
"14877","1421334",0.557700661096695,7289,0.589230491077321,7647,-0.0315298299806261,-358
"14878","2421334",0.494477488588506,10519,0.532856006436498,10857,-0.0383785178479918,-338
"14879","3421334",0.451363279775003,12485,0.504062173236719,12297,-0.0526988934617159,188
"14880","4421334",0.409888949074463,14002,0.461651798114908,14027,-0.0517628490404453,-25
"14881","1131334",0.635241884786364,3735,0.673749748876402,3360,-0.0385078640900386,375
"14882","2131334",0.572018712278175,6588,0.617375264235579,6082,-0.0453565519574042,506
"14883","3131334",0.528904503464671,8795,0.5885814310358,7685,-0.0596769275711282,1110
"14884","4131334",0.487430172764132,10888,0.546171055913989,10104,-0.0587408831498577,784
"14885","1231334",0.581284107193368,6132,0.618445469930696,6022,-0.0371613627373284,110
"14886","2231334",0.518060934685179,9348,0.562070985289873,9211,-0.044010050604694,137
"14887","3231334",0.474946725871675,11475,0.533277152090093,10830,-0.058330426218418,645
"14888","4231334",0.433472395171135,13214,0.490866776968283,12895,-0.0573943817971477,319
"14889","1331334",0.553304636916592,7526,0.591394902597398,7530,-0.0380902656808066,-4
"14890","2331334",0.490081464408403,10740,0.535020417956575,10734,-0.0449389535481722,6
"14891","3331334",0.446967255594899,12683,0.506226584756795,12197,-0.0592593291618962,486
"14892","4331334",0.405492924894359,14150,0.463816209634985,13951,-0.0583232847406259,199
"14893","1431334",0.514368138931596,9544,0.550765398629292,9855,-0.0363972596976968,-311
"14894","2431334",0.451144966423407,12502,0.494390913988469,12741,-0.0432459475650624,-239
"14895","3431334",0.408030757609903,14062,0.46559708078869,13907,-0.0575663231787865,155
"14896","4431334",0.366556426909363,15137,0.423186705666879,15123,-0.0566302787575162,14
"14897","1141334",0.586208320331534,5877,0.633351254749318,5251,-0.0471429344177839,626
"14898","2141334",0.522985147823345,9092,0.576976770108495,8373,-0.0539916222851495,719
"14899","3141334",0.479870939009842,11224,0.548182936908716,10002,-0.0683119978988735,1222
"14900","4141334",0.438396608309302,12999,0.505772561786905,12214,-0.0673759534776033,785
"14901","1241334",0.532250542738538,8607,0.578046975803612,8316,-0.045796433065074,291
"14902","2241334",0.469027370230349,11738,0.521672491162789,11413,-0.0526451209324396,325
"14903","3241334",0.425913161416846,13478,0.492878657963009,12809,-0.0669654965461635,669
"14904","4241334",0.384438830716306,14721,0.450468282841199,14402,-0.066029452124893,319
"14905","1341334",0.504271072461762,10046,0.550996408470314,9846,-0.0467253360085522,200
"14906","2341334",0.441047899953573,12901,0.494621923829491,12732,-0.0535740238759178,169
"14907","3341334",0.39793369114007,14358,0.465828090629711,13898,-0.0678943994896418,460
"14908","4341334",0.35645936043953,15320,0.423417715507901,15117,-0.0669583550683713,203
"14909","1441334",0.465334574476766,11885,0.510366904502208,12014,-0.0450323300254424,-129
"14910","2441334",0.402111401968577,14245,0.453992419861385,14287,-0.051881017892808,-42
"14911","3441334",0.358997193155074,15274,0.425198586661606,15084,-0.066201393506532,190
"14912","4441334",0.317522862454534,15867,0.382788211539795,15823,-0.0652653490852615,44
"14913","1112334",0.713468766056195,1397,0.734465171453186,1427,-0.0209964053969913,-30
"14914","2112334",0.650245593548006,3184,0.678090686812363,3202,-0.0278450932643569,-18
"14915","3112334",0.607131384734502,4926,0.649296853612583,4443,-0.0421654688780809,483
"14916","4112334",0.565657054033962,6904,0.606886478490773,6656,-0.0412294244568107,248
"14917","1212334",0.659510988463198,2828,0.67916089250748,3166,-0.0196499040442814,-338
"14918","2212334",0.59628781595501,5409,0.622786407866656,5793,-0.0264985919116469,-384
"14919","3212334",0.553173607141506,7533,0.593992574666877,7404,-0.040818967525371,129
"14920","4212334",0.511699276440966,9684,0.551582199545067,9813,-0.0398829231041005,-129
"14921","1312334",0.631531518186422,3860,0.652110325174182,4317,-0.0205788069877596,-457
"14922","2312334",0.568308345678233,6784,0.595735840533358,7308,-0.0274274948551252,-524
"14923","3312334",0.52519413686473,8993,0.566942007333579,8943,-0.0417478704688492,50
"14924","4312334",0.48371980616419,11067,0.524531632211769,11273,-0.0408118260475787,-206
"14925","1412334",0.592595020201426,5564,0.611480821206076,6418,-0.0188858010046498,-854
"14926","2412334",0.529371847693237,8772,0.555106336565253,9619,-0.0257344888720155,-847
"14927","3412334",0.486257638879734,10942,0.526312503365473,11182,-0.0400548644857395,-240
"14928","4412334",0.444783308179194,12768,0.483902128243663,13184,-0.0391188200644689,-416
"14929","1122334",0.645489495189775,3346,0.673895859795779,3349,-0.0284063646060045,-3
"14930","2122334",0.582266322681586,6082,0.617521375154956,6073,-0.0352550524733701,9
"14931","3122334",0.539152113868082,8269,0.588727541955176,7670,-0.0495754280870941,599
"14932","4122334",0.497677783167542,10376,0.546317166833366,10091,-0.0486393836658239,285
"14933","1222334",0.591531717596778,5600,0.618591580850073,6011,-0.0270598632532946,-411
"14934","2222334",0.52830854508859,8825,0.56221709620925,9208,-0.0339085511206602,-383
"14935","3222334",0.485194336275086,10987,0.53342326300947,10821,-0.0482289267343842,166
"14936","4222334",0.443720005574546,12808,0.49101288788766,12890,-0.0472928823131136,-82
"14937","1322334",0.563552247320002,6982,0.591541013516775,7525,-0.0279887661967728,-543
"14938","2322334",0.500329074811813,10247,0.535166528875952,10730,-0.0348374540641384,-483
"14939","3322334",0.45721486599831,12251,0.506372695676172,12189,-0.0491578296778624,62
"14940","4322334",0.41574053529777,13823,0.463962320554362,13947,-0.0482217852565919,-124
"14941","1422334",0.524615749335006,9013,0.550911509548669,9849,-0.026295760213663,-836
"14942","2422334",0.461392576826817,12074,0.494537024907846,12736,-0.0331444480810286,-662
"14943","3422334",0.418278368013314,13742,0.465743191708066,13900,-0.0474648236947526,-158
"14944","4422334",0.376804037312774,14910,0.423332816586256,15118,-0.0465287792734821,-208
"14945","1132334",0.602156973024675,5126,0.63543076734775,5153,-0.0332737943230754,-27
"14946","2132334",0.538933800516486,8283,0.579056282706927,8256,-0.040122482190441,27
"14947","3132334",0.495819591702983,10458,0.550262449507148,9882,-0.054442857804165,576
"14948","4132334",0.454345261002443,12371,0.507852074385337,12127,-0.0535068133828945,244
"14949","1232334",0.548199195431679,7778,0.580126488402044,8186,-0.0319272929703652,-408
"14950","2232334",0.48497602292349,11000,0.523752003761221,11310,-0.0387759808377308,-310
"14951","3232334",0.441861814109986,12869,0.494958170561441,12719,-0.0530963564514548,150
"14952","4232334",0.400387483409446,14291,0.452547795439631,14330,-0.0521603120301845,-39
"14953","1332334",0.520219725154903,9226,0.553075921068746,9741,-0.0328561959138435,-515
"14954","2332334",0.456996552646714,12262,0.496701436427923,12636,-0.039704883781209,-374
"14955","3332334",0.41388234383321,13875,0.467907603228143,13823,-0.054025259394933,52
"14956","4332334",0.37240801313267,14998,0.425497228106333,15073,-0.0530892149736628,-75
"14957","1432334",0.481283227169907,11167,0.51244641710064,11908,-0.0311631899307336,-741
"14958","2432334",0.418060054661718,13751,0.456071932459817,14209,-0.0380118777980993,-458
"14959","3432334",0.374945845848214,14940,0.427278099260038,15040,-0.0523322534118233,-100
"14960","4432334",0.333471515147674,15685,0.384867724138227,15798,-0.051396208990553,-113
"14961","1142334",0.553123408569845,7537,0.595032273220666,7341,-0.0419088646508208,196
"14962","2142334",0.489900236061657,10752,0.538657788579843,10538,-0.0487575525181864,214
"14963","3142334",0.446786027248153,12691,0.509863955380063,12031,-0.0630779281319104,660
"14964","4142334",0.405311696547613,14159,0.467453580258253,13838,-0.06214188371064,321
"14965","1242334",0.499165630976849,10307,0.53972799427496,10486,-0.0405623632981108,-179
"14966","2242334",0.43594245846866,13103,0.483353509634137,13205,-0.0474110511654763,-102
"14967","3242334",0.392828249655157,14511,0.454559676434357,14266,-0.0617314267792003,245
"14968","4242334",0.351353918954617,15416,0.412149301312547,15361,-0.0607953823579299,55
"14969","1342334",0.471186160700073,11643,0.512677426941662,11893,-0.0414912662415891,-250
"14970","2342334",0.407962988191884,14068,0.456302942300839,14197,-0.0483399541089546,-129
"14971","3342334",0.364848779378381,15170,0.427509109101059,15033,-0.0626603297226786,137
"14972","4342334",0.323374448677841,15810,0.385098733979249,15791,-0.0617242853014081,19
"14973","1442334",0.432249662715077,13255,0.472047922973556,13688,-0.0397982602584792,-433
"14974","2442334",0.369026490206888,15073,0.415673438332733,15285,-0.0466469481258449,-212
"14975","3442334",0.325912281393385,15779,0.386879605132954,15770,-0.0609673237395689,9
"14976","4442334",0.284437950692845,16140,0.344469230011143,16169,-0.0600312793182984,-29
"14977","1113334",0.674585590483709,2380,0.708968581063947,2115,-0.034382990580238,265
"14978","2113334",0.61136241797552,4738,0.652594096423124,4299,-0.0412316784476036,439
"14979","3113334",0.568248209162017,6789,0.623800263223344,5737,-0.0555520540613276,1052
"14980","4113334",0.526773878461477,8915,0.581389888101534,8112,-0.0546160096400571,803
"14981","1213334",0.620627812890713,4305,0.653664302118241,4248,-0.0330364892275278,57
"14982","2213334",0.557404640382524,7313,0.597289817477417,7220,-0.0398851770948934,93
"14983","3213334",0.514290431569021,9548,0.568495984277638,8861,-0.0542055527086174,687
"14984","4213334",0.47281610086848,11572,0.526085609155828,11199,-0.0532695082873471,373
"14985","1313334",0.592648342613937,5560,0.626613734784943,5589,-0.033965392171006,-29
"14986","2313334",0.529425170105748,8764,0.57023925014412,8765,-0.0408140800383716,-1
"14987","3313334",0.486310961292244,10938,0.54144541694434,10396,-0.0551344556520956,542
"14988","4313334",0.444836630591704,12762,0.49903504182253,12550,-0.0541984112308253,212
"14989","1413334",0.553711844628941,7511,0.585984230816837,7836,-0.0322723861878962,-325
"14990","2413334",0.490488672120752,10709,0.529609746176014,11023,-0.0391210740552619,-314
"14991","3413334",0.447374463307248,12661,0.500815912976234,12451,-0.0534414496689859,210
"14992","4413334",0.405900132606708,14138,0.458405537854424,14141,-0.0525054052477156,-3
"14993","1123334",0.606606319617289,4947,0.64839926940654,4478,-0.0417929497892512,469
"14994","2123334",0.5433831471091,8049,0.592024784765717,7501,-0.0486416376566168,548
"14995","3123334",0.500268938295597,10252,0.563230951565937,9150,-0.0629620132703408,1102
"14996","4123334",0.458794607595057,12200,0.520820576444127,11451,-0.0620259688490703,749
"14997","1223334",0.552648542024293,7554,0.593094990460834,7447,-0.040446448436541,107
"14998","2223334",0.489425369516104,10773,0.536720505820011,10651,-0.0472951363039066,122
"14999","3223334",0.446311160702601,12701,0.507926672620231,12119,-0.0616155119176306,582
"15000","4223334",0.40483683000206,14169,0.465516297498421,13909,-0.0606794674963603,260
"15001","1323334",0.524669071747517,9011,0.566044423127536,8988,-0.0413753513800192,23
"15002","2323334",0.461445899239328,12070,0.509669938486713,12042,-0.0482240392473848,28
"15003","3323334",0.418331690425824,13741,0.480876105286933,13305,-0.0625444148611088,436
"15004","4323334",0.376857359725284,14909,0.438465730165123,14750,-0.0616083704398385,159
"15005","1423334",0.485732573762521,10967,0.52541491915943,11227,-0.0396823453969094,-260
"15006","2423334",0.422509401254332,13596,0.469040434518607,13793,-0.046531033264275,-197
"15007","3423334",0.379395192440828,14852,0.440246601318827,14707,-0.0608514088779991,145
"15008","4423334",0.337920861740288,15634,0.397836226197017,15619,-0.0599153644567288,15
"15009","1133334",0.563273797452189,7001,0.609934176958511,6490,-0.0466603795063218,511
"15010","2133334",0.500050624944001,10267,0.553559692317688,9710,-0.0535090673736874,557
"15011","3133334",0.456936416130497,12265,0.524765859117909,11261,-0.0678294429874114,1004
"15012","4133334",0.415462085429957,13833,0.482355483996098,13241,-0.0668933985661411,592
"15013","1233334",0.509316019859193,9784,0.554629898012805,9642,-0.0453138781536119,142
"15014","2233334",0.446092847351004,12713,0.498255413371982,12570,-0.0521625660209774,143
"15015","3233334",0.402978638537501,14214,0.469461580172202,13779,-0.0664829416347014,435
"15016","4233334",0.361504307836961,15231,0.427051205050392,15042,-0.0655468972134309,189
"15017","1333334",0.481336549582417,11164,0.527579330679507,11117,-0.0462427810970901,47
"15018","2333334",0.418113377074228,13748,0.471204846038684,13713,-0.0530914689644557,35
"15019","3333334",0.374999168260725,14939,0.442411012838904,14650,-0.0674118445781797,289
"15020","4333334",0.333524837560185,15684,0.400000637717094,15589,-0.0664758001569092,95
"15021","1433334",0.442400051597421,12855,0.486949826711401,13052,-0.0445497751139802,-197
"15022","2433334",0.379176879089232,14855,0.430575342070578,14963,-0.0513984629813459,-108
"15023","3433334",0.336062670275729,15652,0.401781508870799,15572,-0.0657188385950699,80
"15024","4433334",0.294588339575189,16073,0.359371133748988,16067,-0.0647827941737995,6
"15025","1143334",0.51424023299736,9553,0.569535682831427,8800,-0.0552954498340674,753
"15026","2143334",0.451017060489171,12508,0.513161198190604,11872,-0.062144137701433,636
"15027","3143334",0.407902851675667,14072,0.484367364990824,13168,-0.076464513315157,904
"15028","4143334",0.366428520975128,15139,0.441956989869014,14661,-0.0755284688938865,478
"15029","1243334",0.460282455404364,12125,0.514231403885721,11817,-0.0539489484813572,308
"15030","2243334",0.397059282896175,14384,0.457856919244898,14155,-0.0607976363487228,229
"15031","3243334",0.353945074082671,15364,0.429063086045118,15001,-0.0751180119624468,363
"15032","4243334",0.312470743382131,15927,0.386652710923308,15776,-0.0741819675411765,151
"15033","1343334",0.432302985127588,13253,0.487180836552423,13046,-0.0548778514248354,207
"15034","2343334",0.369079812619399,15070,0.4308063519116,14960,-0.061726539292201,110
"15035","3343334",0.325965603805895,15778,0.40201251871182,15567,-0.076046914905925,211
"15036","4343334",0.284491273105355,16139,0.35960214359001,16066,-0.0751108704846548,73
"15037","1443334",0.393366487142592,14492,0.446551332584317,14528,-0.0531848454417256,-36
"15038","2443334",0.330143314634403,15725,0.390176847943494,15731,-0.0600335333090913,-6
"15039","3443334",0.287029105820899,16125,0.361383014743715,16057,-0.0743539089228153,68
"15040","4443334",0.245554775120359,16302,0.318972639621904,16282,-0.073417864501545,20
"15041","1114334",0.622378518513139,4250,0.664317967690291,3783,-0.041939449177152,467
"15042","2114334",0.55915534600495,7218,0.607943483049468,6611,-0.0487881370445176,607
"15043","3114334",0.516041137191447,9470,0.579149649849688,8246,-0.0631085126582416,1224
"15044","4114334",0.474566806490907,11494,0.536739274727878,10649,-0.0621724682369711,845
"15045","1214334",0.568420740920143,6770,0.609013688744585,6551,-0.0405929478244418,219
"15046","2214334",0.505197568411954,9996,0.552639204103762,9766,-0.0474416356918074,230
"15047","3214334",0.462083359598451,12045,0.523845370903982,11305,-0.0617620113055314,740
"15048","4214334",0.420609028897911,13665,0.481434995782172,13278,-0.0608259668842611,387
"15049","1314334",0.540441270643367,8212,0.581963121411287,8086,-0.04152185076792,126
"15050","2314334",0.477218098135178,11363,0.525588636770464,11221,-0.0483705386352856,142
"15051","3314334",0.434103889321675,13182,0.496794803570684,12632,-0.0626909142490096,550
"15052","4314334",0.392629558621134,14518,0.454384428448874,14274,-0.0617548698277393,244
"15053","1414334",0.501504772658371,10197,0.541333617443181,10399,-0.0398288447848102,-202
"15054","2414334",0.438281600150182,13004,0.484959132802358,13139,-0.0466775326521758,-135
"15055","3414334",0.395167391336679,14443,0.456165299602578,14201,-0.0609979082658998,242
"15056","4414334",0.353693060636138,15371,0.413754924480768,15329,-0.0600618638446296,42
"15057","1124334",0.554399247646719,7479,0.603748656032884,6838,-0.0493494083861652,641
"15058","2124334",0.49117607513853,10682,0.547374171392061,10038,-0.0561980962535308,644
"15059","3124334",0.448061866325027,12635,0.518580338192282,11582,-0.0705184718672548,1053
"15060","4124334",0.406587535624487,14112,0.476169963070471,13506,-0.0695824274459843,606
"15061","1224334",0.500441470053723,10236,0.548444377087178,9983,-0.048002907033455,253
"15062","2224334",0.437218297545534,13048,0.492069892446355,12848,-0.0548515949008205,200
"15063","3224334",0.394104088732031,14475,0.463276059246575,13968,-0.0691719705145445,507
"15064","4224334",0.352629758031491,15396,0.420865684124765,15178,-0.0682359260932743,218
"15065","1324334",0.472461999776947,11591,0.52139380975388,11430,-0.0489318099769332,161
"15066","2324334",0.409238827268758,14023,0.465019325113057,13922,-0.0557804978442988,101
"15067","3324334",0.366124618455255,15145,0.436225491913277,14814,-0.0701008734580228,331
"15068","4324334",0.324650287754714,15794,0.393815116791467,15674,-0.0691648290367525,120
"15069","1424334",0.433525501791951,13207,0.480764305785774,13309,-0.0472388039938234,-102
"15070","2424334",0.370302329283762,15045,0.424389821144951,15100,-0.054087491861189,-55
"15071","3424334",0.327188120470259,15767,0.395595987945172,15650,-0.0684078674749131,117
"15072","4424334",0.285713789769719,16135,0.353185612823361,16108,-0.0674718230536427,27
"15073","1134334",0.51106672548162,9717,0.565283563584855,9025,-0.0542168381032359,692
"15074","2134334",0.447843552973431,12644,0.508909078944032,12069,-0.0610655259706014,575
"15075","3134334",0.404729344159927,14173,0.480115245744253,13331,-0.0753859015843254,842
"15076","4134334",0.363255013459387,15200,0.437704870622442,14769,-0.0744498571630551,431
"15077","1234334",0.457108947888623,12254,0.509979284639149,12027,-0.0528703367505259,227
"15078","2234334",0.393885775380434,14482,0.453604799998326,14297,-0.0597190246178914,185
"15079","3234334",0.350771566566931,15423,0.424810966798546,15088,-0.0740394002316154,335
"15080","4234334",0.309297235866391,15963,0.382400591676736,15829,-0.0731033558103449,134
"15081","1334334",0.429129477611847,13372,0.482928717305851,13217,-0.0537992396940041,155
"15082","2334334",0.365906305103658,15149,0.426554232665028,15045,-0.0606479275613697,104
"15083","3334334",0.322792096290155,15815,0.397760399465248,15621,-0.0749683031750937,194
"15084","4334334",0.281317765589615,16161,0.355350024343438,16090,-0.0740322587538232,71
"15085","1434334",0.390192979626851,14586,0.442299213337745,14652,-0.0521062337108942,-66
"15086","2434334",0.326969807118662,15768,0.385924728696922,15781,-0.0589549215782599,-13
"15087","3434334",0.283855598305159,16142,0.357130895497143,16081,-0.0732752971919838,61
"15088","4434334",0.242381267604619,16311,0.314720520375332,16292,-0.0723392527707136,19
"15089","1144334",0.46203316102679,12048,0.524885069457771,11252,-0.0628519084309814,796
"15090","2144334",0.398809988518601,14329,0.468510584816948,13809,-0.069700596298347,520
"15091","3144334",0.355695779705098,15338,0.439716751617169,14717,-0.084020971912071,621
"15092","4144334",0.314221449004558,15910,0.397306376495358,15630,-0.0830849274908005,280
"15093","1244334",0.408075383433794,14057,0.469580790512065,13776,-0.0615054070782712,281
"15094","2244334",0.344852210925605,15514,0.413206305871242,15346,-0.0683540949456368,168
"15095","3244334",0.301738002112102,16020,0.384412472671462,15800,-0.0826744705593608,220
"15096","4244334",0.260263671411562,16253,0.342002097549652,16184,-0.0817384261380904,69
"15097","1344334",0.380095913157018,14837,0.442530223178767,14647,-0.0624343100217494,190
"15098","2344334",0.316872740648829,15877,0.386155738537944,15778,-0.069282997889115,99
"15099","3344334",0.273758531835325,16199,0.357361905338164,16079,-0.083603373502839,120
"15100","4344334",0.232284201134785,16327,0.314951530216354,16291,-0.0826673290815688,36
"15101","1444334",0.341159415172022,15578,0.401900719210661,15569,-0.0607413040386396,9
"15102","2444334",0.277936242663833,16176,0.345526234569838,16163,-0.0675899919060053,13
"15103","3444334",0.234822033850329,16322,0.316732401370059,16286,-0.0819103675197294,36
"15104","4444334",0.193347703149789,16371,0.274322026248248,16365,-0.080974323098459,6
"15105","1111434",0.716761660805736,1326,0.738659013144723,1339,-0.0218973523389867,-13
"15106","2111434",0.653538488297547,3056,0.682284528503899,3033,-0.0287460402063523,23
"15107","3111434",0.610424279484044,4777,0.65349069530412,4260,-0.0430664158200763,517
"15108","4111434",0.568949948783504,6739,0.61108032018231,6434,-0.0421303713988059,305
"15109","1211434",0.66280388321274,2734,0.683354734199016,2992,-0.0205508509862766,-258
"15110","2211434",0.599580710704551,5249,0.626980249558193,5564,-0.0273995388536422,-315
"15111","3211434",0.556466501891048,7373,0.598186416358414,7169,-0.0417199144673662,204
"15112","4211434",0.514992171190508,9517,0.555776041236603,9588,-0.0407838700460958,-71
"15113","1311434",0.634824412935964,3746,0.656304166865719,4133,-0.0214797539297549,-387
"15114","2311434",0.571601240427775,6599,0.599929682224895,7060,-0.0283284417971205,-461
"15115","3311434",0.528487031614271,8812,0.571135849025116,8719,-0.0426488174108445,93
"15116","4311434",0.487012700913731,10905,0.528725473903305,11066,-0.0417127729895741,-161
"15117","1411434",0.595887914950968,5430,0.615674662897613,6180,-0.019786747946645,-750
"15118","2411434",0.532664742442779,8588,0.55930017825679,9373,-0.0266354358140107,-785
"15119","3411434",0.489550533629275,10767,0.53050634505701,10972,-0.0409558114277347,-205
"15120","4411434",0.448076202928735,12634,0.4880959699352,13016,-0.0400197670064643,-382
"15121","1121434",0.648782389939316,3233,0.678089701487316,3203,-0.0293073115479999,30
"15122","2121434",0.585559217431127,5915,0.621715216846493,5844,-0.0361559994153655,71
"15123","3121434",0.542445008617624,8097,0.592921383646713,7459,-0.0504763750290895,638
"15124","4121434",0.500970677917084,10217,0.550511008524903,9867,-0.0495403306078191,350
"15125","1221434",0.59482461234632,5476,0.62278542254161,5794,-0.0279608101952898,-318
"15126","2221434",0.531601439838131,8641,0.566410937900786,8970,-0.0348094980626554,-329
"15127","3221434",0.488487231024628,10830,0.537617104701007,10602,-0.0491298736763794,228
"15128","4221434",0.447012900324088,12679,0.495206729579197,12709,-0.048193829255109,-30
"15129","1321434",0.566845142069544,6847,0.595734855208312,7309,-0.0288897131387681,-462
"15130","2321434",0.503621969561355,10082,0.539360370567489,10507,-0.0357384010061337,-425
"15131","3321434",0.460507760747851,12117,0.510566537367709,12007,-0.0500587766198577,110
"15132","4321434",0.419033430047311,13724,0.468156162245899,13817,-0.0491227321985873,-93
"15133","1421434",0.527908644084548,8849,0.555105351240206,9620,-0.0271967071556583,-771
"15134","2421434",0.464685471576359,11922,0.498730866599383,12558,-0.0340453950230239,-636
"15135","3421434",0.421571262762855,13631,0.469937033399603,13766,-0.0483657706367479,-135
"15136","4421434",0.380096932062315,14836,0.427526658277793,15030,-0.0474297262154775,-194
"15137","1131434",0.605449867774216,4991,0.639624609039287,4942,-0.0341747412650707,49
"15138","2131434",0.542226695266028,8110,0.583250124398464,7996,-0.0410234291324363,114
"15139","3131434",0.499112486452524,10315,0.554456291198684,9655,-0.0553438047461603,660
"15140","4131434",0.457638155751984,12238,0.512045916076874,11929,-0.0544077603248899,309
"15141","1231434",0.55149209018122,7624,0.584320330093581,7928,-0.0328282399123606,-304
"15142","2231434",0.488268917673031,10842,0.527945845452758,11097,-0.0396769277797262,-255
"15143","3231434",0.445154708859528,12754,0.499152012252978,12539,-0.0539973033934502,215
"15144","4231434",0.403680378158988,14202,0.456741637131168,14188,-0.0530612589721798,14
"15145","1331434",0.523512619904444,9064,0.557269762760283,9493,-0.0337571428558389,-429
"15146","2331434",0.460289447396255,12124,0.50089527811946,12445,-0.0406058307232045,-321
"15147","3331434",0.417175238582752,13783,0.47210144491968,13686,-0.0549262063369284,97
"15148","4331434",0.375700907882212,14929,0.42969106979787,14986,-0.053990161915658,-57
"15149","1431434",0.484576121919448,11011,0.516640258792177,11681,-0.032064136872729,-670
"15150","2431434",0.421352949411259,13636,0.460265774151354,14072,-0.0389128247400947,-436
"15151","3431434",0.378238740597756,14880,0.431471940951574,14949,-0.0532332003538187,-69
"15152","4431434",0.336764409897216,15644,0.389061565829764,15744,-0.0522971559325483,-100
"15153","1141434",0.556416303319387,7378,0.599226114912203,7101,-0.0428098115928162,277
"15154","2141434",0.493193130811198,10589,0.54285163027138,10294,-0.0496584994601817,295
"15155","3141434",0.450078921997695,12541,0.5140577970716,11827,-0.0639788750739058,714
"15156","4141434",0.408604591297155,14040,0.47164742194979,13700,-0.0630428306526353,340
"15157","1241434",0.502458525726391,10139,0.543921835966497,10240,-0.0414633102401061,-101
"15158","2241434",0.439235353218202,12968,0.487547351325673,13032,-0.0483119981074716,-64
"15159","3241434",0.396121144404698,14415,0.458753518125894,14128,-0.0626323737211956,287
"15160","4241434",0.354646813704158,15353,0.416343143004084,15274,-0.0616963292999252,79
"15161","1341434",0.474479055449615,11501,0.516871268633199,11673,-0.0423922131835843,-172
"15162","2341434",0.411255882941426,13955,0.460496783992376,14064,-0.0492409010509499,-109
"15163","3341434",0.368141674127922,15096,0.431702950792596,14941,-0.0635612766646739,155
"15164","4341434",0.326667343427382,15769,0.389292575670786,15740,-0.0626252322434035,29
"15165","1441434",0.435542557464619,13122,0.476241764665093,13501,-0.0406992072004744,-379
"15166","2441434",0.37231938495643,15000,0.41986728002427,15203,-0.0475478950678401,-203
"15167","3441434",0.329205176142926,15739,0.39107344682449,15718,-0.0618682706815641,21
"15168","4441434",0.287730845442386,16119,0.34866307170268,16142,-0.0609322262602937,-23
"15169","1112434",0.683676749044047,2111,0.700340031616071,2394,-0.0166632825720235,-283
"15170","2112434",0.620453576535858,4317,0.643965546975247,4700,-0.0235119704393891,-383
"15171","3112434",0.577339367722355,6322,0.615171713775468,6204,-0.0378323460531131,118
"15172","4112434",0.535865037021815,8428,0.572761338653658,8605,-0.0368963016318428,-177
"15173","1212434",0.629718971451051,3923,0.645035752670364,4650,-0.0153167812193135,-727
"15174","2212434",0.566495798942862,6860,0.588661268029541,7674,-0.022165469086679,-814
"15175","3212434",0.523381590129359,9068,0.559867434829762,9344,-0.0364858447004031,-276
"15176","4212434",0.481907259428819,11140,0.517457059707951,11640,-0.0355498002791327,-500
"15177","1312434",0.601739501174275,5145,0.617985185337066,6048,-0.0162456841627917,-903
"15178","2312434",0.538516328666086,8298,0.561610700696243,9234,-0.0230943720301573,-936
"15179","3312434",0.495402119852582,10471,0.532816867496464,10859,-0.0374147476438813,-388
"15180","4312434",0.453927789152042,12392,0.490406492374653,12913,-0.0364787032226109,-521
"15181","1412434",0.562803003189279,7022,0.577355681368961,8355,-0.0145526781796819,-1333
"15182","2412434",0.49957983068109,10283,0.520981196728137,11442,-0.0214013660470476,-1159
"15183","3412434",0.456465621867586,12280,0.492187363528358,12844,-0.0357217416607715,-564
"15184","4412434",0.414991291167046,13849,0.449776988406548,14424,-0.0347856972395011,-575
"15185","1122434",0.615697478177627,4509,0.639770719958664,4929,-0.0240732417810368,-420
"15186","2122434",0.552474305669438,7567,0.583396235317841,7986,-0.0309219296484023,-419
"15187","3122434",0.509360096855935,9779,0.554602402118061,9645,-0.0452423052621264,134
"15188","4122434",0.467885766155395,11780,0.512192026996251,11922,-0.044306260840856,-142
"15189","1222434",0.561739700584631,7075,0.584466441012958,7918,-0.0227267404283267,-843
"15190","2222434",0.498516528076442,10332,0.528091956372134,11094,-0.0295754282956923,-762
"15191","3222434",0.455402319262939,12322,0.499298123172355,12530,-0.0438958039094162,-208
"15192","4222434",0.413927988562399,13874,0.456887748050544,14185,-0.0429597594881458,-311
"15193","1322434",0.533760230307855,8524,0.55741587367966,9483,-0.0236556433718049,-959
"15194","2322434",0.470537057799666,11665,0.501041389038836,12441,-0.0305043312391705,-776
"15195","3322434",0.427422848986162,13416,0.472247555839057,13678,-0.0448247068528945,-262
"15196","4322434",0.385948518285622,14680,0.429837180717247,14983,-0.0438886624316241,-303
"15197","1422434",0.494823732322859,10508,0.516786369711554,11677,-0.0219626373886951,-1169
"15198","2422434",0.43160055981467,13282,0.460411885070731,14067,-0.0288113252560607,-785
"15199","3422434",0.388486351001166,14622,0.431618051870951,14944,-0.0431317008697847,-322
"15200","4422434",0.347012020300627,15477,0.389207676749141,15743,-0.0421956564485144,-266
"15201","1132434",0.572364956012527,6569,0.601305627510635,6979,-0.0289406714981075,-410
"15202","2132434",0.509141783504339,9791,0.544931142869812,10176,-0.0357893593654731,-385
"15203","3132434",0.466027574690835,11859,0.516137309670032,11710,-0.0501097349791971,149
"15204","4132434",0.424553243990295,13526,0.473726934548222,13613,-0.0491736905579267,-87
"15205","1232434",0.518407178419531,9316,0.546001348564929,10114,-0.0275941701453974,-798
"15206","2232434",0.455184005911342,12329,0.489626863924105,12952,-0.034442858012763,-623
"15207","3232434",0.412069797097839,13937,0.460833030724326,14056,-0.048763233626487,-119
"15208","4232434",0.370595466397299,15037,0.418422655602516,15230,-0.0478271892052166,-193
"15209","1332434",0.490427708142755,10720,0.518950781231631,11559,-0.0285230730888757,-839
"15210","2332434",0.427204535634566,13425,0.462576296590808,13994,-0.0353717609562412,-569
"15211","3332434",0.384090326821063,14728,0.433782463391028,14873,-0.0496921365699652,-145
"15212","4332434",0.342615996120523,15551,0.391372088269218,15713,-0.0487560921486949,-162
"15213","1432434",0.451491210157759,12481,0.478321277263525,13406,-0.0268300671057658,-925
"15214","2432434",0.38826803764957,14627,0.421946792622702,15148,-0.0336787549731315,-521
"15215","3432434",0.345153828836067,15508,0.393152959422922,15684,-0.0479991305868555,-176
"15216","4432434",0.303679498135527,16007,0.350742584301112,16130,-0.047063086165585,-123
"15217","1142434",0.523331391557698,9071,0.560907133383551,9267,-0.037575741825853,-196
"15218","2142434",0.460108219049509,12136,0.504532648742728,12268,-0.0444244296932186,-132
"15219","3142434",0.416994010236006,13787,0.475738815542948,13521,-0.0587448053069425,266
"15220","4142434",0.375519679535466,14932,0.433328440421138,14883,-0.0578087608856722,49
"15221","1242434",0.469373613964702,11725,0.505602854437845,12219,-0.0362292404731429,-494
"15222","2242434",0.406150441456513,14127,0.449228369797021,14443,-0.0430779283405084,-316
"15223","3242434",0.363036232643009,15207,0.420434536597242,15192,-0.0573983039542325,15
"15224","4242434",0.32156190194247,15829,0.378024161475432,15887,-0.0564622595329621,-58
"15225","1342434",0.441394143687926,12888,0.478552287104547,13389,-0.0371581434166211,-501
"15226","2342434",0.378170971179737,14881,0.422177802463723,15142,-0.0440068312839867,-261
"15227","3342434",0.335056762366233,15666,0.393383969263944,15680,-0.0583272068977107,-14
"15228","4342434",0.293582431665693,16081,0.350973594142134,16126,-0.0573911624764402,-45
"15229","1442434",0.40245764570293,14234,0.437922783136441,14761,-0.0354651374335113,-527
"15230","2442434",0.339234473194741,15612,0.381548298495618,15837,-0.042313825300877,-225
"15231","3442434",0.296120264381237,16067,0.352754465295838,16114,-0.0566342009146009,-47
"15232","4442434",0.254645933680697,16272,0.310344090174028,16311,-0.0556981564933304,-39
"15233","1113434",0.644793573471561,3370,0.674843441226832,3324,-0.0300498677552702,46
"15234","2113434",0.581570400963373,6114,0.618468956586008,6021,-0.0368985556226358,93
"15235","3113434",0.538456192149869,8302,0.589675123386229,7624,-0.0512189312363598,678
"15236","4113434",0.496981861449329,10412,0.547264748264419,10043,-0.0502828868150893,369
"15237","1213434",0.590835795878565,5637,0.619539162281125,5964,-0.02870336640256,-327
"15238","2213434",0.527612623370377,8862,0.563164677640302,9154,-0.0355520542699256,-292
"15239","3213434",0.484498414556873,11013,0.534370844440523,10771,-0.0498724298836496,242
"15240","4213434",0.443024083856333,12827,0.491960469318712,12852,-0.0489363854623793,-25
"15241","1313434",0.562856325601789,7018,0.592488594947827,7480,-0.0296322693460382,-462
"15242","2313434",0.4996331530936,10280,0.536114110307004,10678,-0.0364809572134038,-398
"15243","3313434",0.456518944280097,12277,0.507320277107225,12146,-0.0508013328271278,131
"15244","4313434",0.415044613579557,13845,0.464909901985414,13926,-0.0498652884058575,-81
"15245","1413434",0.523919827616793,9051,0.551859090979722,9802,-0.0279392633629284,-751
"15246","2413434",0.460696655108604,12109,0.495484606338898,12695,-0.034787951230294,-586
"15247","3413434",0.417582446295101,13765,0.466690773139119,13862,-0.0491083268440181,-97
"15248","4413434",0.376108115594561,14924,0.424280398017309,15103,-0.0481722824227478,-179
"15249","1123434",0.576814302605141,6345,0.614274129569425,6253,-0.0374598269642834,92
"15250","2123434",0.513591130096953,9587,0.557899644928602,9451,-0.044308514831649,136
"15251","3123434",0.470476921283449,11668,0.529105811728822,11050,-0.058628890445373,618
"15252","4123434",0.429002590582909,13377,0.486695436607012,13067,-0.0576928460241025,310
"15253","1223434",0.522856525012145,9100,0.558969850623719,9398,-0.0361133256115732,-298
"15254","2223434",0.459633352503957,12155,0.502595365982895,12364,-0.0429620134789388,-209
"15255","3223434",0.416519143690453,13795,0.473801532783116,13609,-0.0572823890926628,186
"15256","4223434",0.375044812989913,14938,0.431391157661305,14951,-0.0563463446713925,-13
"15257","1323434",0.494877054735369,10506,0.531919283290421,10895,-0.0370422285550515,-389
"15258","2323434",0.43165388222718,13281,0.475544798649597,13525,-0.043890916422417,-244
"15259","3323434",0.388539673413677,14621,0.446750965449818,14522,-0.058211292036141,99
"15260","4323434",0.347065342713137,15476,0.404340590328008,15515,-0.0572752476148707,-39
"15261","1423434",0.455940556750373,12311,0.491289779322315,12874,-0.0353492225719416,-563
"15262","2423434",0.392717384242184,14513,0.434915294681492,14844,-0.0421979104393073,-331
"15263","3423434",0.349603175428681,15444,0.406121461481712,15481,-0.0565182860530313,-37
"15264","4423434",0.308128844728141,15972,0.363711086359902,16030,-0.0555822416317609,-58
"15265","1133434",0.533481780440042,8542,0.575809037121396,8438,-0.0423272566813541,104
"15266","2133434",0.470258607931853,11681,0.519434552480573,11532,-0.0491759445487197,149
"15267","3133434",0.42714439911835,13431,0.490640719280793,12905,-0.0634963201624436,526
"15268","4133434",0.38567006841781,14687,0.448230344158983,14472,-0.0625602757411733,215
"15269","1233434",0.479524002847046,11238,0.52050475817569,11467,-0.0409807553286441,-229
"15270","2233434",0.416300830338857,13804,0.464130273534866,13941,-0.0478294431960096,-137
"15271","3233434",0.373186621525353,14980,0.435336440335087,14836,-0.0621498188097336,144
"15272","4233434",0.331712290824813,15705,0.392926065213277,15685,-0.0612137743884631,20
"15273","1333434",0.45154453257027,12479,0.493454190842392,12779,-0.0419096582721223,-300
"15274","2333434",0.388321360062081,14626,0.437079706201568,14781,-0.0487583461394879,-155
"15275","3333434",0.345207151248577,15507,0.408285873001789,15436,-0.0630787217532119,71
"15276","4333434",0.303732820548037,16006,0.365875497879979,16008,-0.0621426773319413,-2
"15277","1433434",0.412608034585274,13921,0.452824686874286,14316,-0.0402166522890124,-395
"15278","2433434",0.349384862077085,15447,0.396450202233463,15636,-0.0470653401563781,-189
"15279","3433434",0.306270653263581,15987,0.367656369033683,15998,-0.061385715770102,-11
"15280","4433434",0.264796322563041,16237,0.325245993911873,16258,-0.0604496713488314,-21
"15281","1143434",0.484448215985212,11018,0.535410542994312,10716,-0.0509623270090996,302
"15282","2143434",0.421225043477023,13642,0.479036058353489,13373,-0.0578110148764652,269
"15283","3143434",0.37811083466352,14884,0.450242225153709,14413,-0.0721313904901892,471
"15284","4143434",0.33663650396298,15646,0.407831850031899,15447,-0.0711953460689187,199
"15285","1243434",0.430490438392216,13321,0.480106264048606,13332,-0.0496158256563894,-11
"15286","2243434",0.367267265884027,15116,0.423731779407782,15110,-0.056464513523755,6
"15287","3243434",0.324153057070524,15799,0.394937946208003,15659,-0.070784889137479,140
"15288","4243434",0.282678726369984,16150,0.352527571086193,16116,-0.0698488447162086,34
"15289","1343434",0.40251096811544,14233,0.453055696715308,14310,-0.0505447285998676,-77
"15290","2343434",0.339287795607251,15611,0.396681212074484,15633,-0.0573934164672332,-22
"15291","3343434",0.296173586793748,16066,0.367887378874705,15994,-0.0717137920809571,72
"15292","4343434",0.254699256093208,16271,0.325477003752895,16257,-0.0707777476596868,14
"15293","1443434",0.363574470130444,15194,0.412426192747202,15356,-0.0488517226167578,-162
"15294","2443434",0.300351297622255,16037,0.356051708106379,16087,-0.0557004104841234,-50
"15295","3443434",0.257237088808752,16267,0.327257874906599,16254,-0.0700207860978473,13
"15296","4443434",0.215762758108212,16354,0.284847499784789,16351,-0.069084741676577,3
"15297","1114434",0.592586501500992,5566,0.630192827853176,5398,-0.0376063263521841,168
"15298","2114434",0.529363328992803,8773,0.573818343212352,8553,-0.0444550142195497,220
"15299","3114434",0.486249120179299,10943,0.545024510012573,10169,-0.0587753898332737,774
"15300","4114434",0.444774789478759,12769,0.502614134890763,12362,-0.0578393454120033,407
"15301","1214434",0.538628723907996,8295,0.57488854890747,8495,-0.036259824999474,-200
"15302","2214434",0.475405551399807,11448,0.518514064266646,11586,-0.0431085128668396,-138
"15303","3214434",0.432291342586303,13254,0.489720231066867,12946,-0.0574288884805635,308
"15304","4214434",0.390817011885763,14569,0.447309855945056,14506,-0.0564928440592932,63
"15305","1314434",0.510649253631219,9736,0.547837981574172,10015,-0.0371887279429522,-279
"15306","2314434",0.44742608112303,12659,0.491463496933348,12867,-0.0440374158103178,-208
"15307","3314434",0.404311872309527,14181,0.462669663733569,13991,-0.0583577914240418,190
"15308","4314434",0.362837541608987,15211,0.420259288611758,15196,-0.0574217470027714,15
"15309","1414434",0.471712755646223,11628,0.507208477606066,12150,-0.0354957219598424,-522
"15310","2414434",0.408489583138035,14045,0.450833992965243,14383,-0.042344409827208,-338
"15311","3414434",0.365375374324531,15159,0.422040159765463,15145,-0.0566647854409321,14
"15312","4414434",0.323901043623991,15805,0.379629784643653,15869,-0.0557287410196617,-64
"15313","1124434",0.524607230634572,9016,0.569623516195769,8796,-0.0450162855611973,220
"15314","2124434",0.461384058126383,12075,0.513249031554946,11869,-0.0518649734285629,206
"15315","3124434",0.418269849312879,13743,0.484455198355166,13164,-0.0661853490422868,579
"15316","4124434",0.376795518612339,14911,0.442044823233356,14660,-0.0652493046210165,251
"15317","1224434",0.470649453041576,11662,0.514319237250063,11815,-0.0436697842084872,-153
"15318","2224434",0.407426280533387,14085,0.457944752609239,14153,-0.0505184720758527,-68
"15319","3224434",0.364312071719883,15175,0.42915091940946,14997,-0.0648388476895768,178
"15320","4224434",0.322837741019343,15814,0.38674054428765,15773,-0.0639028032683064,41
"15321","1324434",0.442669982764799,12844,0.487268669916765,13044,-0.0445986871519654,-200
"15322","2324434",0.379446810256611,14851,0.430894185275942,14959,-0.051447375019331,-108
"15323","3324434",0.336332601443107,15649,0.402100352076162,15564,-0.065767750633055,85
"15324","4324434",0.294858270742567,16072,0.359689976954352,16065,-0.0648317062117845,7
"15325","1424434",0.403733484779803,14201,0.446639165948659,14524,-0.0429056811688556,-323
"15326","2424434",0.340510312271615,15588,0.390264681307836,15729,-0.0497543690362213,-141
"15327","3424434",0.297396103458111,16055,0.361470848108056,16055,-0.0640747446499452,0
"15328","4424434",0.255921772757571,16269,0.319060472986246,16281,-0.0631387002286747,-12
"15329","1134434",0.481274708469472,11169,0.53115842374774,10931,-0.0498837152782681,238
"15330","2134434",0.418051535961283,13752,0.474783939106917,13562,-0.0567324031456336,190
"15331","3134434",0.37493732714778,14941,0.445990105907137,14542,-0.0710527787593576,399
"15332","4134434",0.33346299644724,15686,0.403579730785327,15528,-0.0701167343380872,158
"15333","1234434",0.427316930876476,13419,0.475854144802034,13513,-0.0485372139255579,-94
"15334","2234434",0.364093758368287,15181,0.419479660161211,15210,-0.0553859017929235,-29
"15335","3234434",0.320979549554784,15833,0.390685826961431,15723,-0.0697062774066475,110
"15336","4234434",0.279505218854244,16167,0.348275451839621,16144,-0.068770232985377,23
"15337","1334434",0.3993374605997,14316,0.448803577468736,14451,-0.0494661168690362,-135
"15338","2334434",0.336114288091511,15651,0.392429092827913,15689,-0.0563148047364018,-38
"15339","3334434",0.293000079278008,16086,0.363635259628133,16032,-0.0706351803501257,54
"15340","4334434",0.251525748577468,16281,0.321224884506323,16275,-0.0696991359288552,6
"15341","1434434",0.360400962614704,15253,0.40817407350063,15438,-0.0477731108859263,-185
"15342","2434434",0.297177790106515,16056,0.351799588859807,16119,-0.0546217987532919,-63
"15343","3434434",0.254063581293012,16275,0.323005755660027,16270,-0.0689421743670158,5
"15344","4434434",0.212589250592471,16357,0.280595380538217,16358,-0.0680061299457456,-1
"15345","1144434",0.432241144014643,13257,0.490759929620656,12900,-0.0585187856060135,357
"15346","2144434",0.369017971506454,15074,0.434385444979833,14856,-0.0653674734733791,218
"15347","3144434",0.32590376269295,15780,0.405591611780053,15493,-0.0796878490871031,287
"15348","4144434",0.28442943199241,16141,0.363181236658243,16038,-0.0787518046658326,103
"15349","1244434",0.378283366421646,14878,0.43545565067495,14831,-0.0571722842533034,47
"15350","2244434",0.315060193913458,15896,0.379081166034127,15878,-0.064020972120669,18
"15351","3244434",0.271945985099954,16210,0.350287332834347,16132,-0.0783413477343929,78
"15352","4244434",0.230471654399414,16329,0.307876957712537,16317,-0.0774053033131224,12
"15353","1344434",0.35030389614487,15436,0.408405083341652,15433,-0.0581011871967816,3
"15354","2344434",0.287080723636681,16124,0.352030598700829,16117,-0.0649498750641471,7
"15355","3344434",0.243966514823178,16307,0.323236765501049,16267,-0.079270250677871,40
"15356","4344434",0.202492184122638,16365,0.280826390379239,16357,-0.0783342062566008,8
"15357","1444434",0.311367398159874,15944,0.367775579373546,15995,-0.0564081812136717,-51
"15358","2444434",0.248144225651685,16293,0.311401094732723,16306,-0.0632568690810373,-13
"15359","3444434",0.205030016838182,16364,0.282607261532943,16355,-0.0775772446947614,9
"15360","4444434",0.163555686137642,16381,0.240196886411133,16381,-0.076641200273491,0
"15361","1111144",0.779798622294077,453,0.796780403548419,445,-0.0169817812543414,8
"15362","2111144",0.716575449785888,1334,0.740405918907595,1307,-0.0238304691217069,27
"15363","3111144",0.673461240972385,2401,0.711612085707816,2024,-0.038150844735431,377
"15364","4111144",0.631986910271845,3843,0.669201710586005,3555,-0.0372148003141605,288
"15365","1211144",0.725840844701081,1164,0.741476124602712,1278,-0.0156352799016312,-114
"15366","2211144",0.662617672192892,2744,0.685101639961889,2923,-0.0224839677689967,-179
"15367","3211144",0.619503463379389,4360,0.65630780676211,4132,-0.0368043433827208,228
"15368","4211144",0.578029132678849,6294,0.613897431640299,6275,-0.0358682989614505,19
"15369","1311144",0.697861374424305,1745,0.714425557269414,1949,-0.0165641828451094,-204
"15370","2311144",0.634638201916116,3754,0.658051072628591,4051,-0.023412870712475,-297
"15371","3311144",0.591523993102613,5603,0.629257239428812,5445,-0.037733246326199,158
"15372","4311144",0.550049662402073,7702,0.586846864307001,7789,-0.0367972019049287,-87
"15373","1411144",0.658924876439309,2852,0.673796053301309,3357,-0.0148711768619996,-505
"15374","2411144",0.59570170393112,5439,0.617421568660485,6079,-0.0217198647293653,-640
"15375","3411144",0.552587495117617,7561,0.588627735460706,7681,-0.0360402403430893,-120
"15376","4411144",0.511113164417077,9713,0.546217360338896,10101,-0.035104195921819,-388
"15377","1121144",0.711819351427657,1426,0.736211091891012,1395,-0.0243917404633546,31
"15378","2121144",0.648596178919468,3243,0.679836607250188,3145,-0.0312404283307202,98
"15379","3121144",0.605481970105965,4987,0.651042774050409,4365,-0.0455608039444442,622
"15380","4121144",0.564007639405425,6966,0.608632398928599,6579,-0.0446247595231737,387
"15381","1221144",0.657861573834661,2892,0.680906812945306,3096,-0.0230452391106444,-204
"15382","2221144",0.594638401326472,5488,0.624532328304482,5694,-0.02989392697801,-206
"15383","3221144",0.551524192512969,7623,0.595738495104703,7307,-0.044214302591734,316
"15384","4221144",0.510049861812429,9757,0.553328119982892,9728,-0.0432782581704637,29
"15385","1321144",0.629882103557885,3920,0.653856245612008,4241,-0.0239741420541226,-321
"15386","2321144",0.566658931049696,6855,0.597481760971184,7214,-0.0308228299214882,-359
"15387","3321144",0.523544722236193,9061,0.568687927771405,8850,-0.0451432055352122,211
"15388","4321144",0.482070391535653,11136,0.526277552649595,11186,-0.044207161113942,-50
"15389","1421144",0.590945605572889,5632,0.613226741643902,6309,-0.0222811360710128,-677
"15390","2421144",0.5277224330647,8858,0.556852257003079,9519,-0.0291298239383785,-661
"15391","3421144",0.484608224251197,11010,0.528058423803299,11095,-0.0434501995521025,-85
"15392","4421144",0.443133893550657,12821,0.485648048681489,13115,-0.0425141551308322,-294
"15393","1131144",0.668486829262558,2559,0.697745999442983,2483,-0.0292591701804252,76
"15394","2131144",0.605263656754369,4997,0.64137151480216,4854,-0.0361078580477908,143
"15395","3131144",0.562149447940865,7059,0.61257768160238,6358,-0.0504282336615148,701
"15396","4131144",0.520675117240325,9206,0.57016730648057,8769,-0.0494921892402446,437
"15397","1231144",0.614529051669561,4581,0.642441720497277,4789,-0.0279126688277153,-208
"15398","2231144",0.551305879161373,7638,0.586067235856453,7829,-0.0347613566950808,-191
"15399","3231144",0.508191670347869,9848,0.557273402656674,9492,-0.0490817323088049,356
"15400","4231144",0.466717339647329,11828,0.514863027534864,11785,-0.0481456878875344,43
"15401","1331144",0.586549581392785,5851,0.615391153163979,6193,-0.0288415717711935,-342
"15402","2331144",0.523326408884596,9072,0.559016668523155,9396,-0.0356902596385591,-324
"15403","3331144",0.480212200071093,11212,0.530222835323376,10995,-0.0500106352522831,217
"15404","4331144",0.438737869370553,12986,0.487812460201566,13026,-0.0490745908310126,-40
"15405","1431144",0.547613083407789,7806,0.574761649195873,8507,-0.0271485657880837,-701
"15406","2431144",0.4843899108996,11019,0.51838716455505,11592,-0.0339972536554494,-573
"15407","3431144",0.441275702086097,12892,0.48959333135527,12953,-0.0483176292691733,-61
"15408","4431144",0.399801371385557,14302,0.44718295623346,14509,-0.0473815848479028,-207
"15409","1141144",0.619453264807728,4363,0.657347505315899,4088,-0.0378942405081708,275
"15410","2141144",0.556230092299539,7386,0.600973020675076,7000,-0.0447429283755364,386
"15411","3141144",0.513115883486036,9617,0.572179187475296,8642,-0.0590633039892604,975
"15412","4141144",0.471641552785496,11630,0.529768812353486,11012,-0.0581272595679899,618
"15413","1241144",0.565495487214732,6914,0.602043226370193,6929,-0.0365477391554606,-15
"15414","2241144",0.502272314706543,10151,0.545668741729369,10130,-0.0433964270228262,21
"15415","3241144",0.45915810589304,12181,0.51687490852959,11672,-0.0577168026365502,509
"15416","4241144",0.4176837751925,13760,0.474464533407779,13578,-0.0567807582152799,182
"15417","1341144",0.537516016937956,8349,0.574992659036895,8488,-0.0374766420989389,-139
"15418","2341144",0.474292844429767,11507,0.518618174396071,11580,-0.0443253299663044,-73
"15419","3341144",0.431178635616263,13296,0.489824341196292,12943,-0.0586457055800284,353
"15420","4341144",0.389704304915723,14597,0.447413966074482,14504,-0.0577096611587581,93
"15421","1441144",0.49857951895296,10331,0.534363155068789,10772,-0.035783636115829,-441
"15422","2441144",0.435356346444771,13130,0.477988670427966,13420,-0.0426323239831947,-290
"15423","3441144",0.392242137631267,14528,0.449194837228186,14444,-0.0569526995969187,84
"15424","4441144",0.350767806930727,15424,0.406784462106376,15469,-0.0560166551756484,-45
"15425","1112144",0.746713710532388,832,0.758461422019766,959,-0.0117477114873782,-127
"15426","2112144",0.683490538024199,2122,0.702086937378943,2355,-0.0185963993547438,-233
"15427","3112144",0.640376329210696,3550,0.673293104179164,3383,-0.0329167749684678,167
"15428","4112144",0.598901998510156,5280,0.630882729057353,5367,-0.0319807305471973,-87
"15429","1212144",0.692755932939392,1885,0.70315714307406,2311,-0.010401210134668,-426
"15430","2212144",0.629532760431203,3936,0.646782658433237,4571,-0.0172498980020336,-635
"15431","3212144",0.5864185516177,5858,0.617988825233457,6047,-0.0315702736157576,-189
"15432","4212144",0.54494422091716,7967,0.575578450111647,8459,-0.0306342291944873,-492
"15433","1312144",0.664776462662616,2666,0.676106575740762,3288,-0.0113301130781462,-622
"15434","2312144",0.601553290154427,5156,0.619732091099939,5956,-0.0181788009455118,-800
"15435","3312144",0.558439081340924,7255,0.59093825790016,7550,-0.0324991765592358,-295
"15436","4312144",0.516964750640384,9412,0.548527882778349,9979,-0.0315631321379656,-567
"15437","1412144",0.62583996467762,4080,0.635477071772656,5147,-0.0096371070950364,-1067
"15438","2412144",0.562616792169431,7031,0.579102587131833,8249,-0.0164857949624021,-1218
"15439","3412144",0.519502583355928,9251,0.550308753932054,9878,-0.0308061705761261,-627
"15440","4412144",0.478028252655388,11319,0.507898378810243,12121,-0.0298701261548558,-802
"15441","1122144",0.678734439665968,2263,0.69789211036236,2482,-0.0191576706963914,-219
"15442","2122144",0.615511267157779,4524,0.641517625721536,4844,-0.026006358563757,-320
"15443","3122144",0.572397058344276,6566,0.612723792521757,6347,-0.040326734177481,219
"15444","4122144",0.530922727643736,8685,0.570313417399947,8764,-0.0393906897562105,-79
"15445","1222144",0.624776662072972,4142,0.642587831416653,4785,-0.0178111693436812,-643
"15446","2222144",0.561553489564783,7085,0.58621334677583,7824,-0.0246598572110468,-739
"15447","3222144",0.51843928075128,9314,0.557419513576051,9482,-0.0389802328247708,-168
"15448","4222144",0.47696495005074,11376,0.51500913845424,11776,-0.0380441884035005,-400
"15449","1322144",0.596797191796196,5378,0.615537264083356,6189,-0.0187400722871595,-811
"15450","2322144",0.533574019288007,8533,0.559162779442532,9387,-0.025588760154525,-854
"15451","3322144",0.490459810474504,10713,0.530368946242753,10985,-0.0399091357682491,-272
"15452","4322144",0.448985479773964,12597,0.487958571120942,13023,-0.0389730913469787,-426
"15453","1422144",0.5578606938112,7282,0.57490776011525,8494,-0.0170470663040496,-1212
"15454","2422144",0.494637521303011,10513,0.518533275474427,11584,-0.0238957541714153,-1071
"15455","3422144",0.451523312489508,12480,0.489739442274647,12945,-0.0382161297851393,-465
"15456","4422144",0.410048981788968,13996,0.447329067152837,14505,-0.037280085363869,-509
"15457","1132144",0.635401917500869,3729,0.659427017914331,3993,-0.0240251004134621,-264
"15458","2132144",0.57217874499268,6581,0.603052533273507,6877,-0.0308737882808277,-296
"15459","3132144",0.529064536179176,8788,0.574258700073728,8535,-0.0451941638945517,253
"15460","4132144",0.487590205478636,10877,0.531848324951918,10899,-0.0442581194732814,-22
"15461","1232144",0.581444139907872,6125,0.604122738968625,6818,-0.0226785990607521,-693
"15462","2232144",0.518220967399684,9336,0.547748254327801,10022,-0.0295272869281177,-686
"15463","3232144",0.47510675858618,11466,0.518954421128022,11558,-0.0438476625418417,-92
"15464","4232144",0.43363242788564,13205,0.476544046006211,13490,-0.0429116181205711,-285
"15465","1332144",0.553464669631096,7521,0.577072171635327,8367,-0.0236075020042303,-846
"15466","2332144",0.490241497122907,10729,0.520697686994503,11460,-0.0304561898715959,-731
"15467","3332144",0.447127288309404,12674,0.491903853794724,12853,-0.0447765654853199,-179
"15468","4332144",0.405652957608864,14147,0.449493478672914,14438,-0.0438405210640494,-291
"15469","1432144",0.5145281716461,9532,0.536442667667221,10661,-0.0219144960211205,-1129
"15470","2432144",0.451304999137911,12488,0.480068183026398,13335,-0.0287631838884861,-847
"15471","3432144",0.408190790324408,14054,0.451274349826618,14370,-0.0430835595022102,-316
"15472","4432144",0.366716459623868,15130,0.408863974704808,15428,-0.0421475150809397,-298
"15473","1142144",0.586368353046039,5861,0.619028523787247,5991,-0.0326601707412076,-130
"15474","2142144",0.52314518053785,9082,0.562654039146423,9183,-0.0395088586085732,-101
"15475","3142144",0.480030971724347,11218,0.533860205946644,10798,-0.0538292342222972,420
"15476","4142144",0.438556641023807,12991,0.491449830824834,12868,-0.0528931898010267,123
"15477","1242144",0.532410575453043,8601,0.56372424484154,9121,-0.0313136693884974,-520
"15478","2242144",0.469187402944854,11733,0.507349760200717,12145,-0.038162357255863,-412
"15479","3242144",0.426073194131351,13471,0.478555927000938,13387,-0.052482732869587,84
"15480","4242144",0.384598863430811,14716,0.436145551879127,14818,-0.0515466884483167,-102
"15481","1342144",0.504431105176267,10036,0.536673677508243,10653,-0.0322425723319757,-617
"15482","2342144",0.441207932668078,12893,0.480299192867419,13325,-0.0390912601993412,-432
"15483","3342144",0.398093723854574,14350,0.45150535966764,14362,-0.0534116358130653,-12
"15484","4342144",0.356619393154035,15318,0.409094984545829,15423,-0.0524755913917949,-105
"15485","1442144",0.465494607191271,11875,0.496044173540137,12669,-0.0305495663488658,-794
"15486","2442144",0.402271434683082,14238,0.439669688899314,14718,-0.0373982542162315,-480
"15487","3442144",0.359157225869578,15272,0.410875855699534,15382,-0.0517186298299556,-110
"15488","4442144",0.317682895169039,15864,0.368465480577724,15988,-0.0507825854086852,-124
"15489","1113144",0.707830534959903,1524,0.732964831630527,1467,-0.0251342966706248,57
"15490","2113144",0.644607362451714,3377,0.676590346989704,3269,-0.0319829845379904,108
"15491","3113144",0.60149315363821,5158,0.647796513789925,4513,-0.0463033601517144,645
"15492","4113144",0.56001882293767,7174,0.605386138668114,6745,-0.0453673157304439,429
"15493","1213144",0.653872757366907,3038,0.677660552684821,3220,-0.0237877953179146,-182
"15494","2213144",0.590649584858718,5650,0.621286068043998,5872,-0.0306364831852802,-222
"15495","3213144",0.547535376045214,7809,0.592492234844218,7478,-0.0449568587990042,331
"15496","4213144",0.506061045344674,9947,0.550081859722408,9891,-0.044020814377734,56
"15497","1313144",0.62589328709013,4077,0.650609985351523,4390,-0.0247166982613929,-313
"15498","2313144",0.562670114581941,7027,0.5942355007107,7391,-0.0315653861287585,-364
"15499","3313144",0.519555905768438,9247,0.56544166751092,9018,-0.0458857617424825,229
"15500","4313144",0.478081575067898,11316,0.52303129238911,11347,-0.0449497173212122,-31
"15501","1413144",0.586956789105134,5831,0.609980481383417,6485,-0.023023692278283,-654
"15502","2413144",0.523733616596946,9054,0.553605996742594,9708,-0.0298723801456487,-654
"15503","3413144",0.480619407783442,11194,0.524812163542815,11259,-0.0441927557593728,-65
"15504","4413144",0.439145077082902,12972,0.482401788421004,13238,-0.0432567113381024,-266
"15505","1123144",0.639851264093483,3566,0.672395519973121,3427,-0.032544255879638,139
"15506","2123144",0.576628091585294,6351,0.616021035332297,6168,-0.0393929437470036,183
"15507","3123144",0.53351388277179,8537,0.587227202132518,7761,-0.0537133193607277,776
"15508","4123144",0.49203955207125,10642,0.544816827010708,10186,-0.0527772749394572,456
"15509","1223144",0.585893486500487,5894,0.617091241027414,6104,-0.0311977545269279,-210
"15510","2223144",0.522670313992298,9110,0.560716756386591,9285,-0.0380464423942934,-175
"15511","3223144",0.479556105178794,11236,0.531922923186812,10894,-0.0523668180080175,342
"15512","4223144",0.438081774478254,13013,0.489512548065001,12956,-0.0514307735867471,57
"15513","1323144",0.55791401622371,7280,0.590040673694117,7599,-0.0321266574704061,-319
"15514","2323144",0.494690843715522,10512,0.533666189053293,10815,-0.0389753453377717,-303
"15515","3323144",0.451576634902018,12476,0.504872355853514,12251,-0.0532957209514957,225
"15516","4323144",0.410102304201478,13993,0.462461980731703,14000,-0.0523596765302254,-7
"15517","1423144",0.518977518238714,9285,0.549411169726011,9925,-0.0304336514872963,-640
"15518","2423144",0.455754345730526,12315,0.493036685085187,12800,-0.0372823393546619,-485
"15519","3423144",0.412640136917022,13920,0.464242851885408,13938,-0.0516027149683859,-18
"15520","4423144",0.371165806216482,15024,0.421832476763598,15152,-0.0506666705471156,-128
"15521","1133144",0.596518741928383,5387,0.633930427525092,5229,-0.0374116855967087,158
"15522","2133144",0.533295569420194,8553,0.577555942884268,8345,-0.0442603734640743,208
"15523","3133144",0.490181360606691,10733,0.548762109684489,9962,-0.0585807490777983,771
"15524","4133144",0.448707029906151,12607,0.506351734562679,12190,-0.057644704656528,417
"15525","1233144",0.542560964335387,8091,0.578626148579386,8277,-0.0360651842439987,-186
"15526","2233144",0.479337791827198,11251,0.522251663938562,11386,-0.0429138721113643,-135
"15527","3233144",0.436223583013694,13090,0.493457830738783,12778,-0.0572342477250883,312
"15528","4233144",0.394749252313155,14457,0.451047455616972,14376,-0.0562982033038177,81
"15529","1333144",0.514581494058611,9530,0.551575581246088,9814,-0.036994087187477,-284
"15530","2333144",0.451358321550422,12486,0.495201096605264,12710,-0.0438427750548425,-224
"15531","3333144",0.408244112736918,14050,0.466407263405485,13871,-0.0581631506685665,179
"15532","4333144",0.366769782036378,15128,0.423996888283674,15107,-0.057227106247296,21
"15533","1433144",0.475644996073615,11439,0.510946077277982,11988,-0.0353010812043671,-549
"15534","2433144",0.412421823565426,13925,0.454571592637159,14265,-0.0421497690717328,-340
"15535","3433144",0.369307614751922,15064,0.425777759437379,15062,-0.0564701446854567,2
"15536","4433144",0.327833284051383,15760,0.383367384315569,15815,-0.0555341002641863,-55
"15537","1143144",0.547485177473553,7811,0.593531933398008,7429,-0.0460467559244543,382
"15538","2143144",0.484262004965365,11031,0.537157448757184,10627,-0.0528954437918199,404
"15539","3143144",0.441147796151861,12895,0.508363615557405,12091,-0.0672158194055439,804
"15540","4143144",0.399673465451321,14303,0.465953240435595,13888,-0.0662797749842733,415
"15541","1243144",0.493527399880557,10568,0.538227654452301,10566,-0.0447002545717441,2
"15542","2243144",0.430304227372369,13331,0.481853169811478,13259,-0.0515489424391096,72
"15543","3243144",0.387190018558865,14653,0.453059336611699,14309,-0.0658693180528336,344
"15544","4243144",0.345715687858325,15498,0.410648961489888,15388,-0.0649332736315633,110
"15545","1343144",0.465547929603781,11874,0.511177087119004,11977,-0.0456291575152223,-103
"15546","2343144",0.402324757095592,14235,0.45480260247818,14261,-0.0524778453825879,-26
"15547","3343144",0.359210548282089,15269,0.426008769278401,15059,-0.0667982209963118,210
"15548","4343144",0.317736217581549,15863,0.38359839415659,15813,-0.0658621765750416,50
"15549","1443144",0.426611431618785,13451,0.470547583150898,13742,-0.0439361515321124,-291
"15550","2443144",0.363388259110596,15196,0.414173098510074,15321,-0.0507848393994781,-125
"15551","3443144",0.320274050297093,15842,0.385379265310295,15787,-0.0651052150132021,55
"15552","4443144",0.278799719596553,16173,0.342968890188485,16178,-0.0641691705919318,-5
"15553","1114144",0.655623462989333,2963,0.688314218256872,2803,-0.0326907552675386,160
"15554","2114144",0.592400290481144,5573,0.631939733616048,5324,-0.0395394431349042,249
"15555","3114144",0.549286081667641,7730,0.603145900416269,6872,-0.0538598187486282,858
"15556","4114144",0.5078117509671,9865,0.560735525294458,9282,-0.052923774327358,583
"15557","1214144",0.601665685396337,5149,0.633009939311165,5264,-0.0313442539148286,-115
"15558","2214144",0.538442512888148,8306,0.576635454670342,8391,-0.0381929417821942,-85
"15559","3214144",0.495328304074644,10475,0.547841621470563,10014,-0.0525133173959182,461
"15560","4214144",0.453853973374104,12394,0.505431246348752,12228,-0.0515772729746478,166
"15561","1314144",0.57368621511956,6494,0.605959371977867,6704,-0.0322731568583069,-210
"15562","2314144",0.510463042611372,9741,0.549584887337044,9915,-0.0391218447256725,-174
"15563","3314144",0.467348833797868,11798,0.520791054137265,11454,-0.0534422203393965,344
"15564","4314144",0.425874503097328,13481,0.478380679015454,13401,-0.052506175918126,80
"15565","1414144",0.534749717134565,8476,0.565329868009762,9024,-0.0305801508751971,-548
"15566","2414144",0.471526544626376,11633,0.508955383368938,12067,-0.0374288387425628,-434
"15567","3414144",0.428412335812872,13389,0.480161550169159,13329,-0.0517492143562867,60
"15568","4414144",0.386938005112332,14659,0.437751175047349,14767,-0.0508131699350163,-108
"15569","1124144",0.587644192122913,5795,0.627744906599465,5524,-0.0401007144765518,271
"15570","2124144",0.524421019614724,9024,0.571370421958642,8702,-0.0469494023439174,322
"15571","3124144",0.481306810801221,11166,0.542576588758862,10314,-0.0612697779576414,852
"15572","4124144",0.439832480100681,12951,0.500166213637052,12489,-0.0603337335363712,462
"15573","1224144",0.533686414529917,8527,0.572440627653759,8627,-0.0387542131238419,-100
"15574","2224144",0.470463242021728,11669,0.516066143012935,11715,-0.0456029009912075,-46
"15575","3224144",0.427349033208224,13418,0.487272309813156,13042,-0.0599232766049314,376
"15576","4224144",0.385874702507684,14681,0.444861934691345,14576,-0.058987232183661,105
"15577","1324144",0.505706944253141,9964,0.545390060320461,10149,-0.0396831160673201,-185
"15578","2324144",0.442483771744952,12852,0.489015575679637,12980,-0.0465318039346856,-128
"15579","3324144",0.399369562931448,14313,0.460221742479858,14075,-0.0608521795484097,238
"15580","4324144",0.357895232230908,15295,0.417811367358048,15242,-0.0599161351271392,53
"15581","1424144",0.466770446268145,11823,0.504760556352355,12255,-0.0379901100842103,-432
"15582","2424144",0.403547273759956,14203,0.448386071711532,14466,-0.0448387979515759,-263
"15583","3424144",0.360433064946452,15252,0.419592238511752,15208,-0.0591591735652999,44
"15584","4424144",0.318958734245912,15850,0.377181863389942,15896,-0.0582231291440295,-46
"15585","1134144",0.544311669957813,7999,0.589279814151436,7645,-0.0449681441936227,354
"15586","2134144",0.481088497449624,11178,0.532905329510613,10853,-0.0518168320609883,325
"15587","3134144",0.437974288636121,13015,0.504111496310833,12293,-0.0661372076747123,722
"15588","4134144",0.396499957935581,14402,0.461701121189023,14025,-0.0652011632534418,377
"15589","1234144",0.490353892364817,10723,0.53397553520573,10791,-0.0436216428409125,-68
"15590","2234144",0.427130719856628,13433,0.477601050564906,13441,-0.0504703307082781,-8
"15591","3234144",0.384016511043125,14730,0.448807217365127,14450,-0.0647907063220021,280
"15592","4234144",0.342542180342585,15553,0.406396842243317,15476,-0.0638546619007317,77
"15593","1334144",0.462374422088041,12027,0.506924967872432,12168,-0.0445505457843908,-141
"15594","2334144",0.399151249579852,14320,0.450550483231608,14397,-0.0513992336517563,-77
"15595","3334144",0.356037040766349,15327,0.421756650031829,15154,-0.0657196092654804,173
"15596","4334144",0.314562710065809,15903,0.379346274910019,15875,-0.06478356484421,28
"15597","1434144",0.423437924103045,13561,0.466295463904326,13875,-0.0428575398012809,-314
"15598","2434144",0.360214751594856,15255,0.409920979263503,15404,-0.0497062276686466,-149
"15599","3434144",0.317100542781353,15872,0.381127146063723,15843,-0.0640266032823706,29
"15600","4434144",0.275626212080813,16191,0.338716770941913,16202,-0.0630905588611003,-11
"15601","1144144",0.495278105502984,10478,0.548881320024352,9958,-0.0536032145213681,520
"15602","2144144",0.432054932994795,13263,0.492506835383529,12827,-0.0604519023887336,436
"15603","3144144",0.388940724181291,14610,0.463713002183749,13955,-0.0747722780024577,655
"15604","4144144",0.347466393480751,15472,0.421302627061939,15163,-0.0738362335811873,309
"15605","1244144",0.441320327909988,12890,0.493577041078646,12771,-0.052256713168658,119
"15606","2244144",0.378097155401799,14885,0.437202556437822,14778,-0.0591054010360236,107
"15607","3244144",0.334982946588295,15667,0.408408723238043,15432,-0.0734257766497476,235
"15608","4244144",0.293508615887755,16082,0.365998348116232,16007,-0.0724897322284772,75
"15609","1344144",0.413340857633211,13890,0.466526473745348,13868,-0.0531856161121363,22
"15610","2344144",0.350117685125023,15437,0.410151989104524,15400,-0.0600343039795018,37
"15611","3344144",0.307003476311519,15977,0.381358155904745,15841,-0.0743546795932258,136
"15612","4344144",0.265529145610979,16233,0.338947780782935,16200,-0.0734186351719555,33
"15613","1444144",0.374404359648215,14953,0.425896969777242,15061,-0.0514926101290264,-108
"15614","2444144",0.311181187140027,15945,0.369522485136419,15973,-0.0583412979963921,-28
"15615","3444144",0.268066978326523,16227,0.340728651936639,16189,-0.0726616736101162,38
"15616","4444144",0.226592647625983,16336,0.298318276814829,16332,-0.0717256291888458,4
"15617","1111244",0.733949788145867,1025,0.751445556893637,1074,-0.0174957687477696,-49
"15618","2111244",0.670726615637678,2481,0.695071072252813,2576,-0.0243444566151352,-95
"15619","3111244",0.627612406824175,4010,0.666277239053034,3679,-0.0386648322288592,331
"15620","4111244",0.586138076123635,5880,0.623866863931223,5732,-0.0377287878075887,148
"15621","1211244",0.679992010552871,2226,0.69614127794793,2530,-0.0161492673950594,-304
"15622","2211244",0.616768838044682,4466,0.639766793307107,4932,-0.022997955262425,-466
"15623","3211244",0.573654629231179,6497,0.610972960107328,6437,-0.037318330876149,60
"15624","4211244",0.532180298530639,8612,0.568562584985517,8856,-0.0363822864548787,-244
"15625","1311244",0.652012540276095,3118,0.669090710614632,3561,-0.0170781703385376,-443
"15626","2311244",0.588789367767906,5740,0.612716225973809,6350,-0.0239268582059032,-610
"15627","3311244",0.545675158954402,7925,0.58392239277403,7952,-0.0382472338196272,-27
"15628","4311244",0.504200828253862,10051,0.541512017652219,10393,-0.037311189398357,-342
"15629","1411244",0.613076042291099,4656,0.628461206646527,5479,-0.0153851643554278,-823
"15630","2411244",0.54985286978291,7707,0.572086722005703,8651,-0.0222338522227935,-944
"15631","3411244",0.506738660969406,9915,0.543292888805924,10272,-0.0365542278365175,-357
"15632","4411244",0.465264330268866,11889,0.500882513684114,12447,-0.0356181834152473,-558
"15633","1121244",0.665970517279447,2627,0.69087624523623,2712,-0.0249057279567828,-85
"15634","2121244",0.602747344771258,5099,0.634501760595407,5209,-0.0317544158241484,-110
"15635","3121244",0.559633135957755,7185,0.605707927395627,6721,-0.0460747914378724,464
"15636","4121244",0.518158805257215,9340,0.563297552273817,9145,-0.0451387470166019,195
"15637","1221244",0.612012739686451,4702,0.635571966290524,5139,-0.0235592266040726,-437
"15638","2221244",0.548789567178262,7750,0.5791974816497,8243,-0.0304079144714382,-493
"15639","3221244",0.505675358364759,9967,0.550403648449921,9873,-0.0447282900851622,94
"15640","4221244",0.464201027664219,11944,0.50799327332811,12116,-0.043792245663892,-172
"15641","1321244",0.584033269409675,6001,0.608521398957226,6582,-0.0244881295475509,-581
"15642","2321244",0.520810096901486,9200,0.552146914316402,9790,-0.0313368174149165,-590
"15643","3321244",0.477695888087982,11338,0.523353081116623,11329,-0.0456571930286405,9
"15644","4321244",0.436221557387442,13091,0.480942705994813,13301,-0.0447211486073701,-210
"15645","1421244",0.545096771424679,7960,0.56789189498912,8893,-0.022795123564441,-933
"15646","2421244",0.48187359891649,11141,0.511517410348297,11959,-0.0296438114318067,-818
"15647","3421244",0.438759390102986,12983,0.482723577148517,13228,-0.0439641870455307,-245
"15648","4421244",0.397285059402446,14373,0.440313202026707,14705,-0.0430281426242604,-332
"15649","1131244",0.622637995114347,4232,0.652411152788201,4308,-0.0297731576738535,-76
"15650","2131244",0.559414822606159,7200,0.596036668147378,7293,-0.0366218455412191,-93
"15651","3131244",0.516300613792655,9453,0.567242834947598,8927,-0.0509422211549431,526
"15652","4131244",0.474826283092115,11483,0.524832459825788,11257,-0.0500061767336728,226
"15653","1231244",0.568680217521351,6751,0.597106873842495,7229,-0.0284266563211435,-478
"15654","2231244",0.505457045013162,9976,0.540732389201671,10439,-0.0352753441885091,-463
"15655","3231244",0.462342836199659,12029,0.511938556001892,11935,-0.0495957198022331,94
"15656","4231244",0.420868505499119,13655,0.469528180880082,13777,-0.0486596753809626,-122
"15657","1331244",0.540700747244575,8198,0.570056306509197,8772,-0.0293555592646217,-574
"15658","2331244",0.477477574736386,11346,0.513681821868374,11847,-0.0362042471319873,-501
"15659","3331244",0.434363365922883,13175,0.484887988668594,13144,-0.0505246227457113,31
"15660","4331244",0.392889035222343,14510,0.442477613546784,14648,-0.0495885783244409,-138
"15661","1431244",0.501764249259579,10180,0.529426802541091,11030,-0.0276625532815119,-850
"15662","2431244",0.43854107675139,12992,0.473052317900268,13645,-0.0345112411488775,-653
"15663","3431244",0.395426867937887,14433,0.444258484700488,14595,-0.0488316167626015,-162
"15664","4431244",0.353952537237347,15363,0.401848109578678,15570,-0.0478955723413311,-207
"15665","1141244",0.573604430659518,6501,0.612012658661117,6393,-0.038408228001599,108
"15666","2141244",0.510381258151329,9744,0.555638174020294,9595,-0.0452569158689646,149
"15667","3141244",0.467267049337825,11802,0.526844340820514,11152,-0.0595772914826886,650
"15668","4141244",0.425792718637286,13482,0.484433965698704,13165,-0.0586412470614181,317
"15669","1241244",0.519646653066522,9244,0.556708379715411,9527,-0.0370617266488888,-283
"15670","2241244",0.456423480558333,12281,0.500333895074587,12477,-0.0439104145162544,-196
"15671","3241244",0.413309271744829,13892,0.471540061874808,13704,-0.0582307901299784,188
"15672","4241244",0.371834941044289,15010,0.429129686752998,14998,-0.0572947457087081,12
"15673","1341244",0.491667182789746,10659,0.529657812382113,11019,-0.0379906295923671,-360
"15674","2341244",0.428444010281557,13388,0.473283327741289,13634,-0.0448393174597326,-246
"15675","3341244",0.385329801468053,14701,0.44448949454151,14586,-0.0591596930734567,115
"15676","4341244",0.343855470767513,15532,0.4020791194197,15565,-0.0582236486521863,-33
"15677","1441244",0.45273068480475,12435,0.489028308414007,12978,-0.0362976236092572,-543
"15678","2441244",0.389507512296561,14599,0.432653823773184,14910,-0.043146311476623,-311
"15679","3441244",0.346393303483057,15485,0.403859990573404,15524,-0.057466687090347,-39
"15680","4441244",0.304918972782517,15997,0.361449615451594,16056,-0.0565306426690766,-59
"15681","1112244",0.700864876384178,1675,0.713126575364984,1981,-0.0122616989808064,-306
"15682","2112244",0.637641703875989,3650,0.656752090724161,4114,-0.019110386848172,-464
"15683","3112244",0.594527495062486,5491,0.627958257524382,5509,-0.033430762461896,-18
"15684","4112244",0.553053164361946,7540,0.585547882402571,7859,-0.0324947180406255,-319
"15685","1212244",0.646907098791182,3304,0.657822296419278,4061,-0.0109151976280962,-757
"15686","2212244",0.583683926282993,6014,0.601447811778455,6965,-0.0177638854954618,-951
"15687","3212244",0.54056971746949,8205,0.572653978578676,8612,-0.0320842611091858,-407
"15688","4212244",0.49909538676895,10317,0.530243603456865,10992,-0.0311482166879156,-675
"15689","1312244",0.618927628514406,4386,0.63077172908598,5371,-0.0118441005715745,-985
"15690","2312244",0.555704456006217,7416,0.574397244445157,8526,-0.0186927884389401,-1110
"15691","3312244",0.512590247192714,9644,0.545603411245378,10137,-0.0330131640526641,-493
"15692","4312244",0.471115916492173,11646,0.503193036123567,12339,-0.0320771196313938,-693
"15693","1412244",0.57999113052941,6205,0.590142225117875,7596,-0.0101510945884646,-1391
"15694","2412244",0.516767958021221,9423,0.533767740477051,10806,-0.0169997824558303,-1383
"15695","3412244",0.473653749207718,11539,0.504973907277272,12248,-0.0313201580695543,-709
"15696","4412244",0.432179418507177,13260,0.462563532155461,13996,-0.030384113648284,-736
"15697","1122244",0.632885605517758,3812,0.652557263707578,4300,-0.0196716581898196,-488
"15698","2122244",0.569662433009569,6710,0.596182779066754,7281,-0.0265203460571852,-571
"15699","3122244",0.526548224196066,8928,0.567388945866975,8917,-0.0408407216709092,11
"15700","4122244",0.485073893495526,10992,0.524978570745165,11249,-0.0399046772496388,-257
"15701","1222244",0.578927827924762,6261,0.597252984761871,7221,-0.0183251568371094,-960
"15702","2222244",0.515704655416573,9482,0.540878500121048,10429,-0.025173844704475,-947
"15703","3222244",0.47259044660307,11588,0.512084666921269,11926,-0.039494220318199,-338
"15704","4222244",0.43111611590253,13302,0.469674291799458,13775,-0.0385581758969287,-473
"15705","1322244",0.550948357647986,7658,0.570202417428574,8767,-0.0192540597805877,-1109
"15706","2322244",0.487725185139797,10870,0.51382793278775,11840,-0.0261027476479533,-970
"15707","3322244",0.444610976326294,12772,0.485034099587971,13137,-0.0404231232616772,-365
"15708","4322244",0.403136645625753,14211,0.44262372446616,14644,-0.039487078840407,-433
"15709","1422244",0.51201185966299,9673,0.529572913460468,11026,-0.0175610537974779,-1353
"15710","2422244",0.448788687154801,12603,0.473198428819645,13639,-0.0244097416648435,-1036
"15711","3422244",0.405674478341298,14145,0.444404595619865,14589,-0.0387301172785675,-444
"15712","4422244",0.364200147640758,15178,0.401994220498055,15568,-0.0377940728572972,-390
"15713","1132244",0.589553083352659,5706,0.614092171259549,6264,-0.0245390879068903,-558
"15714","2132244",0.52632991084447,8941,0.557717686618726,9462,-0.0313877757742559,-521
"15715","3132244",0.483215702030966,11087,0.528923853418946,11056,-0.0457081513879799,31
"15716","4132244",0.441741371330426,12872,0.486513478297136,13074,-0.0447721069667096,-202
"15717","1232244",0.535595305759662,8436,0.558787892313843,9408,-0.0231925865541803,-972
"15718","2232244",0.472372133251473,11596,0.502413407673019,12373,-0.0300412744215459,-777
"15719","3232244",0.42925792443797,13368,0.47361957447324,13619,-0.0443616500352699,-251
"15720","4232244",0.38778359373743,14640,0.43120919935143,14955,-0.0434256056139994,-315
"15721","1332244",0.507615835482886,9872,0.531737324980545,10902,-0.0241214894976586,-1030
"15722","2332244",0.444392662974697,12780,0.475362840339721,13535,-0.0309701773650241,-755
"15723","3332244",0.401278454161194,14272,0.446569007139942,14527,-0.0452905529787481,-255
"15724","4332244",0.359804123460654,15263,0.404158632018132,15517,-0.0443545085574777,-254
"15725","1432244",0.46867933749789,11751,0.491107821012439,12886,-0.0224284835145487,-1135
"15726","2432244",0.405456164989701,14151,0.434733336371616,14848,-0.0292771713819144,-697
"15727","3432244",0.362341956176198,15221,0.405939503171836,15485,-0.0435975469956383,-264
"15728","4432244",0.320867625475658,15835,0.363529128050026,16034,-0.042661502574368,-199
"15729","1142244",0.540519518897829,8208,0.573693677132465,8560,-0.0331741582346359,-352
"15730","2142244",0.47729634638964,11357,0.517319192491641,11648,-0.0400228461020015,-291
"15731","3142244",0.434182137576137,13179,0.488525359291862,12997,-0.0543432217157254,182
"15732","4142244",0.392707806875597,14514,0.446114984170052,14538,-0.053407177294455,-24
"15733","1242244",0.486561741304833,10929,0.518389398186759,11591,-0.0318276568819257,-662
"15734","2242244",0.423338568796644,13566,0.462014913545935,14013,-0.0386763447492912,-447
"15735","3242244",0.38022435998314,14833,0.433221080346156,14886,-0.0529967203630153,-53
"15736","4242244",0.3387500292826,15619,0.390810705224345,15721,-0.0520606759417449,-102
"15737","1342244",0.458582271028057,12211,0.491338830853461,12871,-0.0327565598254039,-660
"15738","2342244",0.395359098519868,14434,0.434964346212637,14843,-0.0396052476927695,-409
"15739","3342244",0.352244889706364,15401,0.406170513012858,15480,-0.0539256233064935,-79
"15740","4342244",0.310770559005824,15948,0.363760137891047,16029,-0.0529895788852232,-81
"15741","1442244",0.419645773043061,13710,0.450709326885355,14391,-0.031063553842294,-681
"15742","2442244",0.356422600534872,15321,0.394334842244532,15667,-0.0379122417096598,-346
"15743","3442244",0.313308391721368,15923,0.365541009044752,16011,-0.0522326173233838,-88
"15744","4442244",0.271834061020828,16212,0.323130633922942,16268,-0.0512965729021134,-56
"15745","1113244",0.661981700811692,2758,0.687629984975745,2826,-0.0256482841640531,-68
"15746","2113244",0.598758528303504,5285,0.631255500334922,5347,-0.0324969720314187,-62
"15747","3113244",0.55564431949,7420,0.602461667135143,6903,-0.0468173476451427,517
"15748","4113244",0.51416998878946,9558,0.560051292013332,9329,-0.0458813032238722,229
"15749","1213244",0.608023923218696,4891,0.632325706030039,5298,-0.0243017828113429,-407
"15750","2213244",0.544800750710507,7971,0.575951221389216,8429,-0.0311504706787085,-458
"15751","3213244",0.501686541897004,10186,0.547157388189436,10046,-0.0454708462924325,140
"15752","4213244",0.460212211196464,12129,0.504747013067626,12258,-0.0445348018711622,-129
"15753","1313244",0.58004445294192,6202,0.605275138696741,6756,-0.0252306857548211,-554
"15754","2313244",0.516821280433731,9418,0.548900654055918,9957,-0.0320793736221867,-539
"15755","3313244",0.473707071620228,11538,0.520106820856139,11489,-0.0463997492359107,49
"15756","4313244",0.432232740919688,13258,0.477696445734328,13437,-0.0454637048146404,-179
"15757","1413244",0.541107954956924,8169,0.564645634728635,9061,-0.0235376797717113,-892
"15758","2413244",0.477884782448735,11325,0.508271150087812,12097,-0.030386367639077,-772
"15759","3413244",0.434770573635232,13155,0.479477316888033,13354,-0.0447067432528009,-199
"15760","4413244",0.393296242934692,14494,0.437066941766222,14783,-0.0437706988315306,-289
"15761","1123244",0.594002429945272,5511,0.627060673318339,5559,-0.0330582433730663,-48
"15762","2123244",0.530779257437084,8694,0.570686188677515,8744,-0.0399069312404319,-50
"15763","3123244",0.48766504862358,10872,0.541892355477736,10361,-0.0542273068541559,511
"15764","4123244",0.44619071792304,12709,0.499481980355926,12525,-0.0532912624328853,184
"15765","1223244",0.540044652352276,8228,0.571756394372632,8672,-0.0317117420203561,-444
"15766","2223244",0.476821479844088,11381,0.515381909731809,11756,-0.0385604298877217,-375
"15767","3223244",0.433707271030584,13201,0.48658807653203,13070,-0.0528808055014456,131
"15768","4223244",0.392232940330044,14529,0.444177701410219,14599,-0.0519447610801753,-70
"15769","1323244",0.5120651820755,9670,0.544705827039335,10193,-0.0326406449638343,-523
"15770","2323244",0.448842009567311,12601,0.488331342398511,13008,-0.0394893328311999,-407
"15771","3323244",0.405727800753808,14144,0.459537509198732,14100,-0.0538097084449239,44
"15772","4323244",0.364253470053268,15177,0.417127134076921,15256,-0.0528736640236536,-79
"15773","1423244",0.473128684090504,11561,0.504076323071229,12296,-0.0309476389807245,-735
"15774","2423244",0.409905511582315,14001,0.447701838430406,14495,-0.0377963268480901,-494
"15775","3423244",0.366791302768812,15126,0.418908005230626,15220,-0.0521167024618141,-94
"15776","4423244",0.325316972068272,15785,0.376497630108816,15904,-0.0511806580405438,-119
"15777","1133244",0.550669907780173,7668,0.58859558087031,7684,-0.0379256730901369,-16
"15778","2133244",0.487446735271984,10885,0.532221096229487,10881,-0.0447743609575025,4
"15779","3133244",0.444332526458481,12784,0.503427263029707,12325,-0.0590947365712265,459
"15780","4133244",0.40285819575794,14218,0.461016887907897,14051,-0.0581586921499562,167
"15781","1233244",0.496712130187177,10420,0.533291301924604,10829,-0.036579171737427,-409
"15782","2233244",0.433488957678988,13211,0.47691681728378,13473,-0.0434278596047925,-262
"15783","3233244",0.390374748865484,14580,0.448122984084001,14475,-0.0577482352185165,105
"15784","4233244",0.348900418164944,15454,0.40571260896219,15488,-0.056812190797246,-34
"15785","1333244",0.4687326599104,11748,0.506240734591306,12196,-0.0375080746809052,-448
"15786","2333244",0.405509487402212,14149,0.449866249950482,14422,-0.0443567625482708,-273
"15787","3333244",0.362395278588708,15219,0.421072416750703,15171,-0.0586771381619947,48
"15788","4333244",0.320920947888168,15834,0.378662041628893,15880,-0.0577410937407242,-46
"15789","1433244",0.429796161925404,13351,0.4656112306232,13905,-0.0358150686977953,-554
"15790","2433244",0.366572989417216,15136,0.409236745982377,15420,-0.042663756565161,-284
"15791","3433244",0.323458780603712,15808,0.380442912782597,15857,-0.056984132178885,-49
"15792","4433244",0.281984449903172,16156,0.338032537660787,16206,-0.0560480877576145,-50
"15793","1143244",0.501636343325343,10191,0.548197086743226,9999,-0.0465607434178825,192
"15794","2143244",0.438413170817154,12997,0.491822602102402,12854,-0.0534094312852481,143
"15795","3143244",0.395298962003651,14437,0.463028768902623,13975,-0.067729806898972,462
"15796","4143244",0.353824631303111,15365,0.420618393780813,15188,-0.0667937624777015,177
"15797","1243244",0.447678565732347,12650,0.49289280779752,12807,-0.0452142420651723,-157
"15798","2243244",0.384455393224158,14718,0.436518323156696,14799,-0.0520629299325378,-81
"15799","3243244",0.341341184410655,15573,0.407724489956917,15449,-0.0663833055462618,124
"15800","4243244",0.299866853710115,16040,0.365314114835106,16014,-0.0654472611249916,26
"15801","1343244",0.419699095455571,13707,0.465842240464222,13895,-0.0461431450086505,-188
"15802","2343244",0.356475922947382,15319,0.409467755823398,15415,-0.0529918328760161,-96
"15803","3343244",0.313361714133879,15922,0.380673922623619,15849,-0.0673122084897401,73
"15804","4343244",0.271887383433339,16211,0.338263547501808,16205,-0.0663761640684698,6
"15805","1443244",0.380762597470575,14818,0.425212736496116,15082,-0.0444501390255406,-264
"15806","2443244",0.317539424962386,15866,0.368838251855293,15982,-0.0512988268929063,-116
"15807","3443244",0.274425216148883,16196,0.340044418655513,16193,-0.0656192025066303,3
"15808","4443244",0.232950885448343,16325,0.297634043533703,16334,-0.06468315808536,-9
"15809","1114244",0.609774628841123,4807,0.64297937160209,4761,-0.0332047427609669,46
"15810","2114244",0.546551456332934,7868,0.586604886961266,7801,-0.0400534306283324,67
"15811","3114244",0.50343724751943,10095,0.557811053761487,9455,-0.0543738062420565,640
"15812","4114244",0.46196291681889,12050,0.515400678639677,11753,-0.0534377618207862,297
"15813","1214244",0.555816851248127,7407,0.587675092656383,7726,-0.0318582414082569,-319
"15814","2214244",0.492593678739938,10613,0.53130060801556,10924,-0.0387069292756225,-311
"15815","3214244",0.449479469926434,12571,0.502506774815781,12367,-0.0530273048893465,204
"15816","4214244",0.408005139225894,14063,0.46009639969397,14081,-0.0520912604680759,-18
"15817","1314244",0.52783738097135,8852,0.560624525323085,9289,-0.0327871443517351,-437
"15818","2314244",0.464614208463161,11927,0.504250040682262,12285,-0.0396358322191007,-358
"15819","3314244",0.421499999649658,13632,0.475456207482483,13532,-0.0539562078328247,100
"15820","4314244",0.380025668949118,14839,0.433045832360672,14893,-0.0530201634115542,-54
"15821","1414244",0.488900882986354,10804,0.51999502135498,11496,-0.0310941383686253,-692
"15822","2414244",0.425677710478165,13486,0.463620536714156,13958,-0.0379428262359909,-472
"15823","3414244",0.382563501664662,14770,0.434826703514377,14847,-0.0522632018497149,-77
"15824","4414244",0.341089170964122,15580,0.392416328392567,15691,-0.0513271574284445,-111
"15825","1124244",0.541795357974703,8133,0.582410059944683,8060,-0.0406147019699801,73
"15826","2124244",0.478572185466514,11293,0.52603557530386,11201,-0.0474633898373457,92
"15827","3124244",0.43545797665301,13124,0.49724174210408,12613,-0.0617837654510696,511
"15828","4124244",0.39398364595247,14478,0.45483136698227,14260,-0.0608477210297993,218
"15829","1224244",0.487837580381707,10863,0.527105780998977,11138,-0.0392682006172701,-275
"15830","2224244",0.424614407873518,13522,0.470731296358153,13734,-0.0461168884846356,-212
"15831","3224244",0.381500199060014,14794,0.441937463158374,14662,-0.0604372640983596,132
"15832","4224244",0.340025868359474,15593,0.399527088036564,15593,-0.0595012196770892,0
"15833","1324244",0.45985811010493,12148,0.500055213665679,12496,-0.0401971035607483,-348
"15834","2324244",0.396634937596742,14397,0.443680729024855,14614,-0.0470457914281138,-217
"15835","3324244",0.353520728783238,15375,0.414886895825076,15303,-0.0613661670418378,72
"15836","4324244",0.312046398082698,15931,0.372476520703266,15953,-0.0604301226205675,-22
"15837","1424244",0.420921612119934,13653,0.459425709697573,14106,-0.0385040975776385,-453
"15838","2424244",0.357698439611746,15298,0.40305122505675,15540,-0.0453527854450041,-242
"15839","3424244",0.314584230798242,15901,0.37425739185697,15931,-0.0596731610587281,-30
"15840","4424244",0.273109900097702,16202,0.33184701673516,16238,-0.0587371166374577,-36
"15841","1134244",0.498462835809603,10336,0.543944967496654,10239,-0.045482131687051,97
"15842","2134244",0.435239663301414,13135,0.487570482855831,13031,-0.0523308195544165,104
"15843","3134244",0.392125454487911,14534,0.458776649656051,14126,-0.0666511951681404,408
"15844","4134244",0.350651123787371,15426,0.416366274534241,15273,-0.0657151507468701,153
"15845","1234244",0.444505058216607,12775,0.488640688550948,12993,-0.0441356303343407,-218
"15846","2234244",0.381281885708418,14800,0.432266203910124,14922,-0.0509843182017063,-122
"15847","3234244",0.338167676894915,15627,0.403472370710345,15530,-0.0653046938154304,97
"15848","4234244",0.296693346194375,16058,0.361061995588535,16059,-0.06436864939416,-1
"15849","1334244",0.416525587939831,13794,0.46159012121765,14028,-0.045064533277819,-234
"15850","2334244",0.353302415431642,15378,0.405215636576827,15499,-0.0519132211451846,-121
"15851","3334244",0.310188206618138,15954,0.376421803377047,15906,-0.0662335967589086,48
"15852","4334244",0.268713875917598,16223,0.334011428255237,16228,-0.0652975523376382,-5
"15853","1434244",0.377589089954835,14894,0.420960617249544,15175,-0.0433715272947092,-281
"15854","2434244",0.314365917446646,15906,0.364586132608721,16023,-0.0502202151620749,-117
"15855","3434244",0.271251708633142,16215,0.335792299408941,16217,-0.0645405907757989,-2
"15856","4434244",0.229777377932602,16331,0.293381924287131,16341,-0.0636045463545286,-10
"15857","1144244",0.449429271354774,12576,0.50354647336957,12318,-0.0541172020147963,258
"15858","2144244",0.386206098846585,14673,0.447171988728747,14511,-0.0609658898821619,162
"15859","3144244",0.343091890033081,15543,0.418378155528967,15231,-0.0752862654958859,312
"15860","4144244",0.301617559332541,16022,0.375967780407157,15913,-0.0743502210746155,109
"15861","1244244",0.395471493761777,14430,0.448242194423864,14470,-0.0527707006620862,-40
"15862","2244244",0.332248321253589,15697,0.39186770978304,15704,-0.0596193885294518,-7
"15863","3244244",0.289134112440085,16107,0.363073876583261,16039,-0.0739397641431758,68
"15864","4244244",0.247659781739545,16294,0.320663501461451,16276,-0.0730037197219054,18
"15865","1344244",0.367492023485001,15111,0.421191627090566,15165,-0.0536996036055645,-54
"15866","2344244",0.304268850976812,16001,0.364817142449742,16022,-0.0605482914729301,-21
"15867","3344244",0.261154642163309,16249,0.336023309249963,16215,-0.0748686670866541,34
"15868","4344244",0.219680311462769,16348,0.293612934128153,16340,-0.0739326226653838,8
"15869","1444244",0.328555525500005,15749,0.38056212312246,15853,-0.0520065976224546,-104
"15870","2444244",0.265332352991816,16234,0.324187638481637,16263,-0.0588552854898203,-29
"15871","3444244",0.222218144178313,16342,0.295393805281857,16336,-0.0731756611035444,6
"15872","4444244",0.180743813477773,16376,0.252983430160047,16375,-0.072239616682274,1
"15873","1111344",0.711495809140559,1436,0.733395566965962,1455,-0.021899757825403,-19
"15874","2111344",0.64827263663237,3256,0.677021082325139,3248,-0.0287484456927686,8
"15875","3111344",0.605158427818867,5001,0.648227249125359,4489,-0.0430688213064926,512
"15876","4111344",0.563684097118327,6973,0.605816874003549,6713,-0.0421327768852223,260
"15877","1211344",0.657538031547563,2902,0.678091288020256,3201,-0.020553256472693,-299
"15878","2211344",0.594314859039374,5500,0.621716803379432,5843,-0.0274019443400586,-343
"15879","3211344",0.55120065022587,7644,0.592922970179653,7458,-0.0417223199537826,186
"15880","4211344",0.509726319525331,9766,0.550512595057843,9866,-0.0407862755325121,-100
"15881","1311344",0.629558561270787,3931,0.651040720686958,4366,-0.0214821594161713,-435
"15882","2311344",0.566335388762598,6869,0.594666236046135,7360,-0.0283308472835369,-491
"15883","3311344",0.523221179949094,9077,0.565872402846355,8994,-0.0426512228972609,83
"15884","4311344",0.481746849248554,11146,0.523462027724545,11324,-0.0417151784759904,-178
"15885","1411344",0.590622063285791,5655,0.610411216718852,6462,-0.0197891534330614,-807
"15886","2411344",0.527398890777602,8879,0.554036732078029,9678,-0.0266378413004271,-799
"15887","3411344",0.484284681964098,11028,0.525242898878249,11234,-0.0409582169141511,-206
"15888","4411344",0.442810351263558,12838,0.482832523756439,13220,-0.0400221724928806,-382
"15889","1121344",0.643516538274139,3414,0.672826255308555,3400,-0.0293097170344162,14
"15890","2121344",0.58029336576595,6189,0.616451770667732,6145,-0.0361584049017818,44
"15891","3121344",0.537179156952447,8362,0.587657937467952,7728,-0.0504787805155058,634
"15892","4121344",0.495704826251907,10462,0.545247562346142,10158,-0.0495427360942355,304
"15893","1221344",0.589558760681143,5705,0.617521976362849,6072,-0.0279632156817062,-367
"15894","2221344",0.526335588172954,8939,0.561147491722026,9257,-0.0348119035490718,-318
"15895","3221344",0.48322137935945,11086,0.532353658522246,10875,-0.0491322791627958,211
"15896","4221344",0.441747048658911,12871,0.489943283400436,12936,-0.0481962347415253,-65
"15897","1321344",0.561579290404367,7084,0.590471409029551,7574,-0.0288921186251845,-490
"15898","2321344",0.498356117896178,10341,0.534096924388728,10788,-0.0357408064925501,-447
"15899","3321344",0.455241909082674,12328,0.505303091188948,12234,-0.0500611821062741,94
"15900","4321344",0.413767578382134,13877,0.462892716067138,13981,-0.0491251376850035,-104
"15901","1421344",0.522642792419371,9113,0.549841905061445,9898,-0.0271991126420746,-785
"15902","2421344",0.459419619911182,12168,0.493467420420622,12777,-0.0340478005094403,-609
"15903","3421344",0.416305411097678,13803,0.464673587220843,13929,-0.0483681761231643,-126
"15904","4421344",0.374831080397138,14946,0.422263212099032,15140,-0.0474321317018938,-194
"15905","1131344",0.600184016109039,5226,0.634361162860526,5216,-0.0341771467514871,10
"15906","2131344",0.53696084360085,8373,0.577986678219703,8321,-0.0410258346188527,52
"15907","3131344",0.493846634787347,10553,0.549192845019924,9941,-0.0553462102325767,612
"15908","4131344",0.452372304086807,12450,0.506782469898113,12172,-0.0544101658113062,278
"15909","1231344",0.546226238516043,7889,0.57905688391482,8255,-0.0328306453987769,-366
"15910","2231344",0.483003066007854,11095,0.522682399273997,11362,-0.0396793332661425,-267
"15911","3231344",0.439888857194351,12948,0.493888566074217,12761,-0.0539997088798664,187
"15912","4231344",0.398414526493811,14339,0.451478190952407,14364,-0.0530636644585961,-25
"15913","1331344",0.518246768239267,9335,0.552006316581522,9793,-0.0337595483422551,-458
"15914","2331344",0.455023595731078,12340,0.495631831940699,12684,-0.0406082362096207,-344
"15915","3331344",0.411909386917575,13943,0.466837998740919,13853,-0.0549286118233447,90
"15916","4331344",0.370435056217035,15042,0.424427623619109,15098,-0.0539925674020744,-56
"15917","1431344",0.479310270254271,11254,0.511376812613416,11967,-0.0320665423591453,-713
"15918","2431344",0.416087097746082,13813,0.455002327972593,14246,-0.0389152302265109,-433
"15919","3431344",0.372972888932579,14988,0.426208494772814,15054,-0.0532356058402349,-66
"15920","4431344",0.331498558232039,15711,0.383798119651003,15809,-0.0522995614189646,-98
"15921","1141344",0.55115045165421,7650,0.593962668733442,7406,-0.0428122170792324,244
"15922","2141344",0.487927279146021,10859,0.537588184092619,10604,-0.049660904946598,255
"15923","3141344",0.444813070332517,12765,0.50879435089284,12075,-0.063981280560322,690
"15924","4141344",0.403338739631977,14208,0.466383975771029,13872,-0.0630452361390517,336
"15925","1241344",0.497192674061214,10404,0.538658389787736,10537,-0.0414657157265225,-133
"15926","2241344",0.433969501553025,13186,0.482283905146913,13242,-0.048314403593888,-56
"15927","3241344",0.390855292739521,14568,0.453490071947133,14301,-0.062634779207612,267
"15928","4241344",0.349380962038981,15448,0.411079696825323,15380,-0.0616987347863415,68
"15929","1341344",0.469213203784437,11732,0.511607822454438,11951,-0.0423946186700007,-219
"15930","2341344",0.405990031276249,14131,0.455233337813615,14238,-0.0492433065373662,-107
"15931","3341344",0.362875822462745,15210,0.426439504613835,15048,-0.0635636821510902,162
"15932","4341344",0.321401491762205,15831,0.384029129492025,15806,-0.0626276377298197,25
"15933","1441344",0.430276705799441,13334,0.470978318486332,13724,-0.0407016126868908,-390
"15934","2441344",0.367053533291253,15122,0.414603833845509,15311,-0.0475503005542565,-189
"15935","3441344",0.323939324477749,15803,0.38581000064573,15784,-0.0618706761679805,19
"15936","4441344",0.282464993777209,16154,0.343399625523919,16175,-0.06093463174671,-21
"15937","1112344",0.67841089737887,2275,0.69507658543731,2574,-0.0166656880584398,-299
"15938","2112344",0.615187724870681,4547,0.638702100796487,5002,-0.0235143759258054,-455
"15939","3112344",0.572073516057178,6585,0.609908267596707,6492,-0.0378347515395294,93
"15940","4112344",0.530599185356638,8703,0.567497892474897,8912,-0.0368987071182592,-209
"15941","1212344",0.624453119785874,4159,0.639772306491604,4928,-0.0153191867057298,-769
"15942","2212344",0.561229947277685,7108,0.58339782185078,7984,-0.0221678745730954,-876
"15943","3212344",0.518115738464181,9343,0.554603988651001,9644,-0.0364882501868194,-301
"15944","4212344",0.476641407763642,11393,0.512193613529191,11921,-0.035552205765549,-528
"15945","1312344",0.596473649509098,5391,0.612721739158306,6348,-0.0162480896492081,-957
"15946","2312344",0.533250477000909,8562,0.556347254517482,9550,-0.0230967775165737,-988
"15947","3312344",0.490136268187405,10737,0.527553421317703,11119,-0.0374171531302977,-382
"15948","4312344",0.448661937486865,12611,0.485143046195893,13135,-0.0364811087090272,-524
"15949","1412344",0.557537151524102,7301,0.5720922351902,8649,-0.0145550836660983,-1348
"15950","2412344",0.494313979015913,10530,0.515717750549377,11734,-0.021403771533464,-1204
"15951","3412344",0.451199770202409,12495,0.486923917349597,13054,-0.0357241471471879,-559
"15952","4412344",0.409725439501869,14007,0.444513542227787,14585,-0.0347881027259174,-578
"15953","1122344",0.61043162651245,4774,0.634507273779903,5206,-0.024075647267453,-432
"15954","2122344",0.547208454004261,7837,0.57813278913908,8312,-0.0309243351348186,-475
"15955","3122344",0.504094245190758,10056,0.5493389559393,9930,-0.0452447107485426,126
"15956","4122344",0.462619914490218,12013,0.50692858081749,12166,-0.0443086663272724,-153
"15957","1222344",0.556473848919454,7372,0.579202994834197,8241,-0.0227291459147431,-869
"15958","2222344",0.493250676411265,10584,0.522828510193374,11355,-0.0295778337821087,-771
"15959","3222344",0.450136467597761,12538,0.494034676993594,12754,-0.0438982093958326,-216
"15960","4222344",0.408662136897222,14038,0.451624301871784,14358,-0.0429621649745621,-320
"15961","1322344",0.528494378642678,8810,0.552152427500899,9788,-0.0236580488582213,-978
"15962","2322344",0.465271206134489,11888,0.495777942860076,12680,-0.0305067367255868,-792
"15963","3322344",0.422156997320985,13605,0.466984109660296,13849,-0.0448271123393109,-244
"15964","4322344",0.380682666620446,14819,0.424573734538486,15095,-0.0438910679180403,-276
"15965","1422344",0.489557880657682,10765,0.511522923532793,11957,-0.0219650428751115,-1192
"15966","2422344",0.426334708149493,13458,0.45514843889197,14242,-0.0288137307424771,-784
"15967","3422344",0.383220499335989,14751,0.42635460569219,15051,-0.0431341063562011,-300
"15968","4422344",0.34174616863545,15564,0.38394423057038,15807,-0.0421980619349306,-243
"15969","1132344",0.56709910434735,6839,0.596042181331874,7291,-0.0289430769845239,-452
"15970","2132344",0.503875931839161,10072,0.539667696691051,10489,-0.0357917648518895,-417
"15971","3132344",0.460761723025658,12105,0.510873863491272,11991,-0.0501121404656135,114
"15972","4132344",0.419287392325118,13720,0.468463488369461,13811,-0.049176096044343,-91
"15973","1232344",0.513141326754354,9614,0.540737902386168,10437,-0.0275965756318137,-823
"15974","2232344",0.449918154246165,12549,0.484363417745345,13169,-0.0344452634991793,-620
"15975","3232344",0.406803945432662,14105,0.455569584545565,14227,-0.0487656391129033,-122
"15976","4232344",0.365329614732122,15160,0.413159209423755,15347,-0.047829594691633,-187
"15977","1332344",0.485161856477578,10988,0.51368733505287,11845,-0.028525478575292,-857
"15978","2332344",0.421938683969389,13616,0.457312850412047,14167,-0.0353741664426575,-551
"15979","3332344",0.378824475155886,14861,0.428519017212267,15013,-0.0496945420563815,-152
"15980","4332344",0.337350144455346,15637,0.386108642090457,15779,-0.0487584976351112,-142
"15981","1432344",0.446225358492582,12705,0.473057831084764,13643,-0.0268324725921821,-938
"15982","2432344",0.383002185984393,14758,0.416683346443941,15266,-0.0336811604595477,-508
"15983","3432344",0.33988797717089,15598,0.387889513244162,15758,-0.0480015360732717,-160
"15984","4432344",0.29841364647035,16052,0.345479138122351,16164,-0.0470654916520015,-112
"15985","1142344",0.518065539892521,9347,0.55564368720479,9593,-0.0375781473122693,-246
"15986","2142344",0.454842367384332,12351,0.499269202563967,12531,-0.0444268351796348,-180
"15987","3142344",0.411728158570829,13949,0.470475369364187,13745,-0.0587472107933588,204
"15988","4142344",0.370253827870289,15047,0.428064994242377,15023,-0.0578111663720885,24
"15989","1242344",0.464107762299525,11951,0.500339408259084,12475,-0.0362316459595593,-524
"15990","2242344",0.400884589791336,14284,0.443964923618261,14604,-0.0430803338269248,-320
"15991","3242344",0.357770380977832,15297,0.415171090418481,15296,-0.0574007094406488,1
"15992","4242344",0.316296050277293,15886,0.372760715296671,15948,-0.0564646650193783,-62
"15993","1342344",0.436128292022748,13093,0.473288840925786,13632,-0.0371605489030375,-539
"15994","2342344",0.37290511951456,14990,0.416914356284963,15259,-0.044009236770403,-269
"15995","3342344",0.329790910701056,15729,0.388120523085183,15754,-0.058329612384127,-25
"15996","4342344",0.288316580000516,16115,0.345710147963373,16160,-0.0573935679628566,-45
"15997","1442344",0.397191794037753,14378,0.43265933695768,14908,-0.0354675429199276,-530
"15998","2442344",0.333968621529564,15681,0.376284852316857,15907,-0.0423162307872933,-226
"15999","3442344",0.29085441271606,16096,0.347491019117078,16147,-0.0566366064010173,-51
"16000","4442344",0.24938008201552,16289,0.305080643995267,16322,-0.0557005619797469,-33
"16001","1113344",0.639527721806384,3581,0.669579995048071,3535,-0.0300522732416865,46
"16002","2113344",0.576304549298196,6368,0.613205510407248,6312,-0.0369009611090521,56
"16003","3113344",0.533190340484692,8568,0.584411677207468,7924,-0.0512213367227761,644
"16004","4113344",0.491716009784152,10657,0.542001302085658,10355,-0.0502852923015056,302
"16005","1213344",0.585569944213388,5913,0.614275716102365,6252,-0.0287057718889763,-339
"16006","2213344",0.5223467717052,9127,0.557901231461541,9450,-0.0355544597563419,-323
"16007","3213344",0.479232562891696,11258,0.529107398261762,11049,-0.0498748353700659,209
"16008","4213344",0.437758232191156,13025,0.486697023139952,13066,-0.0489387909487956,-41
"16009","1313344",0.557590473936612,7294,0.587225148769067,7762,-0.0296346748324545,-468
"16010","2313344",0.494367301428423,10526,0.530850664128243,10948,-0.0364833626998201,-422
"16011","3313344",0.45125309261492,12492,0.502056830928464,12392,-0.0508037383135441,100
"16012","4313344",0.40977876191438,14004,0.459646455806654,14097,-0.0498676938922738,-93
"16013","1413344",0.518653975951616,9300,0.546595644800961,10077,-0.0279416688493447,-777
"16014","2413344",0.455430803443427,12319,0.490221160160138,12922,-0.0347903567167103,-603
"16015","3413344",0.412316594629924,13929,0.461427326960358,14036,-0.0491107323304343,-107
"16016","4413344",0.370842263929384,15034,0.419016951838548,15217,-0.048174687909164,-183
"16017","1123344",0.571548450939964,6605,0.609010683390664,6552,-0.0374622324506997,53
"16018","2123344",0.508325278431776,9837,0.552636198749841,9767,-0.0443109203180653,70
"16019","3123344",0.465211069618272,11894,0.523842365550061,11306,-0.0586312959317893,588
"16020","4123344",0.423736738917732,13554,0.481431990428251,13279,-0.0576952515105187,275
"16021","1223344",0.517590673346968,9373,0.553706404444958,9703,-0.0361157310979895,-330
"16022","2223344",0.45436750083878,12368,0.497331919804135,12609,-0.042964418965355,-241
"16023","3223344",0.411253292025276,13956,0.468538086604355,13807,-0.057284794579079,149
"16024","4223344",0.369778961324736,15053,0.426127711482545,15057,-0.0563487501578087,-4
"16025","1323344",0.489611203070192,10762,0.52665583711166,11162,-0.0370446340414677,-400
"16026","2323344",0.426388030562003,13455,0.470281352470837,13757,-0.0438933219088333,-302
"16027","3323344",0.3832738217485,14750,0.441487519271057,14670,-0.0582136975225572,80
"16028","4323344",0.34179949104796,15563,0.399077144149247,15598,-0.057277653101287,-35
"16029","1423344",0.450674705085196,12516,0.486026333143554,13093,-0.0353516280583578,-577
"16030","2423344",0.387451532577007,14647,0.429651848502731,14989,-0.0422003159257235,-342
"16031","3423344",0.344337323763504,15522,0.400858015302951,15579,-0.0565206915394475,-57
"16032","4423344",0.302862993062964,16012,0.358447640181141,16068,-0.0555846471181772,-56
"16033","1133344",0.528215928774865,8833,0.570545590942635,8752,-0.0423296621677703,81
"16034","2133344",0.464992756266676,11905,0.514171106301812,11820,-0.0491783500351359,85
"16035","3133344",0.421878547453173,13620,0.485377273102032,13126,-0.0634987256488599,494
"16036","4133344",0.380404216752633,14827,0.442966897980222,14636,-0.0625626812275896,191
"16037","1233344",0.474258151181869,11511,0.515241311996929,11761,-0.0409831608150604,-250
"16038","2233344",0.41103497867368,13964,0.458866827356106,14122,-0.0478318486824259,-158
"16039","3233344",0.367920769860176,15099,0.430072994156326,14975,-0.0621522242961499,124
"16040","4233344",0.326446439159637,15771,0.387662619034516,15760,-0.0612161798748794,11
"16041","1333344",0.446278680905092,12703,0.488190744663631,13012,-0.0419120637585386,-309
"16042","2333344",0.383055508396904,14756,0.431816260022808,14934,-0.0487607516259041,-178
"16043","3333344",0.3399412995834,15597,0.403022426823028,15541,-0.0630811272396281,56
"16044","4333344",0.29846696888286,16051,0.360612051701218,16061,-0.0621450828183576,-10
"16045","1433344",0.407342182920096,14087,0.447561240695525,14498,-0.0402190577754287,-411
"16046","2433344",0.344119010411908,15525,0.391186756054702,15714,-0.0470677456427944,-189
"16047","3433344",0.301004801598404,16028,0.362392922854923,16050,-0.0613881212565184,-22
"16048","4433344",0.259530470897864,16256,0.319982547733112,16280,-0.060452076835248,-24
"16049","1143344",0.479182364320035,11265,0.530147096815551,10997,-0.0509647324955159,268
"16050","2143344",0.415959191811846,13815,0.473772612174728,13610,-0.0578134203628815,205
"16051","3143344",0.372844982998343,14994,0.444978778974948,14574,-0.0721337959766054,420
"16052","4143344",0.331370652297803,15713,0.402568403853138,15556,-0.0711977515553349,157
"16053","1243344",0.425224586727039,13503,0.474842817869845,13559,-0.0496182311428057,-56
"16054","2243344",0.36200141421885,15226,0.418468333229022,15228,-0.0564669190101712,-2
"16055","3243344",0.318887205405347,15852,0.389674500029242,15735,-0.0707872946238952,117
"16056","4243344",0.277412874704807,16179,0.347264124907432,16151,-0.069851250202625,28
"16057","1343344",0.397245116450263,14375,0.447792250536547,14491,-0.0505471340862839,-116
"16058","2343344",0.334021943942074,15679,0.391417765895724,15712,-0.0573958219536495,-33
"16059","3343344",0.290907735128571,16095,0.362623932695944,16044,-0.0717161975673735,51
"16060","4343344",0.249433404428031,16288,0.320213557574134,16279,-0.0707801531461033,9
"16061","1443344",0.358308618465267,15286,0.407162746568441,15464,-0.048854128103174,-178
"16062","2443344",0.295085445957078,16071,0.350788261927618,16129,-0.0557028159705397,-58
"16063","3443344",0.251971237143575,16280,0.321994428727839,16274,-0.0700231915842638,6
"16064","4443344",0.210496906443035,16358,0.279584053606028,16360,-0.0690871471629935,-2
"16065","1114344",0.587320649835815,5812,0.624929381674415,5672,-0.0376087318386005,140
"16066","2114344",0.524097477327626,9042,0.568554897033592,8857,-0.0444574197059661,185
"16067","3114344",0.480983268514122,11184,0.539761063833812,10484,-0.0587777953196901,700
"16068","4114344",0.439508937813582,12961,0.497350688712002,12607,-0.0578417508984195,354
"16069","1214344",0.533362872242819,8547,0.569625102728709,8795,-0.0362622304858903,-248
"16070","2214344",0.47013969973463,11683,0.513250618087886,11868,-0.0431109183532559,-185
"16071","3214344",0.427025490921126,13435,0.484456784888106,13163,-0.0574312939669798,272
"16072","4214344",0.385551160220586,14689,0.442046409766296,14659,-0.0564952495457095,30
"16073","1314344",0.505383401966042,9980,0.542574535395411,10315,-0.0371911334293685,-335
"16074","2314344",0.442160229457853,12861,0.486200050754588,13086,-0.0440398212967341,-225
"16075","3314344",0.39904602064435,14322,0.457406217554808,14164,-0.0583601969104581,158
"16076","4314344",0.35757168994381,15302,0.414995842432998,15302,-0.0574241524891878,0
"16077","1414344",0.466446903981046,11836,0.501945031427305,12398,-0.0354981274462587,-562
"16078","2414344",0.403223731472858,14209,0.445570546786482,14552,-0.0423468153136243,-343
"16079","3414344",0.360109522659354,15256,0.416776713586702,15263,-0.0566671909273483,-7
"16080","4414344",0.318635191958814,15856,0.374366338464892,15929,-0.055731146506078,-73
"16081","1124344",0.519341378969395,9261,0.564360070017008,9081,-0.0450186910476137,180
"16082","2124344",0.456118206461206,12302,0.507985585376185,12117,-0.0518673789149793,185
"16083","3124344",0.413003997647702,13903,0.479191752176405,13368,-0.0661877545287032,535
"16084","4124344",0.371529666947162,15016,0.436781377054595,14798,-0.0652517101074327,218
"16085","1224344",0.465383601376399,11881,0.509055791071302,12061,-0.0436721896949035,-180
"16086","2224344",0.40216042886821,14243,0.452681306430479,14325,-0.050520877562269,-82
"16087","3224344",0.359046220054706,15273,0.423887473230699,15108,-0.064841253175993,165
"16088","4224344",0.317571889354166,15865,0.381477098108889,15838,-0.0639052087547227,27
"16089","1324344",0.437404131099622,13039,0.482005223738004,13252,-0.0446010926383817,-213
"16090","2324344",0.374180958591434,14959,0.425630739097181,15068,-0.0514497805057472,-109
"16091","3324344",0.33106674977793,15715,0.396836905897401,15632,-0.0657701561194712,83
"16092","4324344",0.28959241907739,16102,0.354426530775591,16096,-0.064834111698201,6
"16093","1424344",0.398467633114626,14335,0.441375719769898,14674,-0.0429080866552718,-339
"16094","2424344",0.335244460606438,15664,0.385001235129075,15794,-0.0497567745226375,-130
"16095","3424344",0.292130251792934,16089,0.356207401929296,16085,-0.0640771501363615,4
"16096","4424344",0.250655921092394,16282,0.313797026807485,16294,-0.0631411057150912,-12
"16097","1134344",0.476008856804295,11424,0.525894977568979,11207,-0.0498861207646843,217
"16098","2134344",0.412785684296106,13913,0.469520492928156,13778,-0.0567348086320499,135
"16099","3134344",0.369671475482603,15056,0.440726659728377,14692,-0.0710551842457738,364
"16100","4134344",0.328197144782063,15755,0.398316284606566,15613,-0.0701191398245036,142
"16101","1234344",0.422051079211299,13609,0.470590698623273,13740,-0.0485396194119743,-131
"16102","2234344",0.35882790670311,15277,0.41421621398245,15320,-0.0553883072793399,-43
"16103","3234344",0.315713697889607,15890,0.38542238078267,15786,-0.0697086828930639,104
"16104","4234344",0.274239367189067,16197,0.34301200566086,16177,-0.0687726384717934,20
"16105","1334344",0.394071608934523,14476,0.443540131289975,14618,-0.0494685223554525,-142
"16106","2334344",0.330848436426334,15717,0.387165646649152,15765,-0.0563172102228181,-48
"16107","3334344",0.28773422761283,16118,0.358371813449372,16069,-0.0706375858365421,49
"16108","4334344",0.24625989691229,16301,0.315961438327562,16288,-0.0697015414152717,13
"16109","1434344",0.355135110949527,15346,0.402910627321869,15546,-0.0477755163723427,-200
"16110","2434344",0.291911938441338,16090,0.346536142681046,16154,-0.0546242042397084,-64
"16111","3434344",0.248797729627834,16291,0.317742309481267,16284,-0.0689445798534323,7
"16112","4434344",0.207323398927294,16362,0.275331934359456,16363,-0.068008535432162,-1
"16113","1144344",0.426975292349465,13441,0.485496483441895,13121,-0.0585211910924299,320
"16114","2144344",0.363752119841277,15191,0.429121998801072,14999,-0.0653698789597954,192
"16115","3144344",0.320637911027773,15840,0.400328165601293,15585,-0.0796902545735194,255
"16116","4144344",0.279163580327233,16171,0.357917790479482,16076,-0.078754210152249,95
"16117","1244344",0.373017514756469,14985,0.430192204496189,14972,-0.0571746897397196,13
"16118","2244344",0.309794342248281,15959,0.373817719855366,15936,-0.0640233776070852,23
"16119","3244344",0.266680133434777,16230,0.345023886655586,16166,-0.0783437532208093,64
"16120","4244344",0.225205802734237,16337,0.302613511533776,16327,-0.0774077087995389,10
"16121","1344344",0.345038044479693,15510,0.403141637162891,15537,-0.0581035926831979,-27
"16122","2344344",0.281814871971504,16158,0.346767152522068,16153,-0.0649522805505635,5
"16123","3344344",0.238700663158001,16315,0.317973319322288,16283,-0.0792726561642875,32
"16124","4344344",0.197226332457461,16368,0.275562944200478,16362,-0.0783366117430172,6
"16125","1444344",0.306101546494697,15988,0.362512133194785,16047,-0.056410586700088,-59
"16126","2444344",0.242878373986508,16310,0.306137648553962,16319,-0.0632592745674538,-9
"16127","3444344",0.199764165173005,16366,0.277343815354183,16361,-0.0775796501811779,5
"16128","4444344",0.158289834472465,16382,0.234933440232372,16382,-0.0766436057599075,0
"16129","1111444",0.681703792128411,2179,0.699270427128847,2430,-0.0175666350004352,-251
"16130","2111444",0.618480619620223,4409,0.642895942488023,4766,-0.0244153228678008,-357
"16131","3111444",0.575366410806719,6408,0.614102109288244,6262,-0.0387356984815248,146
"16132","4111444",0.533892080106179,8514,0.571691734166434,8676,-0.0377996540602543,-162
"16133","1211444",0.627746014535415,4006,0.64396614818314,4699,-0.016220133647725,-693
"16134","2211444",0.564522842027227,6951,0.587591663542317,7733,-0.0230688215150906,-782
"16135","3211444",0.521408633213723,9177,0.558797830342538,9407,-0.0373891971288146,-230
"16136","4211444",0.479934302513183,11221,0.516387455220727,11696,-0.0364531527075443,-475
"16137","1311444",0.599766544258639,5240,0.616915580849843,6110,-0.0171490365912033,-870
"16138","2311444",0.53654337175045,8390,0.560541096209019,9293,-0.0239977244585688,-903
"16139","3311444",0.493429162936947,10570,0.53174726300924,10901,-0.0383181000722929,-331
"16140","4311444",0.451954832236407,12460,0.489336887887429,12961,-0.0373820556510225,-501
"16141","1411444",0.560830046273643,7128,0.576286076881737,8409,-0.0154560306080934,-1281
"16142","2411444",0.497606873765454,10384,0.519911592240914,11499,-0.0223047184754591,-1115
"16143","3411444",0.454492664951951,12362,0.491117759041134,12885,-0.0366250940891831,-523
"16144","4411444",0.413018334251411,13900,0.448707383919324,14456,-0.0356890496679128,-556
"16145","1121444",0.613724521261992,4628,0.63870111547144,5003,-0.0249765942094484,-375
"16146","2121444",0.550501348753803,7680,0.582326630830617,8063,-0.031825282076814,-383
"16147","3121444",0.507387139940299,9881,0.553532797630837,9713,-0.046145657690538,168
"16148","4121444",0.465912809239759,11863,0.511122422509027,11978,-0.0452096132692675,-115
"16149","1221444",0.559766743668995,7184,0.583396836525734,7985,-0.0236300928567382,-801
"16150","2221444",0.496543571160807,10425,0.52702235188491,11141,-0.0304787807241038,-716
"16151","3221444",0.453429362347303,12413,0.498228518685131,12571,-0.0447991563378278,-158
"16152","4221444",0.411955031646763,13939,0.455818143563321,14220,-0.0438631119165575,-281
"16153","1321444",0.531787273392219,8634,0.556346269192436,9551,-0.0245589958002165,-917
"16154","2321444",0.46856410088403,11753,0.499971784551612,12501,-0.031407683667582,-748
"16155","3321444",0.425449892070527,13493,0.471177951351833,13714,-0.045728059281306,-221
"16156","4321444",0.383975561369987,14731,0.428767576230023,15007,-0.0447920148600357,-276
"16157","1421444",0.492850775407223,10605,0.51571676522433,11735,-0.0228659898171066,-1130
"16158","2421444",0.429627602899034,13354,0.459342280583507,14109,-0.0297146776844723,-755
"16159","3421444",0.386513394085531,14667,0.430548447383727,14964,-0.0440350532981963,-297
"16160","4421444",0.345039063384991,15509,0.388138072261917,15752,-0.043099008876926,-243
"16161","1131444",0.570391999096892,6672,0.600236023023411,7046,-0.0298440239265191,-374
"16162","2131444",0.507168826588703,9895,0.543861538382588,10245,-0.0366927117938847,-350
"16163","3131444",0.4640546177752,11955,0.515067705182808,11773,-0.0510130874076087,182
"16164","4131444",0.42258028707466,13595,0.472657330060998,13660,-0.0500770429863384,-65
"16165","1231444",0.516434221503896,9442,0.544931744077705,10175,-0.0284975225738091,-733
"16166","2231444",0.453211048995707,12419,0.488557259436881,12995,-0.0353462104411746,-576
"16167","3231444",0.410096840182203,13994,0.459763426237102,14090,-0.0496665860548987,-96
"16168","4231444",0.368622509481663,15084,0.417353051115292,15251,-0.0487305416336282,-167
"16169","1331444",0.48845475122712,10834,0.517881176744407,11619,-0.0294264255172874,-785
"16170","2331444",0.425231578718931,13501,0.461506692103584,14031,-0.0362751133846529,-530
"16171","3331444",0.382117369905427,14780,0.432712858903804,14905,-0.0505954889983768,-125
"16172","4331444",0.340643039204887,15587,0.390302483781994,15727,-0.0496594445771065,-140
"16173","1431444",0.449518253242124,12569,0.477251672776301,13459,-0.0277334195341775,-890
"16174","2431444",0.386295080733935,14671,0.420877188135478,15177,-0.0345821074015431,-506
"16175","3431444",0.343180871920431,15541,0.392083354935698,15700,-0.0489024830152671,-159
"16176","4431444",0.301706541219891,16021,0.349672979813888,16138,-0.0479664385939967,-117
"16177","1141444",0.521358434642062,9181,0.559837528896327,9347,-0.0384790942542647,-166
"16178","2141444",0.458135262133873,12227,0.503463044255504,12322,-0.0453277821216302,-95
"16179","3141444",0.41502105332037,13847,0.474669211055724,13567,-0.0596481577353542,280
"16180","4141444",0.37354672261983,14975,0.432258835933914,14923,-0.0587121133140838,52
"16181","1241444",0.467400657049066,11797,0.504533249950621,12267,-0.0371325929015545,-470
"16182","2241444",0.404177484540877,14183,0.448158765309797,14473,-0.04398128076892,-290
"16183","3241444",0.361063275727374,15239,0.419364932110018,15212,-0.0583016563826441,27
"16184","4241444",0.319588945026834,15846,0.376954556988208,15901,-0.0573656119613737,-55
"16185","1341444",0.43942118677229,12965,0.477482682617323,13445,-0.0380614958450327,-480
"16186","2341444",0.376198014264101,14919,0.4211081979765,15169,-0.0449101837123983,-250
"16187","3341444",0.333083805450598,15690,0.39231436477672,15693,-0.0592305593261223,-3
"16188","4341444",0.291609474750058,16093,0.34990398965491,16135,-0.0582945149048519,-42
"16189","1441444",0.400484688787294,14290,0.436853178649217,14793,-0.0363684898619228,-503
"16190","2441444",0.337261516279105,15639,0.380478694008394,15855,-0.0432171777292886,-216
"16191","3441444",0.294147307465602,16076,0.351684860808614,16121,-0.0575375533430126,-45
"16192","4441444",0.252672976765062,16277,0.309274485686804,16314,-0.0566015089217421,-37
"16193","1112444",0.648618880366723,3241,0.660951445600195,3933,-0.012332565233472,-692
"16194","2112444",0.585395707858534,5933,0.604576960959371,6800,-0.0191812531008376,-867
"16195","3112444",0.54228149904503,8107,0.575783127759592,8441,-0.0335016287145616,-334
"16196","4112444",0.50080716834449,10223,0.533372752637781,10823,-0.0325655842932911,-600
"16197","1212444",0.594661102773727,5487,0.605647166654488,6725,-0.0109860638807618,-1238
"16198","2212444",0.531437930265538,8657,0.549272682013665,9935,-0.0178347517481274,-1278
"16199","3212444",0.488323721452034,10840,0.520478848813886,11470,-0.0321551273618514,-630
"16200","4212444",0.446849390751494,12689,0.478068473692075,13417,-0.0312190829405811,-728
"16201","1312444",0.56668163249695,6854,0.57859659932119,8281,-0.0119149668242401,-1427
"16202","2312444",0.503458459988761,10094,0.522222114680367,11388,-0.0187636546916057,-1294
"16203","3312444",0.460344251175258,12121,0.493428281480588,12782,-0.0330840303053296,-661
"16204","4312444",0.418869920474718,13730,0.451017906358777,14378,-0.0321479858840594,-648
"16205","1412444",0.527745134511954,8857,0.537967095353085,10580,-0.0102219608411303,-1723
"16206","2412444",0.464521962003765,11933,0.481592610712261,13271,-0.0170706487084959,-1338
"16207","3412444",0.421407753190262,13635,0.452798777512482,14319,-0.0313910243222199,-684
"16208","4412444",0.379933422489722,14843,0.410388402390672,15391,-0.0304549799009496,-548
"16209","1122444",0.580639609500303,6166,0.600382133942788,7038,-0.0197425244424853,-872
"16210","2122444",0.517416436992114,9386,0.544007649301965,10234,-0.0265912123098508,-848
"16211","3122444",0.47430222817861,11506,0.515213816102185,11763,-0.0409115879235749,-257
"16212","4122444",0.43282789747807,13237,0.472803440980375,13656,-0.0399755435023043,-419
"16213","1222444",0.526681831907307,8926,0.545077854997082,10164,-0.0183960230897751,-1238
"16214","2222444",0.463458659399118,11980,0.488703370356258,12991,-0.0252447109571406,-1011
"16215","3222444",0.420344450585614,13680,0.459909537156479,14084,-0.0395650865708646,-404
"16216","4222444",0.378870119885074,14860,0.417499162034668,15249,-0.0386290421495943,-389
"16217","1322444",0.49870236163053,10327,0.518027287663784,11612,-0.0193249260332533,-1285
"16218","2322444",0.435479189122342,13123,0.46165280302296,14026,-0.0261736139006188,-903
"16219","3322444",0.392364980308838,14522,0.432858969823181,14898,-0.0404939895143429,-376
"16220","4322444",0.350890649608298,15420,0.390448594701371,15726,-0.0395579450930725,-306
"16221","1422444",0.459765863645534,12153,0.477397783695678,13454,-0.0176319200501434,-1301
"16222","2422444",0.396542691137345,14400,0.421023299054855,15174,-0.0244806079175092,-774
"16223","3422444",0.353428482323842,15377,0.392229465855075,15696,-0.0388009835312332,-319
"16224","4422444",0.311954151623302,15933,0.349819090733265,16137,-0.0378649391099628,-204
"16225","1132444",0.537307087335203,8355,0.561917041494759,9221,-0.0246099541595559,-866
"16226","2132444",0.474083914827014,11520,0.505542556853936,12223,-0.0314586420269215,-703
"16227","3132444",0.430969706013511,13305,0.476748723654156,13482,-0.0457790176406455,-177
"16228","4132444",0.389495375312971,14600,0.434338348532346,14859,-0.0448429732193751,-259
"16229","1232444",0.483349309742207,11080,0.506612762549053,12178,-0.0232634528068459,-1098
"16230","2232444",0.420126137234018,13687,0.450238277908229,14414,-0.0301121406742115,-727
"16231","3232444",0.377011928420515,14907,0.42144444470845,15160,-0.0444325162879354,-253
"16232","4232444",0.335537597719975,15660,0.37903406958664,15879,-0.0434964718666651,-219
"16233","1332444",0.455369839465431,12324,0.479562195215755,13350,-0.0241923557503241,-1026
"16234","2332444",0.392146666957242,14532,0.423187710574931,15122,-0.0310410436176897,-590
"16235","3332444",0.349032458143738,15452,0.394393877375152,15666,-0.0453614192314137,-214
"16236","4332444",0.307558127443198,15975,0.351983502253342,16118,-0.0444253748101433,-143
"16237","1432444",0.416433341480435,13797,0.438932691247649,14737,-0.0224993497672143,-940
"16238","2432444",0.353210168972246,15381,0.382558206606826,15827,-0.0293480376345799,-446
"16239","3432444",0.310095960158742,15956,0.353764373407046,16102,-0.043668413248304,-146
"16240","4432444",0.268621629458202,16225,0.311353998285236,16307,-0.0427323688270335,-82
"16241","1142444",0.488273522880373,10841,0.521518547367675,11419,-0.0332450244873015,-578
"16242","2142444",0.425050350372185,13510,0.465144062726852,13917,-0.040093712354667,-407
"16243","3142444",0.381936141558681,14781,0.436350229527072,14807,-0.054414087968391,-26
"16244","4142444",0.340461810858141,15589,0.393939854405262,15671,-0.0534780435471206,-82
"16245","1242444",0.434315745287377,13177,0.466214268421969,13876,-0.0318985231345912,-699
"16246","2242444",0.371092572779188,15028,0.409839783781145,15408,-0.0387472110019569,-380
"16247","3242444",0.327978363965685,15759,0.381045950581366,15844,-0.0530675866156809,-85
"16248","4242444",0.286504033265145,16129,0.338635575459556,16203,-0.0521315421944105,-74
"16249","1342444",0.406336275010601,14123,0.439163701088671,14729,-0.0328274260780695,-606
"16250","2342444",0.343113102502412,15542,0.382789216447847,15822,-0.0396761139454351,-280
"16251","3342444",0.299998893688909,16038,0.353995383248068,16099,-0.0539964895591591,-61
"16252","4342444",0.258524562988369,16261,0.311585008126258,16304,-0.0530604451378887,-43
"16253","1442444",0.367399777025605,15113,0.398534197120565,15608,-0.0311344200949597,-495
"16254","2442444",0.304176604517416,16003,0.342159712479742,16182,-0.0379831079623254,-179
"16255","3442444",0.261062395703913,16251,0.313365879279962,16296,-0.0523034835760494,-45
"16256","4442444",0.219588065003373,16350,0.270955504158152,16369,-0.0513674391547789,-19
"16257","1113444",0.609735704794237,4811,0.635454855210956,5150,-0.0257191504167187,-339
"16258","2113444",0.546512532286048,7872,0.579080370570132,8253,-0.0325678382840843,-381
"16259","3113444",0.503398323472545,10098,0.550286537370353,9880,-0.0468882138978083,218
"16260","4113444",0.461923992772005,12052,0.507876162248542,12123,-0.0459521694765378,-71
"16261","1213444",0.555777927201241,7410,0.580150576265249,8183,-0.0243726490640085,-773
"16262","2213444",0.492554754693052,10616,0.523776091624426,11309,-0.0312213369313741,-693
"16263","3213444",0.449440545879549,12574,0.494982258424647,12717,-0.045541712545098,-143
"16264","4213444",0.407966215179008,14066,0.452571883302836,14329,-0.0446056681238278,-263
"16265","1313444",0.527798456924465,8854,0.553100008931951,9739,-0.0253015520074867,-885
"16266","2313444",0.464575284416276,11929,0.496725524291128,12635,-0.0321502398748523,-706
"16267","3313444",0.421461075602772,13633,0.467931691091349,13822,-0.0464706154885763,-189
"16268","4313444",0.379986744902232,14841,0.425521315969538,15071,-0.045534571067306,-230
"16269","1413444",0.488861958939469,10806,0.512470504963846,11906,-0.0236085460243769,-1100
"16270","2413444",0.42563878643128,13487,0.456096020323022,14206,-0.0304572338917425,-719
"16271","3413444",0.382524577617776,14771,0.427302187123243,15039,-0.0447776095054665,-268
"16272","4413444",0.341050246917236,15581,0.384891812001433,15797,-0.0438415650841962,-216
"16273","1123444",0.541756433927817,8135,0.574885543553549,8497,-0.0331291096257319,-362
"16274","2123444",0.478533261419628,11294,0.518511058912726,11587,-0.0399777974930975,-293
"16275","3123444",0.435419052606125,13128,0.489717225712946,12947,-0.0542981731068214,181
"16276","4123444",0.393944721905585,14480,0.447306850591136,14507,-0.0533621286855509,-27
"16277","1223444",0.487798656334821,10866,0.519581264607843,11524,-0.0317826082730217,-658
"16278","2223444",0.424575483826632,13524,0.463206779967019,13972,-0.0386312961403872,-448
"16279","3223444",0.381461275013129,14796,0.43441294676724,14855,-0.0529516717541112,-59
"16280","4223444",0.339986944312589,15595,0.392002571645429,15702,-0.0520156273328409,-107
"16281","1323444",0.459819186058045,12149,0.492530697274545,12825,-0.0327115112164999,-676
"16282","2323444",0.396596013549856,14398,0.436156212633721,14817,-0.0395601990838654,-419
"16283","3323444",0.353481804736352,15376,0.407362379433942,15456,-0.0538805746975894,-80
"16284","4323444",0.312007474035812,15932,0.364952004312132,16020,-0.0529445302763192,-88
"16285","1423444",0.420882688073049,13654,0.451901193306439,14350,-0.0310185052333901,-696
"16286","2423444",0.35765951556486,15299,0.395526708665616,15653,-0.0378671931007557,-354
"16287","3423444",0.314545306751356,15904,0.366732875465836,16002,-0.0521875687144797,-98
"16288","4423444",0.273070976050816,16203,0.324322500344026,16261,-0.0512515242932094,-58
"16289","1133444",0.498423911762717,10338,0.53642045110552,10662,-0.0379965393428026,-324
"16290","2133444",0.435200739254529,13136,0.480045966464697,13336,-0.0448452272101681,-200
"16291","3133444",0.392086530441025,14536,0.451252133264917,14371,-0.059165602823892,165
"16292","4133444",0.350612199740485,15428,0.408841758143107,15429,-0.0582295584026218,-1
"16293","1233444",0.444466134169721,12778,0.481116172159814,13289,-0.0366500379900925,-511
"16294","2233444",0.381242961661532,14803,0.42474168751899,15091,-0.0434987258574581,-288
"16295","3233444",0.338128752848029,15629,0.395947854319211,15642,-0.0578191014711821,-13
"16296","4233444",0.296654422147489,16060,0.353537479197401,16104,-0.0568830570499116,-44
"16297","1333444",0.416486663892945,13796,0.454065604826516,14282,-0.0375789409335708,-486
"16298","2333444",0.353263491384756,15379,0.397691120185692,15622,-0.0444276288009363,-243
"16299","3333444",0.310149282571253,15955,0.368897286985913,15980,-0.0587480044146603,-25
"16300","4333444",0.268674951870713,16224,0.326486911864103,16255,-0.0578119599933898,-31
"16301","1433444",0.377550165907949,14895,0.41343610085841,15340,-0.0358859349504609,-445
"16302","2433444",0.31432699339976,15908,0.357061616217587,16082,-0.0427346228178266,-174
"16303","3433444",0.271212784586257,16216,0.328267783017807,16249,-0.0570549984315505,-33
"16304","4433444",0.229738453885717,16332,0.285857407895997,16350,-0.05611895401028,-18
"16305","1143444",0.449390347307888,12579,0.496021956978436,12670,-0.0466316096705481,-91
"16306","2143444",0.386167174799699,14674,0.439647472337613,14719,-0.0534802975379136,-45
"16307","3143444",0.343052965986195,15545,0.410853639137833,15384,-0.0678006731516376,161
"16308","4143444",0.301578635285656,16024,0.368443264016023,15989,-0.0668646287303671,35
"16309","1243444",0.395432569714892,14432,0.44071767803273,14693,-0.0452851083178378,-261
"16310","2243444",0.332209397206703,15699,0.384343193391906,15801,-0.0521337961852034,-102
"16311","3243444",0.289095188393199,16109,0.355549360192127,16088,-0.0664541717989274,21
"16312","4243444",0.247620857692659,16296,0.313138985070317,16298,-0.0655181273776571,-2
"16313","1343444",0.367453099438116,15112,0.413667110699432,15333,-0.0462140112613161,-221
"16314","2343444",0.304229926929927,16002,0.357292626058608,16080,-0.0530626991286817,-78
"16315","3343444",0.261115718116423,16250,0.328498792858829,16245,-0.0673830747424056,5
"16316","4343444",0.219641387415883,16349,0.286088417737019,16349,-0.0664470303211353,0
"16317","1443444",0.32851660145312,15750,0.373037606731326,15946,-0.0445210052782062,-196
"16318","2443444",0.265293428944931,16235,0.316663122090503,16287,-0.0513696931455719,-52
"16319","3443444",0.222179220131427,16343,0.287869288890723,16347,-0.0656900687592958,-4
"16320","4443444",0.180704889430887,16377,0.245458913768913,16377,-0.0647540243380255,0
"16321","1114444",0.557528632823667,7303,0.5908042418373,7559,-0.0332756090136325,-256
"16322","2114444",0.494305460315478,10531,0.534429757196476,10769,-0.0401242968809981,-238
"16323","3114444",0.451191251501975,12496,0.505635923996697,12218,-0.0544446724947221,278
"16324","4114444",0.409716920801435,14008,0.463225548874887,13970,-0.0535086280734517,38
"16325","1214444",0.503570855230671,10088,0.535499962891594,10708,-0.0319291076609225,-620
"16326","2214444",0.440347682722482,12930,0.47912547825077,13371,-0.038777795528288,-441
"16327","3214444",0.397233473908979,14376,0.450331645050991,14407,-0.053098171142012,-31
"16328","4214444",0.355759143208439,15335,0.40792126992918,15445,-0.0521621267207416,-110
"16329","1314444",0.475591384953895,11441,0.508449395558296,12087,-0.0328580106044007,-646
"16330","2314444",0.412368212445706,13927,0.452074910917472,14342,-0.0397066984717663,-415
"16331","3314444",0.369254003632203,15065,0.423281077717693,15120,-0.0540270740854902,-55
"16332","4314444",0.327779672931663,15762,0.380870702595882,15847,-0.0530910296642199,-85
"16333","1414444",0.436654886968899,13073,0.46781989159019,13827,-0.0311650046212908,-754
"16334","2414444",0.37343171446071,14976,0.411445406949367,15373,-0.0380136924886565,-397
"16335","3414444",0.330317505647207,15724,0.382651573749587,15826,-0.0523340681023805,-102
"16336","4414444",0.288843174946667,16113,0.340241198627777,16192,-0.0513980236811101,-79
"16337","1124444",0.489549361957247,10768,0.530234930179893,10993,-0.0406855682226457,-225
"16338","2124444",0.426326189449058,13459,0.47386044553907,13607,-0.0475342560900112,-148
"16339","3124444",0.383211980635555,14752,0.44506661233929,14571,-0.0618546317037353,181
"16340","4124444",0.341737649935015,15565,0.40265623721748,15555,-0.0609185872824649,10
"16341","1224444",0.435591584364251,13121,0.474930651234187,13555,-0.0393390668699357,-434
"16342","2224444",0.372368411856062,14999,0.418556166593363,15227,-0.0461877547373012,-228
"16343","3224444",0.329254203042559,15738,0.389762333393584,15733,-0.0605081303510252,5
"16344","4224444",0.287779872342019,16117,0.347351958271774,16149,-0.0595720859297548,-32
"16345","1324444",0.407612114087475,14080,0.447880083900889,14486,-0.0402679698134139,-406
"16346","2324444",0.344388941579286,15520,0.391505599260066,15710,-0.0471166576807794,-190
"16347","3324444",0.301274732765783,16026,0.362711766060286,16042,-0.0614370332945035,-16
"16348","4324444",0.259800402065243,16255,0.320301390938476,16278,-0.060500988873233,-23
"16349","1424444",0.368675616102479,15083,0.407250579932783,15461,-0.038574963830304,-378
"16350","2424444",0.30545244359429,15992,0.35087609529196,16128,-0.0454236516976697,-136
"16351","3424444",0.262338234780787,16243,0.32208226209218,16272,-0.0597440273113937,-29
"16352","4424444",0.220863904080247,16345,0.27967188697037,16359,-0.0588079828901232,-14
"16353","1134444",0.446216839792148,12707,0.491769837731864,12856,-0.0455529979397165,-149
"16354","2134444",0.382993667283959,14760,0.435395353091041,14833,-0.052401685807082,-73
"16355","3134444",0.339879458470455,15599,0.406601519891261,15472,-0.066722061420806,127
"16356","4134444",0.298405127769915,16053,0.364191144769451,16028,-0.0657860169995357,25
"16357","1234444",0.392259062199151,14527,0.436465558786158,14801,-0.0442064965870064,-274
"16358","2234444",0.329035889690963,15741,0.380091074145335,15866,-0.051055184454372,-125
"16359","3234444",0.285921680877459,16133,0.351297240945555,16123,-0.065375560068096,10
"16360","4234444",0.244447350176919,16305,0.308886865823745,16316,-0.0644395156468255,-11
"16361","1334444",0.364279591922375,15176,0.40941499145286,15416,-0.0451353995304846,-240
"16362","2334444",0.301056419414186,16027,0.353040506812037,16110,-0.0519840873978502,-83
"16363","3334444",0.257942210600683,16263,0.324246673612257,16262,-0.0663044630115742,1
"16364","4334444",0.216467879900143,16352,0.281836298490447,16356,-0.0653684185903037,-4
"16365","1434444",0.325343093937379,15784,0.368785487484754,15983,-0.0434423935473748,-199
"16366","2434444",0.26211992142919,16244,0.312411002843931,16302,-0.0502910814147404,-58
"16367","3434444",0.219005712615687,16351,0.283617169644151,16353,-0.0646114570284644,-2
"16368","4434444",0.177531381915147,16378,0.241206794522341,16380,-0.0636754126071941,-2
"16369","1144444",0.397183275337318,14380,0.45137134360478,14368,-0.0541880682674619,12
"16370","2144444",0.333960102829129,15682,0.394996858963957,15656,-0.0610367561348275,26
"16371","3144444",0.290845894015626,16097,0.366203025764177,16005,-0.0753571317485515,92
"16372","4144444",0.249371563315086,16290,0.323792650642367,16265,-0.0744210873272811,25
"16373","1244444",0.343225497744322,15540,0.396067064659074,15639,-0.0528415669147518,-99
"16374","2244444",0.280002325236133,16164,0.33969258001825,16196,-0.0596902547821174,-32
"16375","3244444",0.23688811642263,16319,0.310898746818471,16308,-0.0740106303958414,11
"16376","4244444",0.19541378572209,16369,0.268488371696661,16372,-0.073074585974571,-3
"16377","1344444",0.315246027467546,15895,0.369016497325776,15978,-0.0537704698582301,-83
"16378","2344444",0.252022854959357,16279,0.312642012684953,16301,-0.0606191577255956,-22
"16379","3344444",0.208908646145853,16359,0.283848179485173,16352,-0.0749395333393196,7
"16380","4344444",0.167434315445313,16380,0.241437804363363,16379,-0.0740034889180493,1
"16381","1444444",0.27630952948255,16188,0.32838699335767,16247,-0.0520774638751202,-59
"16382","2444444",0.213086356974361,16356,0.272012508716847,16367,-0.0589261517424858,-11
"16383","3444444",0.169972148160857,16379,0.243218675517067,16378,-0.0732465273562099,1
"16384","4444444",0.128497817460317,16384,0.200808300395257,16384,-0.0723104829349395,0
